Poker Hand #RC3141728592: Hold'em No Limit ($0.05/$0.1) - 2024/12/12 13:20:17
Table 'RushAndCash22323852' 6-max Seat #1 is the button
Seat 1: fed024e0 ($10.15 in chips)
Seat 2: Hero ($17.9 in chips)
Seat 3: 65bfb346 ($36.84 in chips)
Seat 4: 8f901b97 ($32.16 in chips)
Seat 5: 78854bfa ($7.43 in chips)
Seat 6: fe1a2d61 ($10.43 in chips)
Hero: posts small blind $0.05
65bfb346: posts big blind $0.1
*** HOLE CARDS ***
Dealt to fed024e0 
Dealt to Hero [Jc Ad]
Dealt to 65bfb346 
Dealt to 8f901b97 
Dealt to 78854bfa 
Dealt to fe1a2d61 
8f901b97: folds
78854bfa: raises $0.12 to $0.22
fe1a2d61: folds
fed024e0: folds
Hero: folds
65bfb346: folds
Uncalled bet ($0.12) returned to 78854bfa
*** SHOWDOWN ***
78854bfa collected $0.25 from pot
*** SUMMARY ***
Total pot $0.25 | Rake $0 | Jackpot $0 | Bingo $0 | Fortune $0 | Tax $0
Seat 1: fed024e0 (button) folded before Flop (didn't bet)
Seat 2: Hero (small blind) folded before Flop
Seat 3: 65bfb346 (big blind) folded before Flop
Seat 4: 8f901b97 folded before Flop (didn't bet)
Seat 5: 78854bfa collected ($0.25)
Seat 6: fe1a2d61 folded before Flop (didn't bet)


Poker Hand #RC3141728159: Hold'em No Limit ($0.05/$0.1) - 2024/12/12 13:18:45
Table 'RushAndCash22323419' 6-max Seat #1 is the button
Seat 1: 78a7e3b4 ($10.11 in chips)
Seat 2: 5721fc96 ($7.84 in chips)
Seat 3: Hero ($18.29 in chips)
Seat 4: 4f76bae1 ($10.28 in chips)
Seat 5: 78854bfa ($7.03 in chips)
Seat 6: c2b852ae ($7.2 in chips)
5721fc96: posts small blind $0.05
Hero: posts big blind $0.1
*** HOLE CARDS ***
Dealt to 78a7e3b4 
Dealt to 5721fc96 
Dealt to Hero [Ts As]
Dealt to 4f76bae1 
Dealt to 78854bfa 
Dealt to c2b852ae 
4f76bae1: folds
78854bfa: raises $0.12 to $0.22
c2b852ae: folds
78a7e3b4: folds
5721fc96: folds
Hero: calls $0.12
*** FLOP *** [Qd 4d Th]
Hero: checks
78854bfa: bets $0.17
Hero: calls $0.17
*** TURN *** [Qd 4d Th] [7h]
Hero: checks
78854bfa: checks
*** RIVER *** [Qd 4d Th 7h] [Kh]
Hero: checks
78854bfa: bets $0.42
Hero: folds
Uncalled bet ($0.42) returned to 78854bfa
*** SHOWDOWN ***
78854bfa collected $0.79 from pot
*** SUMMARY ***
Total pot $0.83 | Rake $0.04 | Jackpot $0 | Bingo $0 | Fortune $0 | Tax $0
Board [Qd 4d Th 7h Kh]
Seat 1: 78a7e3b4 (button) folded before Flop (didn't bet)
Seat 2: 5721fc96 (small blind) folded before Flop
Seat 3: Hero (big blind) folded on the River
Seat 4: 4f76bae1 folded before Flop (didn't bet)
Seat 5: 78854bfa won ($0.79)
Seat 6: c2b852ae folded before Flop (didn't bet)


Poker Hand #RC3141728145: Hold'em No Limit ($0.05/$0.1) - 2024/12/12 13:18:42
Table 'RushAndCash22323405' 6-max Seat #1 is the button
Seat 1: a6717311 ($10.28 in chips)
Seat 2: 9cfbee05 ($10 in chips)
Seat 3: af208717 ($10 in chips)
Seat 4: Hero ($18.29 in chips)
Seat 5: 78854bfa ($7.03 in chips)
Seat 6: 101c026b ($35.28 in chips)
9cfbee05: posts small blind $0.05
af208717: posts big blind $0.1
*** HOLE CARDS ***
Dealt to a6717311 
Dealt to 9cfbee05 
Dealt to af208717 
Dealt to Hero [5h Ad]
Dealt to 78854bfa 
Dealt to 101c026b 
Hero: folds
78854bfa: folds
101c026b: folds
a6717311: folds
9cfbee05: raises $0.2 to $0.3
af208717: folds
Uncalled bet ($0.2) returned to 9cfbee05
*** SHOWDOWN ***
9cfbee05 collected $0.2 from pot
*** SUMMARY ***
Total pot $0.2 | Rake $0 | Jackpot $0 | Bingo $0 | Fortune $0 | Tax $0
Seat 1: a6717311 (button) folded before Flop (didn't bet)
Seat 2: 9cfbee05 (small blind) collected ($0.2)
Seat 3: af208717 (big blind) folded before Flop
Seat 4: Hero folded before Flop (didn't bet)
Seat 5: 78854bfa folded before Flop (didn't bet)
Seat 6: 101c026b folded before Flop (didn't bet)


Poker Hand #RC3141728029: Hold'em No Limit ($0.05/$0.1) - 2024/12/12 13:18:16
Table 'RushAndCash22323289' 6-max Seat #1 is the button
Seat 1: 81834a2f ($14.35 in chips)
Seat 2: 59363533 ($10.86 in chips)
Seat 3: Hero ($18.39 in chips)
Seat 4: 2ffa3e66 ($13.09 in chips)
Seat 5: 84c13d8 ($27.31 in chips)
Seat 6: ee394d0a ($11.47 in chips)
59363533: posts small blind $0.05
Hero: posts big blind $0.1
*** HOLE CARDS ***
Dealt to 81834a2f 
Dealt to 59363533 
Dealt to Hero [5s Ah]
Dealt to 2ffa3e66 
Dealt to 84c13d8 
Dealt to ee394d0a 
2ffa3e66: folds
84c13d8: raises $0.2 to $0.3
ee394d0a: folds
81834a2f: folds
59363533: folds
Hero: folds
Uncalled bet ($0.2) returned to 84c13d8
*** SHOWDOWN ***
84c13d8 collected $0.25 from pot
*** SUMMARY ***
Total pot $0.25 | Rake $0 | Jackpot $0 | Bingo $0 | Fortune $0 | Tax $0
Seat 1: 81834a2f (button) folded before Flop (didn't bet)
Seat 2: 59363533 (small blind) folded before Flop
Seat 3: Hero (big blind) folded before Flop
Seat 4: 2ffa3e66 folded before Flop (didn't bet)
Seat 5: 84c13d8 collected ($0.25)
Seat 6: ee394d0a folded before Flop (didn't bet)


Poker Hand #RC3141728014: Hold'em No Limit ($0.05/$0.1) - 2024/12/12 13:18:13
Table 'RushAndCash22323274' 6-max Seat #1 is the button
Seat 1: 65bfb346 ($36.54 in chips)
Seat 2: 59363533 ($10.91 in chips)
Seat 3: 226dbbb0 ($13.92 in chips)
Seat 4: 2e3105a5 ($12.65 in chips)
Seat 5: 418b0280 ($11 in chips)
Seat 6: Hero ($18.39 in chips)
59363533: posts small blind $0.05
226dbbb0: posts big blind $0.1
*** HOLE CARDS ***
Dealt to 65bfb346 
Dealt to 59363533 
Dealt to 226dbbb0 
Dealt to 2e3105a5 
Dealt to 418b0280 
Dealt to Hero [Jc 7h]
2e3105a5: folds
418b0280: folds
Hero: folds
65bfb346: folds
59363533: folds
Uncalled bet ($0.05) returned to 226dbbb0
*** SHOWDOWN ***
226dbbb0 collected $0.1 from pot
*** SUMMARY ***
Total pot $0.1 | Rake $0 | Jackpot $0 | Bingo $0 | Fortune $0 | Tax $0
Seat 1: 65bfb346 (button) folded before Flop (didn't bet)
Seat 2: 59363533 (small blind) folded before Flop
Seat 3: 226dbbb0 (big blind) collected ($0.1)
Seat 4: 2e3105a5 folded before Flop (didn't bet)
Seat 5: 418b0280 folded before Flop (didn't bet)
Seat 6: Hero folded before Flop (didn't bet)


Poker Hand #RC3141727981: Hold'em No Limit ($0.05/$0.1) - 2024/12/12 13:18:05
Table 'RushAndCash22323241' 6-max Seat #1 is the button
Seat 1: 393dfd41 ($7.81 in chips)
Seat 2: Hero ($18.44 in chips)
Seat 3: 7ec40c0d ($20 in chips)
Seat 4: 418b0280 ($11 in chips)
Seat 5: b82279c3 ($19.54 in chips)
Seat 6: 6a8aff3d ($43.36 in chips)
Hero: posts small blind $0.05
7ec40c0d: posts big blind $0.1
*** HOLE CARDS ***
Dealt to 393dfd41 
Dealt to Hero [7d Kd]
Dealt to 7ec40c0d 
Dealt to 418b0280 
Dealt to b82279c3 
Dealt to 6a8aff3d 
418b0280: folds
b82279c3: raises $0.15 to $0.25
6a8aff3d: folds
393dfd41: folds
Hero: folds
7ec40c0d: folds
Uncalled bet ($0.15) returned to b82279c3
*** SHOWDOWN ***
b82279c3 collected $0.25 from pot
*** SUMMARY ***
Total pot $0.25 | Rake $0 | Jackpot $0 | Bingo $0 | Fortune $0 | Tax $0
Seat 1: 393dfd41 (button) folded before Flop (didn't bet)
Seat 2: Hero (small blind) folded before Flop
Seat 3: 7ec40c0d (big blind) folded before Flop
Seat 4: 418b0280 folded before Flop (didn't bet)
Seat 5: b82279c3 collected ($0.25)
Seat 6: 6a8aff3d folded before Flop (didn't bet)


Poker Hand #RC3141727968: Hold'em No Limit ($0.05/$0.1) - 2024/12/12 13:18:02
Table 'RushAndCash22323228' 6-max Seat #1 is the button
Seat 1: a3d9ddb9 ($15.8 in chips)
Seat 2: 35c03ff2 ($14.91 in chips)
Seat 3: 84c13d8 ($27.41 in chips)
Seat 4: Hero ($18.44 in chips)
Seat 5: 9cfbee05 ($10.05 in chips)
Seat 6: 73df44d1 ($10 in chips)
35c03ff2: posts small blind $0.05
84c13d8: posts big blind $0.1
*** HOLE CARDS ***
Dealt to a3d9ddb9 
Dealt to 35c03ff2 
Dealt to 84c13d8 
Dealt to Hero [3d Js]
Dealt to 9cfbee05 
Dealt to 73df44d1 
Hero: folds
9cfbee05: raises $0.15 to $0.25
73df44d1: folds
a3d9ddb9: folds
35c03ff2: folds
84c13d8: folds
Uncalled bet ($0.15) returned to 9cfbee05
*** SHOWDOWN ***
9cfbee05 collected $0.25 from pot
*** SUMMARY ***
Total pot $0.25 | Rake $0 | Jackpot $0 | Bingo $0 | Fortune $0 | Tax $0
Seat 1: a3d9ddb9 (button) folded before Flop (didn't bet)
Seat 2: 35c03ff2 (small blind) folded before Flop
Seat 3: 84c13d8 (big blind) folded before Flop
Seat 4: Hero folded before Flop (didn't bet)
Seat 5: 9cfbee05 collected ($0.25)
Seat 6: 73df44d1 folded before Flop (didn't bet)


Poker Hand #RC3141727955: Hold'em No Limit ($0.05/$0.1) - 2024/12/12 13:17:58
Table 'RushAndCash22323215' 6-max Seat #1 is the button
Seat 1: 671b32fd ($10.2 in chips)
Seat 2: 4b71434f ($12.81 in chips)
Seat 3: 35c03ff2 ($15.01 in chips)
Seat 4: 88133657 ($10.62 in chips)
Seat 5: 7bad2adb ($15.27 in chips)
Seat 6: Hero ($18.44 in chips)
4b71434f: posts small blind $0.05
35c03ff2: posts big blind $0.1
*** HOLE CARDS ***
Dealt to 671b32fd 
Dealt to 4b71434f 
Dealt to 35c03ff2 
Dealt to 88133657 
Dealt to 7bad2adb 
Dealt to Hero [8s 6c]
88133657: folds
7bad2adb: folds
Hero: folds
671b32fd: folds
4b71434f: folds
Uncalled bet ($0.05) returned to 35c03ff2
*** SHOWDOWN ***
35c03ff2 collected $0.1 from pot
*** SUMMARY ***
Total pot $0.1 | Rake $0 | Jackpot $0 | Bingo $0 | Fortune $0 | Tax $0
Seat 1: 671b32fd (button) folded before Flop (didn't bet)
Seat 2: 4b71434f (small blind) folded before Flop
Seat 3: 35c03ff2 (big blind) collected ($0.1)
Seat 4: 88133657 folded before Flop (didn't bet)
Seat 5: 7bad2adb folded before Flop (didn't bet)
Seat 6: Hero folded before Flop (didn't bet)


Poker Hand #RC3141727403: Hold'em No Limit ($0.05/$0.1) - 2024/12/12 13:16:00
Table 'RushAndCash22322663' 6-max Seat #1 is the button
Seat 1: Hero ($21.45 in chips)
Seat 2: a8408ae7 ($10 in chips)
Seat 3: 4b71434f ($10 in chips)
Seat 4: 81834a2f ($13.73 in chips)
Seat 5: f3e09586 ($10 in chips)
Seat 6: e2a23377 ($10.05 in chips)
a8408ae7: posts small blind $0.05
4b71434f: posts big blind $0.1
*** HOLE CARDS ***
Dealt to Hero [4c 5c]
Dealt to a8408ae7 
Dealt to 4b71434f 
Dealt to 81834a2f 
Dealt to f3e09586 
Dealt to e2a23377 
81834a2f: folds
f3e09586: folds
e2a23377: folds
Hero: raises $0.15 to $0.25
a8408ae7: calls $0.2
4b71434f: calls $0.15
*** FLOP *** [2c As Td]
a8408ae7: checks
4b71434f: checks
Hero: bets $0.25
a8408ae7: folds
4b71434f: calls $0.25
*** TURN *** [2c As Td] [3c]
4b71434f: checks
Hero: bets $0.94
4b71434f: calls $0.94
*** RIVER *** [2c As Td 3c] [Jc]
4b71434f: bets $1.57
Hero: calls $1.57
4b71434f: shows [7c Tc] (Jack High Flush)
Hero: shows [4c 5c] (Jack High Flush)
*** SHOWDOWN ***
4b71434f collected $5.82 from pot
*** SUMMARY ***
Total pot $6.27 | Rake $0.3 | Jackpot $0.15 | Bingo $0 | Fortune $0 | Tax $0
Board [2c As Td 3c Jc]
Seat 1: Hero (button) showed [4c 5c] and lost with Jack High Flush
Seat 2: a8408ae7 (small blind) folded on the Flop
Seat 3: 4b71434f (big blind) showed [7c Tc] and won ($5.82) with Jack High Flush
Seat 4: 81834a2f folded before Flop (didn't bet)
Seat 5: f3e09586 folded before Flop (didn't bet)
Seat 6: e2a23377 folded before Flop (didn't bet)


Poker Hand #RC3141727379: Hold'em No Limit ($0.05/$0.1) - 2024/12/12 13:15:55
Table 'RushAndCash22322639' 6-max Seat #1 is the button
Seat 1: 4cf26e8f ($12.92 in chips)
Seat 2: 1dc34506 ($11.31 in chips)
Seat 3: 340255c5 ($11.45 in chips)
Seat 4: 9c1507dc ($18.3 in chips)
Seat 5: Hero ($21.45 in chips)
Seat 6: c6786b68 ($6.23 in chips)
1dc34506: posts small blind $0.05
340255c5: posts big blind $0.1
*** HOLE CARDS ***
Dealt to 4cf26e8f 
Dealt to 1dc34506 
Dealt to 340255c5 
Dealt to 9c1507dc 
Dealt to Hero [7c 7s]
Dealt to c6786b68 
9c1507dc: raises $0.1 to $0.2
Hero: folds
c6786b68: folds
4cf26e8f: folds
1dc34506: folds
340255c5: folds
Uncalled bet ($0.1) returned to 9c1507dc
*** SHOWDOWN ***
9c1507dc collected $0.25 from pot
*** SUMMARY ***
Total pot $0.25 | Rake $0 | Jackpot $0 | Bingo $0 | Fortune $0 | Tax $0
Seat 1: 4cf26e8f (button) folded before Flop (didn't bet)
Seat 2: 1dc34506 (small blind) folded before Flop
Seat 3: 340255c5 (big blind) folded before Flop
Seat 4: 9c1507dc collected ($0.25)
Seat 5: Hero folded before Flop (didn't bet)
Seat 6: c6786b68 folded before Flop (didn't bet)


Poker Hand #RC3141727324: Hold'em No Limit ($0.05/$0.1) - 2024/12/12 13:15:44
Table 'RushAndCash22322584' 6-max Seat #1 is the button
Seat 1: 48f3df37 ($19.53 in chips)
Seat 2: af208717 ($10 in chips)
Seat 3: Hero ($21.55 in chips)
Seat 4: d6b17ac7 ($12.04 in chips)
Seat 5: fa56d9ad ($9.45 in chips)
Seat 6: c2b852ae ($7.46 in chips)
af208717: posts small blind $0.05
Hero: posts big blind $0.1
*** HOLE CARDS ***
Dealt to 48f3df37 
Dealt to af208717 
Dealt to Hero [Ks 7d]
Dealt to d6b17ac7 
Dealt to fa56d9ad 
Dealt to c2b852ae 
d6b17ac7: folds
fa56d9ad: raises $0.2 to $0.3
c2b852ae: folds
48f3df37: folds
af208717: folds
Hero: folds
Uncalled bet ($0.2) returned to fa56d9ad
*** SHOWDOWN ***
fa56d9ad collected $0.25 from pot
*** SUMMARY ***
Total pot $0.25 | Rake $0 | Jackpot $0 | Bingo $0 | Fortune $0 | Tax $0
Seat 1: 48f3df37 (button) folded before Flop (didn't bet)
Seat 2: af208717 (small blind) folded before Flop
Seat 3: Hero (big blind) folded before Flop
Seat 4: d6b17ac7 folded before Flop (didn't bet)
Seat 5: fa56d9ad collected ($0.25)
Seat 6: c2b852ae folded before Flop (didn't bet)


Poker Hand #RC3141727301: Hold'em No Limit ($0.05/$0.1) - 2024/12/12 13:15:40
Table 'RushAndCash22322561' 6-max Seat #1 is the button
Seat 1: 4dfc452f ($10 in chips)
Seat 2: Hero ($21.6 in chips)
Seat 3: 718b4a9 ($12.04 in chips)
Seat 4: c67e237e ($29.46 in chips)
Seat 5: ea3eb4a4 ($10 in chips)
Seat 6: 73154d50 ($10.45 in chips)
Hero: posts small blind $0.05
718b4a9: posts big blind $0.1
*** HOLE CARDS ***
Dealt to 4dfc452f 
Dealt to Hero [7h 8c]
Dealt to 718b4a9 
Dealt to c67e237e 
Dealt to ea3eb4a4 
Dealt to 73154d50 
c67e237e: raises $0.1 to $0.2
ea3eb4a4: folds
73154d50: folds
4dfc452f: folds
Hero: folds
718b4a9: folds
Uncalled bet ($0.1) returned to c67e237e
*** SHOWDOWN ***
c67e237e collected $0.25 from pot
*** SUMMARY ***
Total pot $0.25 | Rake $0 | Jackpot $0 | Bingo $0 | Fortune $0 | Tax $0
Seat 1: 4dfc452f (button) folded before Flop (didn't bet)
Seat 2: Hero (small blind) folded before Flop
Seat 3: 718b4a9 (big blind) folded before Flop
Seat 4: c67e237e collected ($0.25)
Seat 5: ea3eb4a4 folded before Flop (didn't bet)
Seat 6: 73154d50 folded before Flop (didn't bet)


Poker Hand #RC3141727284: Hold'em No Limit ($0.05/$0.1) - 2024/12/12 13:15:36
Table 'RushAndCash22322544' 6-max Seat #1 is the button
Seat 1: 9d1b2c7c ($10.55 in chips)
Seat 2: bb835227 ($10.69 in chips)
Seat 3: c67e237e ($29.56 in chips)
Seat 4: 73154d50 ($10.45 in chips)
Seat 5: Hero ($21.6 in chips)
Seat 6: ea3eb4a4 ($10 in chips)
bb835227: posts small blind $0.05
c67e237e: posts big blind $0.1
*** HOLE CARDS ***
Dealt to 9d1b2c7c 
Dealt to bb835227 
Dealt to c67e237e 
Dealt to 73154d50 
Dealt to Hero [Qh 8d]
Dealt to ea3eb4a4 
73154d50: folds
Hero: folds
ea3eb4a4: folds
9d1b2c7c: raises $0.11 to $0.21
bb835227: folds
c67e237e: folds
Uncalled bet ($0.11) returned to 9d1b2c7c
*** SHOWDOWN ***
9d1b2c7c collected $0.25 from pot
*** SUMMARY ***
Total pot $0.25 | Rake $0 | Jackpot $0 | Bingo $0 | Fortune $0 | Tax $0
Seat 1: 9d1b2c7c (button) collected ($0.25)
Seat 2: bb835227 (small blind) folded before Flop
Seat 3: c67e237e (big blind) folded before Flop
Seat 4: 73154d50 folded before Flop (didn't bet)
Seat 5: Hero folded before Flop (didn't bet)
Seat 6: ea3eb4a4 folded before Flop (didn't bet)


Poker Hand #RC3141727267: Hold'em No Limit ($0.05/$0.1) - 2024/12/12 13:15:33
Table 'RushAndCash22322527' 6-max Seat #1 is the button
Seat 1: Hero ($21.6 in chips)
Seat 2: 1c087ec5 ($43.1 in chips)
Seat 3: f323cdf3 ($14.72 in chips)
Seat 4: ee394d0a ($11.58 in chips)
Seat 5: 19a20066 ($10 in chips)
Seat 6: 9d1b2c7c ($10.55 in chips)
1c087ec5: posts small blind $0.05
f323cdf3: posts big blind $0.1
*** HOLE CARDS ***
Dealt to Hero [6d 9s]
Dealt to 1c087ec5 
Dealt to f323cdf3 
Dealt to ee394d0a 
Dealt to 19a20066 
Dealt to 9d1b2c7c 
ee394d0a: folds
19a20066: folds
9d1b2c7c: folds
Hero: folds
1c087ec5: folds
Uncalled bet ($0.05) returned to f323cdf3
*** SHOWDOWN ***
f323cdf3 collected $0.1 from pot
*** SUMMARY ***
Total pot $0.1 | Rake $0 | Jackpot $0 | Bingo $0 | Fortune $0 | Tax $0
Seat 1: Hero (button) folded before Flop (didn't bet)
Seat 2: 1c087ec5 (small blind) folded before Flop
Seat 3: f323cdf3 (big blind) collected ($0.1)
Seat 4: ee394d0a folded before Flop (didn't bet)
Seat 5: 19a20066 folded before Flop (didn't bet)
Seat 6: 9d1b2c7c folded before Flop (didn't bet)


Poker Hand #RC3141727250: Hold'em No Limit ($0.05/$0.1) - 2024/12/12 13:15:30
Table 'RushAndCash22322510' 6-max Seat #1 is the button
Seat 1: Hero ($21.6 in chips)
Seat 2: 11a00985 ($20.41 in chips)
Seat 3: c8c2a1e ($11.63 in chips)
Seat 4: ee394d0a ($11.58 in chips)
Seat 5: d515d6ec ($12.72 in chips)
Seat 6: d1764387 ($24.38 in chips)
11a00985: posts small blind $0.05
c8c2a1e: posts big blind $0.1
*** HOLE CARDS ***
Dealt to Hero [Qd 4s]
Dealt to 11a00985 
Dealt to c8c2a1e 
Dealt to ee394d0a 
Dealt to d515d6ec 
Dealt to d1764387 
ee394d0a: folds
d515d6ec: folds
d1764387: folds
Hero: folds
11a00985: calls $0.05
c8c2a1e: raises $0.7 to $0.8
11a00985: folds
Uncalled bet ($0.7) returned to c8c2a1e
*** SHOWDOWN ***
c8c2a1e collected $0.2 from pot
*** SUMMARY ***
Total pot $0.2 | Rake $0 | Jackpot $0 | Bingo $0 | Fortune $0 | Tax $0
Seat 1: Hero (button) folded before Flop (didn't bet)
Seat 2: 11a00985 (small blind) folded before Flop
Seat 3: c8c2a1e (big blind) collected ($0.2)
Seat 4: ee394d0a folded before Flop (didn't bet)
Seat 5: d515d6ec folded before Flop (didn't bet)
Seat 6: d1764387 folded before Flop (didn't bet)


Poker Hand #RC3141727234: Hold'em No Limit ($0.05/$0.1) - 2024/12/12 13:15:26
Table 'RushAndCash22322494' 6-max Seat #1 is the button
Seat 1: 216abb36 ($10.56 in chips)
Seat 2: b6367fbf ($10.05 in chips)
Seat 3: f32585e5 ($10.2 in chips)
Seat 4: f564c212 ($11.13 in chips)
Seat 5: 593f64c7 ($6.47 in chips)
Seat 6: Hero ($21.6 in chips)
b6367fbf: posts small blind $0.05
f32585e5: posts big blind $0.1
*** HOLE CARDS ***
Dealt to 216abb36 
Dealt to b6367fbf 
Dealt to f32585e5 
Dealt to f564c212 
Dealt to 593f64c7 
Dealt to Hero [Qs 5h]
f564c212: folds
593f64c7: folds
Hero: folds
216abb36: folds
b6367fbf: folds
Uncalled bet ($0.05) returned to f32585e5
*** SHOWDOWN ***
f32585e5 collected $0.1 from pot
*** SUMMARY ***
Total pot $0.1 | Rake $0 | Jackpot $0 | Bingo $0 | Fortune $0 | Tax $0
Seat 1: 216abb36 (button) folded before Flop (didn't bet)
Seat 2: b6367fbf (small blind) folded before Flop
Seat 3: f32585e5 (big blind) collected ($0.1)
Seat 4: f564c212 folded before Flop (didn't bet)
Seat 5: 593f64c7 folded before Flop (didn't bet)
Seat 6: Hero folded before Flop (didn't bet)


Poker Hand #RC3141727178: Hold'em No Limit ($0.05/$0.1) - 2024/12/12 13:15:13
Table 'RushAndCash22322438' 6-max Seat #1 is the button
Seat 1: 4cf26e8f ($13.07 in chips)
Seat 2: d7f68c0e ($10 in chips)
Seat 3: Hero ($21.7 in chips)
Seat 4: afe85e9d ($10.61 in chips)
Seat 5: 5ab2e15d ($10.49 in chips)
Seat 6: 8499417 ($11.74 in chips)
d7f68c0e: posts small blind $0.05
Hero: posts big blind $0.1
*** HOLE CARDS ***
Dealt to 4cf26e8f 
Dealt to d7f68c0e 
Dealt to Hero [Tc Js]
Dealt to afe85e9d 
Dealt to 5ab2e15d 
Dealt to 8499417 
afe85e9d: folds
5ab2e15d: raises $0.1 to $0.2
8499417: raises $0.42 to $0.62
4cf26e8f: folds
d7f68c0e: folds
Hero: folds
5ab2e15d: folds
Uncalled bet ($0.42) returned to 8499417
*** SHOWDOWN ***
8499417 collected $0.53 from pot
*** SUMMARY ***
Total pot $0.55 | Rake $0.02 | Jackpot $0 | Bingo $0 | Fortune $0 | Tax $0
Seat 1: 4cf26e8f (button) folded before Flop (didn't bet)
Seat 2: d7f68c0e (small blind) folded before Flop
Seat 3: Hero (big blind) folded before Flop
Seat 4: afe85e9d folded before Flop (didn't bet)
Seat 5: 5ab2e15d folded before Flop
Seat 6: 8499417 collected ($0.53)


Poker Hand #RC3141727136: Hold'em No Limit ($0.05/$0.1) - 2024/12/12 13:15:03
Table 'RushAndCash22322396' 6-max Seat #1 is the button
Seat 1: 4f76bae1 ($10 in chips)
Seat 2: Hero ($21.75 in chips)
Seat 3: bd84d15b ($10 in chips)
Seat 4: 844091a0 ($13.4 in chips)
Seat 5: 78854bfa ($7.35 in chips)
Seat 6: 56e396a1 ($10.15 in chips)
Hero: posts small blind $0.05
bd84d15b: posts big blind $0.1
*** HOLE CARDS ***
Dealt to 4f76bae1 
Dealt to Hero [7h Ad]
Dealt to bd84d15b 
Dealt to 844091a0 
Dealt to 78854bfa 
Dealt to 56e396a1 
844091a0: folds
78854bfa: folds
56e396a1: folds
4f76bae1: raises $0.1 to $0.2
Hero: folds
bd84d15b: calls $0.1
*** FLOP *** [9c 8s Td]
bd84d15b: checks
4f76bae1: checks
*** TURN *** [9c 8s Td] [Tc]
bd84d15b: bets $0.15
4f76bae1: calls $0.15
*** RIVER *** [9c 8s Td Tc] [Qc]
bd84d15b: bets $0.38
4f76bae1: folds
Uncalled bet ($0.38) returned to bd84d15b
*** SHOWDOWN ***
bd84d15b collected $0.72 from pot
*** SUMMARY ***
Total pot $0.75 | Rake $0.03 | Jackpot $0 | Bingo $0 | Fortune $0 | Tax $0
Board [9c 8s Td Tc Qc]
Seat 1: 4f76bae1 (button) folded on the River
Seat 2: Hero (small blind) folded before Flop
Seat 3: bd84d15b (big blind) won ($0.72)
Seat 4: 844091a0 folded before Flop (didn't bet)
Seat 5: 78854bfa folded before Flop (didn't bet)
Seat 6: 56e396a1 folded before Flop (didn't bet)


Poker Hand #RC3141727120: Hold'em No Limit ($0.05/$0.1) - 2024/12/12 13:15:00
Table 'RushAndCash22322380' 6-max Seat #1 is the button
Seat 1: 10144c4d ($6.45 in chips)
Seat 2: 7f65d70 ($11.4 in chips)
Seat 3: 216abb36 ($10.71 in chips)
Seat 4: 84cc5caa ($11.87 in chips)
Seat 5: Hero ($21.75 in chips)
Seat 6: e04e7077 ($10.71 in chips)
7f65d70: posts small blind $0.05
216abb36: posts big blind $0.1
*** HOLE CARDS ***
Dealt to 10144c4d 
Dealt to 7f65d70 
Dealt to 216abb36 
Dealt to 84cc5caa 
Dealt to Hero [3h Qd]
Dealt to e04e7077 
84cc5caa: folds
Hero: folds
e04e7077: folds
10144c4d: folds
7f65d70: raises $0.18 to $0.28
216abb36: folds
Uncalled bet ($0.18) returned to 7f65d70
*** SHOWDOWN ***
7f65d70 collected $0.2 from pot
*** SUMMARY ***
Total pot $0.2 | Rake $0 | Jackpot $0 | Bingo $0 | Fortune $0 | Tax $0
Seat 1: 10144c4d (button) folded before Flop (didn't bet)
Seat 2: 7f65d70 (small blind) collected ($0.2)
Seat 3: 216abb36 (big blind) folded before Flop
Seat 4: 84cc5caa folded before Flop (didn't bet)
Seat 5: Hero folded before Flop (didn't bet)
Seat 6: e04e7077 folded before Flop (didn't bet)


Poker Hand #RC3141727104: Hold'em No Limit ($0.05/$0.1) - 2024/12/12 13:14:56
Table 'RushAndCash22322364' 6-max Seat #1 is the button
Seat 1: 79658983 ($10 in chips)
Seat 2: ebfcde93 ($11.5 in chips)
Seat 3: 4d1634eb ($13.25 in chips)
Seat 4: 902b9d1a ($15.86 in chips)
Seat 5: Hero ($21.75 in chips)
Seat 6: e3244dc0 ($14.53 in chips)
ebfcde93: posts small blind $0.05
4d1634eb: posts big blind $0.1
*** HOLE CARDS ***
Dealt to 79658983 
Dealt to ebfcde93 
Dealt to 4d1634eb 
Dealt to 902b9d1a 
Dealt to Hero [6d Qc]
Dealt to e3244dc0 
902b9d1a: folds
Hero: folds
e3244dc0: folds
79658983: raises $0.15 to $0.25
ebfcde93: folds
4d1634eb: folds
Uncalled bet ($0.15) returned to 79658983
*** SHOWDOWN ***
79658983 collected $0.25 from pot
*** SUMMARY ***
Total pot $0.25 | Rake $0 | Jackpot $0 | Bingo $0 | Fortune $0 | Tax $0
Seat 1: 79658983 (button) collected ($0.25)
Seat 2: ebfcde93 (small blind) folded before Flop
Seat 3: 4d1634eb (big blind) folded before Flop
Seat 4: 902b9d1a folded before Flop (didn't bet)
Seat 5: Hero folded before Flop (didn't bet)
Seat 6: e3244dc0 folded before Flop (didn't bet)


Poker Hand #RC3141727085: Hold'em No Limit ($0.05/$0.1) - 2024/12/12 13:14:53
Table 'RushAndCash22322345' 6-max Seat #1 is the button
Seat 1: 1036e403 ($11.73 in chips)
Seat 2: a19f63e0 ($10.8 in chips)
Seat 3: 3b12e634 ($12.23 in chips)
Seat 4: ae2a34aa ($10 in chips)
Seat 5: d6b17ac7 ($12.34 in chips)
Seat 6: Hero ($21.75 in chips)
a19f63e0: posts small blind $0.05
3b12e634: posts big blind $0.1
*** HOLE CARDS ***
Dealt to 1036e403 
Dealt to a19f63e0 
Dealt to 3b12e634 
Dealt to ae2a34aa 
Dealt to d6b17ac7 
Dealt to Hero [3d As]
ae2a34aa: folds
d6b17ac7: folds
Hero: folds
1036e403: raises $0.15 to $0.25
a19f63e0: folds
3b12e634: folds
Uncalled bet ($0.15) returned to 1036e403
*** SHOWDOWN ***
1036e403 collected $0.25 from pot
*** SUMMARY ***
Total pot $0.25 | Rake $0 | Jackpot $0 | Bingo $0 | Fortune $0 | Tax $0
Seat 1: 1036e403 (button) collected ($0.25)
Seat 2: a19f63e0 (small blind) folded before Flop
Seat 3: 3b12e634 (big blind) folded before Flop
Seat 4: ae2a34aa folded before Flop (didn't bet)
Seat 5: d6b17ac7 folded before Flop (didn't bet)
Seat 6: Hero folded before Flop (didn't bet)


Poker Hand #RC3141727056: Hold'em No Limit ($0.05/$0.1) - 2024/12/12 13:14:47
Table 'RushAndCash22322316' 6-max Seat #1 is the button
Seat 1: 78854bfa ($7.5 in chips)
Seat 2: Hero ($21.8 in chips)
Seat 3: f383ae87 ($25.92 in chips)
Seat 4: 6b0057b1 ($10 in chips)
Seat 5: b17f5bfe ($7.17 in chips)
Seat 6: d9ccf407 ($10.77 in chips)
Hero: posts small blind $0.05
f383ae87: posts big blind $0.1
*** HOLE CARDS ***
Dealt to 78854bfa 
Dealt to Hero [9d 6s]
Dealt to f383ae87 
Dealt to 6b0057b1 
Dealt to b17f5bfe 
Dealt to d9ccf407 
6b0057b1: folds
b17f5bfe: folds
d9ccf407: folds
78854bfa: folds
Hero: folds
Uncalled bet ($0.05) returned to f383ae87
*** SHOWDOWN ***
f383ae87 collected $0.1 from pot
*** SUMMARY ***
Total pot $0.1 | Rake $0 | Jackpot $0 | Bingo $0 | Fortune $0 | Tax $0
Seat 1: 78854bfa (button) folded before Flop (didn't bet)
Seat 2: Hero (small blind) folded before Flop
Seat 3: f383ae87 (big blind) collected ($0.1)
Seat 4: 6b0057b1 folded before Flop (didn't bet)
Seat 5: b17f5bfe folded before Flop (didn't bet)
Seat 6: d9ccf407 folded before Flop (didn't bet)


Poker Hand #RC3141727011: Hold'em No Limit ($0.05/$0.1) - 2024/12/12 13:14:37
Table 'RushAndCash22322271' 6-max Seat #1 is the button
Seat 1: f383ae87 ($25.92 in chips)
Seat 2: 17798854 ($10.27 in chips)
Seat 3: 6904b57e ($16.98 in chips)
Seat 4: Hero ($21.8 in chips)
Seat 5: 66a73913 ($18.61 in chips)
Seat 6: 17b5c9c3 ($10.1 in chips)
17798854: posts small blind $0.05
6904b57e: posts big blind $0.1
*** HOLE CARDS ***
Dealt to f383ae87 
Dealt to 17798854 
Dealt to 6904b57e 
Dealt to Hero [7c Qc]
Dealt to 66a73913 
Dealt to 17b5c9c3 
Hero: folds
66a73913: folds
17b5c9c3: raises $0.1 to $0.2
f383ae87: folds
17798854: folds
6904b57e: folds
Uncalled bet ($0.1) returned to 17b5c9c3
*** SHOWDOWN ***
17b5c9c3 collected $0.25 from pot
*** SUMMARY ***
Total pot $0.25 | Rake $0 | Jackpot $0 | Bingo $0 | Fortune $0 | Tax $0
Seat 1: f383ae87 (button) folded before Flop (didn't bet)
Seat 2: 17798854 (small blind) folded before Flop
Seat 3: 6904b57e (big blind) folded before Flop
Seat 4: Hero folded before Flop (didn't bet)
Seat 5: 66a73913 folded before Flop (didn't bet)
Seat 6: 17b5c9c3 collected ($0.25)


Poker Hand #RC3141726948: Hold'em No Limit ($0.05/$0.1) - 2024/12/12 13:14:20
Table 'RushAndCash22322208' 6-max Seat #1 is the button
Seat 1: 316b7313 ($9.84 in chips)
Seat 2: 3b12e634 ($12.43 in chips)
Seat 3: Hero ($21.9 in chips)
Seat 4: 54a8e111 ($12.07 in chips)
Seat 5: 1036e403 ($11.45 in chips)
Seat 6: 5248da40 ($10 in chips)
3b12e634: posts small blind $0.05
Hero: posts big blind $0.1
*** HOLE CARDS ***
Dealt to 316b7313 
Dealt to 3b12e634 
Dealt to Hero [9h Kd]
Dealt to 54a8e111 
Dealt to 1036e403 
Dealt to 5248da40 
54a8e111: folds
1036e403: raises $0.1 to $0.2
5248da40: folds
316b7313: folds
3b12e634: calls $0.15
Hero: folds
*** FLOP *** [4d Kc 8h]
3b12e634: checks
1036e403: bets $0.13
3b12e634: folds
Uncalled bet ($0.13) returned to 1036e403
*** SHOWDOWN ***
1036e403 collected $0.48 from pot
*** SUMMARY ***
Total pot $0.5 | Rake $0.02 | Jackpot $0 | Bingo $0 | Fortune $0 | Tax $0
Board [4d Kc 8h]
Seat 1: 316b7313 (button) folded before Flop (didn't bet)
Seat 2: 3b12e634 (small blind) folded on the Flop
Seat 3: Hero (big blind) folded before Flop
Seat 4: 54a8e111 folded before Flop (didn't bet)
Seat 5: 1036e403 won ($0.48)
Seat 6: 5248da40 folded before Flop (didn't bet)


Poker Hand #RC3141726934: Hold'em No Limit ($0.05/$0.1) - 2024/12/12 13:14:17
Table 'RushAndCash22322194' 6-max Seat #1 is the button
Seat 1: b0559006 ($3.75 in chips)
Seat 2: 4eb4d0d6 ($18.56 in chips)
Seat 3: f564c212 ($11.53 in chips)
Seat 4: Hero ($21.9 in chips)
Seat 5: e04e7077 ($10.86 in chips)
Seat 6: f347a136 ($10.28 in chips)
4eb4d0d6: posts small blind $0.05
f564c212: posts big blind $0.1
*** HOLE CARDS ***
Dealt to b0559006 
Dealt to 4eb4d0d6 
Dealt to f564c212 
Dealt to Hero [2h 9h]
Dealt to e04e7077 
Dealt to f347a136 
Hero: folds
e04e7077: folds
f347a136: raises $0.15 to $0.25
b0559006: folds
4eb4d0d6: folds
f564c212: folds
Uncalled bet ($0.15) returned to f347a136
*** SHOWDOWN ***
f347a136 collected $0.25 from pot
*** SUMMARY ***
Total pot $0.25 | Rake $0 | Jackpot $0 | Bingo $0 | Fortune $0 | Tax $0
Seat 1: b0559006 (button) folded before Flop (didn't bet)
Seat 2: 4eb4d0d6 (small blind) folded before Flop
Seat 3: f564c212 (big blind) folded before Flop
Seat 4: Hero folded before Flop (didn't bet)
Seat 5: e04e7077 folded before Flop (didn't bet)
Seat 6: f347a136 collected ($0.25)


Poker Hand #RC3141726921: Hold'em No Limit ($0.05/$0.1) - 2024/12/12 13:14:14
Table 'RushAndCash22322181' 6-max Seat #1 is the button
Seat 1: 4eb4d0d6 ($18.56 in chips)
Seat 2: fd36d45d ($12.31 in chips)
Seat 3: ac9f5f4 ($9.5 in chips)
Seat 4: Hero ($21.9 in chips)
Seat 5: d1122f42 ($10.95 in chips)
Seat 6: af208717 ($10.28 in chips)
fd36d45d: posts small blind $0.05
ac9f5f4: posts big blind $0.1
*** HOLE CARDS ***
Dealt to 4eb4d0d6 
Dealt to fd36d45d 
Dealt to ac9f5f4 
Dealt to Hero [2s Td]
Dealt to d1122f42 
Dealt to af208717 
Hero: folds
d1122f42: raises $0.1 to $0.2
af208717: folds
4eb4d0d6: folds
fd36d45d: folds
ac9f5f4: raises $0.15 to $0.35
d1122f42: calls $0.15
*** FLOP *** [5c 4d 7d]
ac9f5f4: checks
d1122f42: checks
*** TURN *** [5c 4d 7d] [8s]
ac9f5f4: bets $0.25
d1122f42: calls $0.25
*** RIVER *** [5c 4d 7d 8s] [Kh]
ac9f5f4: checks
d1122f42: checks
ac9f5f4: shows [Ad Ah] (Pair of Aces)
d1122f42: shows [9d Jd] (King-High)
*** SHOWDOWN ***
ac9f5f4 collected $1.19 from pot
*** SUMMARY ***
Total pot $1.25 | Rake $0.06 | Jackpot $0 | Bingo $0 | Fortune $0 | Tax $0
Board [5c 4d 7d 8s Kh]
Seat 1: 4eb4d0d6 (button) folded before Flop (didn't bet)
Seat 2: fd36d45d (small blind) folded before Flop
Seat 3: ac9f5f4 (big blind) showed [Ad Ah] and won ($1.19) with Pair of Aces
Seat 4: Hero folded before Flop (didn't bet)
Seat 5: d1122f42 showed [9d Jd] and lost with King-High
Seat 6: af208717 folded before Flop (didn't bet)


Poker Hand #RC3141726907: Hold'em No Limit ($0.05/$0.1) - 2024/12/12 13:14:10
Table 'RushAndCash22322167' 6-max Seat #1 is the button
Seat 1: Hero ($21.9 in chips)
Seat 2: 61709362 ($10 in chips)
Seat 3: 37fb9df ($10 in chips)
Seat 4: d1122f42 ($10.95 in chips)
Seat 5: c0d18d50 ($5.43 in chips)
Seat 6: 721d2ee6 ($12.7 in chips)
61709362: posts small blind $0.05
37fb9df: posts big blind $0.1
*** HOLE CARDS ***
Dealt to Hero [5s 3c]
Dealt to 61709362 
Dealt to 37fb9df 
Dealt to d1122f42 
Dealt to c0d18d50 
Dealt to 721d2ee6 
d1122f42: folds
c0d18d50: folds
721d2ee6: folds
Hero: folds
61709362: folds
Uncalled bet ($0.05) returned to 37fb9df
*** SHOWDOWN ***
37fb9df collected $0.1 from pot
*** SUMMARY ***
Total pot $0.1 | Rake $0 | Jackpot $0 | Bingo $0 | Fortune $0 | Tax $0
Seat 1: Hero (button) folded before Flop (didn't bet)
Seat 2: 61709362 (small blind) folded before Flop
Seat 3: 37fb9df (big blind) collected ($0.1)
Seat 4: d1122f42 folded before Flop (didn't bet)
Seat 5: c0d18d50 folded before Flop (didn't bet)
Seat 6: 721d2ee6 folded before Flop (didn't bet)


Poker Hand #RC3141726811: Hold'em No Limit ($0.05/$0.1) - 2024/12/12 13:13:46
Table 'RushAndCash22322071' 6-max Seat #1 is the button
Seat 1: c0d18d50 ($5.06 in chips)
Seat 2: 4ff8a7e0 ($3.9 in chips)
Seat 3: 8d92b14e ($10 in chips)
Seat 4: ee394d0a ($11.36 in chips)
Seat 5: c6999b53 ($3.09 in chips)
Seat 6: Hero ($22.15 in chips)
4ff8a7e0: posts small blind $0.05
8d92b14e: posts big blind $0.1
*** HOLE CARDS ***
Dealt to c0d18d50 
Dealt to 4ff8a7e0 
Dealt to 8d92b14e 
Dealt to ee394d0a 
Dealt to c6999b53 
Dealt to Hero [Ah Jd]
ee394d0a: folds
c6999b53: folds
Hero: raises $0.15 to $0.25
c0d18d50: raises $0.49 to $0.74
4ff8a7e0: folds
8d92b14e: folds
Hero: folds
Uncalled bet ($0.49) returned to c0d18d50
*** SHOWDOWN ***
c0d18d50 collected $0.62 from pot
*** SUMMARY ***
Total pot $0.65 | Rake $0.03 | Jackpot $0 | Bingo $0 | Fortune $0 | Tax $0
Seat 1: c0d18d50 (button) collected ($0.62)
Seat 2: 4ff8a7e0 (small blind) folded before Flop
Seat 3: 8d92b14e (big blind) folded before Flop
Seat 4: ee394d0a folded before Flop (didn't bet)
Seat 5: c6999b53 folded before Flop (didn't bet)
Seat 6: Hero folded before Flop


Poker Hand #RC3141726798: Hold'em No Limit ($0.05/$0.1) - 2024/12/12 13:13:43
Table 'RushAndCash22322058' 6-max Seat #1 is the button
Seat 1: Hero ($22.15 in chips)
Seat 2: 4dd7bc95 ($12.13 in chips)
Seat 3: 48f3df37 ($21.2 in chips)
Seat 4: ea3eb4a4 ($10 in chips)
Seat 5: ebfcde93 ($11.9 in chips)
Seat 6: 6904b57e ($17.23 in chips)
4dd7bc95: posts small blind $0.05
48f3df37: posts big blind $0.1
*** HOLE CARDS ***
Dealt to Hero [Js 8d]
Dealt to 4dd7bc95 
Dealt to 48f3df37 
Dealt to ea3eb4a4 
Dealt to ebfcde93 
Dealt to 6904b57e 
ea3eb4a4: folds
ebfcde93: folds
6904b57e: folds
Hero: folds
4dd7bc95: raises $0.2 to $0.3
48f3df37: calls $0.2
*** FLOP *** [Td 2d Ts]
4dd7bc95: bets $0.2
48f3df37: folds
Uncalled bet ($0.2) returned to 4dd7bc95
*** SHOWDOWN ***
4dd7bc95 collected $0.57 from pot
*** SUMMARY ***
Total pot $0.6 | Rake $0.03 | Jackpot $0 | Bingo $0 | Fortune $0 | Tax $0
Board [Td 2d Ts]
Seat 1: Hero (button) folded before Flop (didn't bet)
Seat 2: 4dd7bc95 (small blind) won ($0.57)
Seat 3: 48f3df37 (big blind) folded on the Flop
Seat 4: ea3eb4a4 folded before Flop (didn't bet)
Seat 5: ebfcde93 folded before Flop (didn't bet)
Seat 6: 6904b57e folded before Flop (didn't bet)


Poker Hand #RC3141726769: Hold'em No Limit ($0.05/$0.1) - 2024/12/12 13:13:35
Table 'RushAndCash22322029' 6-max Seat #1 is the button
Seat 1: 3f7822ab ($20.23 in chips)
Seat 2: Hero ($22.2 in chips)
Seat 3: ce410800 ($23.64 in chips)
Seat 4: 647dd971 ($2.75 in chips)
Seat 5: 8a31e4cb ($10.25 in chips)
Seat 6: b1f396f4 ($23.59 in chips)
Hero: posts small blind $0.05
ce410800: posts big blind $0.1
*** HOLE CARDS ***
Dealt to 3f7822ab 
Dealt to Hero [6c As]
Dealt to ce410800 
Dealt to 647dd971 
Dealt to 8a31e4cb 
Dealt to b1f396f4 
647dd971: folds
8a31e4cb: folds
b1f396f4: folds
3f7822ab: raises $0.12 to $0.22
Hero: folds
ce410800: folds
Uncalled bet ($0.12) returned to 3f7822ab
*** SHOWDOWN ***
3f7822ab collected $0.25 from pot
*** SUMMARY ***
Total pot $0.25 | Rake $0 | Jackpot $0 | Bingo $0 | Fortune $0 | Tax $0
Seat 1: 3f7822ab (button) collected ($0.25)
Seat 2: Hero (small blind) folded before Flop
Seat 3: ce410800 (big blind) folded before Flop
Seat 4: 647dd971 folded before Flop (didn't bet)
Seat 5: 8a31e4cb folded before Flop (didn't bet)
Seat 6: b1f396f4 folded before Flop (didn't bet)


Poker Hand #RC3141726749: Hold'em No Limit ($0.05/$0.1) - 2024/12/12 13:13:30
Table 'RushAndCash22322009' 6-max Seat #1 is the button
Seat 1: 4f76bae1 ($10 in chips)
Seat 2: 718b4a9 ($11.5 in chips)
Seat 3: Hero ($22.3 in chips)
Seat 4: e4fc8b12 ($15.15 in chips)
Seat 5: c2b852ae ($7.4 in chips)
Seat 6: dea77808 ($14.14 in chips)
718b4a9: posts small blind $0.05
Hero: posts big blind $0.1
*** HOLE CARDS ***
Dealt to 4f76bae1 
Dealt to 718b4a9 
Dealt to Hero [7h 6s]
Dealt to e4fc8b12 
Dealt to c2b852ae 
Dealt to dea77808 
e4fc8b12: raises $0.1 to $0.2
c2b852ae: folds
dea77808: folds
4f76bae1: raises $0.42 to $0.62
718b4a9: folds
Hero: folds
e4fc8b12: calls $0.42
*** FLOP *** [8h 6c 9s]
e4fc8b12: checks
4f76bae1: checks
*** TURN *** [8h 6c 9s] [4h]
e4fc8b12: bets $1.05
4f76bae1: folds
Uncalled bet ($1.05) returned to e4fc8b12
*** SHOWDOWN ***
e4fc8b12 collected $1.32 from pot
*** SUMMARY ***
Total pot $1.39 | Rake $0.07 | Jackpot $0 | Bingo $0 | Fortune $0 | Tax $0
Board [8h 6c 9s 4h]
Seat 1: 4f76bae1 (button) folded on the Turn
Seat 2: 718b4a9 (small blind) folded before Flop
Seat 3: Hero (big blind) folded before Flop
Seat 4: e4fc8b12 won ($1.32)
Seat 5: c2b852ae folded before Flop (didn't bet)
Seat 6: dea77808 folded before Flop (didn't bet)


Poker Hand #RC3141726736: Hold'em No Limit ($0.05/$0.1) - 2024/12/12 13:13:27
Table 'RushAndCash22321996' 6-max Seat #1 is the button
Seat 1: 254fead6 ($4.93 in chips)
Seat 2: 721d2ee6 ($12.8 in chips)
Seat 3: afe10f69 ($10 in chips)
Seat 4: ce410800 ($23.64 in chips)
Seat 5: Hero ($22.3 in chips)
Seat 6: 271927f ($10.32 in chips)
721d2ee6: posts small blind $0.05
afe10f69: posts big blind $0.1
*** HOLE CARDS ***
Dealt to 254fead6 
Dealt to 721d2ee6 
Dealt to afe10f69 
Dealt to ce410800 
Dealt to Hero [7h Jh]
Dealt to 271927f 
ce410800: folds
Hero: folds
271927f: raises $0.12 to $0.22
254fead6: folds
721d2ee6: folds
afe10f69: calls $0.12
*** FLOP *** [Td 5d 5s]
afe10f69: checks
271927f: checks
*** TURN *** [Td 5d 5s] [Js]
afe10f69: checks
271927f: checks
*** RIVER *** [Td 5d 5s Js] [4s]
afe10f69: checks
271927f: checks
afe10f69: shows [Qd 3d] (Pair of Fives)
271927f: shows [Jd Kh] (Pair of Jacks and Pair of Fives)
*** SHOWDOWN ***
271927f collected $0.47 from pot
*** SUMMARY ***
Total pot $0.49 | Rake $0.02 | Jackpot $0 | Bingo $0 | Fortune $0 | Tax $0
Board [Td 5d 5s Js 4s]
Seat 1: 254fead6 (button) folded before Flop (didn't bet)
Seat 2: 721d2ee6 (small blind) folded before Flop
Seat 3: afe10f69 (big blind) showed [Qd 3d] and lost with Pair of Fives
Seat 4: ce410800 folded before Flop (didn't bet)
Seat 5: Hero folded before Flop (didn't bet)
Seat 6: 271927f showed [Jd Kh] and won ($0.47) with Pair of Jacks and Pair of Fives


Poker Hand #RC3141726721: Hold'em No Limit ($0.05/$0.1) - 2024/12/12 13:13:23
Table 'RushAndCash22321981' 6-max Seat #1 is the button
Seat 1: 6731d495 ($14.55 in chips)
Seat 2: 645be922 ($13.39 in chips)
Seat 3: f32585e5 ($10.67 in chips)
Seat 4: 7bad2adb ($14.77 in chips)
Seat 5: Hero ($22.3 in chips)
Seat 6: 19a20066 ($10 in chips)
645be922: posts small blind $0.05
f32585e5: posts big blind $0.1
*** HOLE CARDS ***
Dealt to 6731d495 
Dealt to 645be922 
Dealt to f32585e5 
Dealt to 7bad2adb 
Dealt to Hero [3c 9d]
Dealt to 19a20066 
7bad2adb: folds
Hero: folds
19a20066: folds
6731d495: folds
645be922: raises $0.2 to $0.3
f32585e5: folds
Uncalled bet ($0.2) returned to 645be922
*** SHOWDOWN ***
645be922 collected $0.2 from pot
*** SUMMARY ***
Total pot $0.2 | Rake $0 | Jackpot $0 | Bingo $0 | Fortune $0 | Tax $0
Seat 1: 6731d495 (button) folded before Flop (didn't bet)
Seat 2: 645be922 (small blind) collected ($0.2)
Seat 3: f32585e5 (big blind) folded before Flop
Seat 4: 7bad2adb folded before Flop (didn't bet)
Seat 5: Hero folded before Flop (didn't bet)
Seat 6: 19a20066 folded before Flop (didn't bet)


Poker Hand #RC3141726706: Hold'em No Limit ($0.05/$0.1) - 2024/12/12 13:13:20
Table 'RushAndCash22321966' 6-max Seat #1 is the button
Seat 1: cf64da1a ($31.82 in chips)
Seat 2: 4dd7bc95 ($12.13 in chips)
Seat 3: 5b32d7fc ($13.13 in chips)
Seat 4: 6731d495 ($14.55 in chips)
Seat 5: Hero ($22.3 in chips)
Seat 6: 6a8aff3d ($41.83 in chips)
4dd7bc95: posts small blind $0.05
5b32d7fc: posts big blind $0.1
*** HOLE CARDS ***
Dealt to cf64da1a 
Dealt to 4dd7bc95 
Dealt to 5b32d7fc 
Dealt to 6731d495 
Dealt to Hero [3s Jd]
Dealt to 6a8aff3d 
6731d495: folds
Hero: folds
6a8aff3d: folds
cf64da1a: raises $0.1 to $0.2
4dd7bc95: folds
5b32d7fc: folds
Uncalled bet ($0.1) returned to cf64da1a
*** SHOWDOWN ***
cf64da1a collected $0.25 from pot
*** SUMMARY ***
Total pot $0.25 | Rake $0 | Jackpot $0 | Bingo $0 | Fortune $0 | Tax $0
Seat 1: cf64da1a (button) collected ($0.25)
Seat 2: 4dd7bc95 (small blind) folded before Flop
Seat 3: 5b32d7fc (big blind) folded before Flop
Seat 4: 6731d495 folded before Flop (didn't bet)
Seat 5: Hero folded before Flop (didn't bet)
Seat 6: 6a8aff3d folded before Flop (didn't bet)


Poker Hand #RC3141726690: Hold'em No Limit ($0.05/$0.1) - 2024/12/12 13:13:16
Table 'RushAndCash22321950' 6-max Seat #1 is the button
Seat 1: 4f76bae1 ($10 in chips)
Seat 2: 88a9583f ($47.61 in chips)
Seat 3: 671b32fd ($10 in chips)
Seat 4: Hero ($22.3 in chips)
Seat 5: 5b32d7fc ($13.13 in chips)
Seat 6: 36e10f27 ($14.3 in chips)
88a9583f: posts small blind $0.05
671b32fd: posts big blind $0.1
*** HOLE CARDS ***
Dealt to 4f76bae1 
Dealt to 88a9583f 
Dealt to 671b32fd 
Dealt to Hero [Ts 4c]
Dealt to 5b32d7fc 
Dealt to 36e10f27 
Hero: folds
5b32d7fc: folds
36e10f27: raises $0.2 to $0.3
4f76bae1: folds
88a9583f: folds
671b32fd: folds
Uncalled bet ($0.2) returned to 36e10f27
*** SHOWDOWN ***
36e10f27 collected $0.25 from pot
*** SUMMARY ***
Total pot $0.25 | Rake $0 | Jackpot $0 | Bingo $0 | Fortune $0 | Tax $0
Seat 1: 4f76bae1 (button) folded before Flop (didn't bet)
Seat 2: 88a9583f (small blind) folded before Flop
Seat 3: 671b32fd (big blind) folded before Flop
Seat 4: Hero folded before Flop (didn't bet)
Seat 5: 5b32d7fc folded before Flop (didn't bet)
Seat 6: 36e10f27 collected ($0.25)


Poker Hand #RC3141726674: Hold'em No Limit ($0.05/$0.1) - 2024/12/12 13:13:13
Table 'RushAndCash22321934' 6-max Seat #1 is the button
Seat 1: Hero ($22.3 in chips)
Seat 2: b0bb79df ($10 in chips)
Seat 3: c46a27c1 ($27.08 in chips)
Seat 4: 1677a3f4 ($13.62 in chips)
Seat 5: c113e767 ($6.38 in chips)
Seat 6: a2304e34 ($10 in chips)
b0bb79df: posts small blind $0.05
c46a27c1: posts big blind $0.1
*** HOLE CARDS ***
Dealt to Hero [Ks 7d]
Dealt to b0bb79df 
Dealt to c46a27c1 
Dealt to 1677a3f4 
Dealt to c113e767 
Dealt to a2304e34 
1677a3f4: folds
c113e767: folds
a2304e34: raises $0.13 to $0.23
Hero: folds
b0bb79df: folds
c46a27c1: folds
Uncalled bet ($0.13) returned to a2304e34
*** SHOWDOWN ***
a2304e34 collected $0.25 from pot
*** SUMMARY ***
Total pot $0.25 | Rake $0 | Jackpot $0 | Bingo $0 | Fortune $0 | Tax $0
Seat 1: Hero (button) folded before Flop (didn't bet)
Seat 2: b0bb79df (small blind) folded before Flop
Seat 3: c46a27c1 (big blind) folded before Flop
Seat 4: 1677a3f4 folded before Flop (didn't bet)
Seat 5: c113e767 folded before Flop (didn't bet)
Seat 6: a2304e34 collected ($0.25)


Poker Hand #RC3141726636: Hold'em No Limit ($0.05/$0.1) - 2024/12/12 13:13:05
Table 'RushAndCash22321896' 6-max Seat #1 is the button
Seat 1: 3c989a00 ($25.8 in chips)
Seat 2: 256d4298 ($17.06 in chips)
Seat 3: Hero ($22.25 in chips)
Seat 4: 59363533 ($13.2 in chips)
Seat 5: 661d577b ($10.64 in chips)
Seat 6: ec7ff353 ($10 in chips)
256d4298: posts small blind $0.05
Hero: posts big blind $0.1
*** HOLE CARDS ***
Dealt to 3c989a00 
Dealt to 256d4298 
Dealt to Hero [Kc Ac]
Dealt to 59363533 
Dealt to 661d577b 
Dealt to ec7ff353 
59363533: folds
661d577b: folds
ec7ff353: folds
3c989a00: folds
256d4298: folds
Uncalled bet ($0.05) returned to Hero
*** SHOWDOWN ***
Hero collected $0.1 from pot
*** SUMMARY ***
Total pot $0.1 | Rake $0 | Jackpot $0 | Bingo $0 | Fortune $0 | Tax $0
Seat 1: 3c989a00 (button) folded before Flop (didn't bet)
Seat 2: 256d4298 (small blind) folded before Flop
Seat 3: Hero (big blind) collected ($0.1)
Seat 4: 59363533 folded before Flop (didn't bet)
Seat 5: 661d577b folded before Flop (didn't bet)
Seat 6: ec7ff353 folded before Flop (didn't bet)


Poker Hand #RC3141726540: Hold'em No Limit ($0.05/$0.1) - 2024/12/12 13:12:40
Table 'RushAndCash22321800' 6-max Seat #1 is the button
Seat 1: d25ababb ($9.7 in chips)
Seat 2: Hero ($22.55 in chips)
Seat 3: 3c989a00 ($25.53 in chips)
Seat 4: 3f1c4e6e ($16.66 in chips)
Seat 5: 7f65d70 ($11.67 in chips)
Seat 6: 47ae29b2 ($15.01 in chips)
Hero: posts small blind $0.05
3c989a00: posts big blind $0.1
*** HOLE CARDS ***
Dealt to d25ababb 
Dealt to Hero [Tc 8c]
Dealt to 3c989a00 
Dealt to 3f1c4e6e 
Dealt to 7f65d70 
Dealt to 47ae29b2 
3f1c4e6e: folds
7f65d70: folds
47ae29b2: folds
d25ababb: folds
Hero: raises $0.2 to $0.3
3c989a00: raises $0.6 to $0.9
Hero: folds
Uncalled bet ($0.6) returned to 3c989a00
*** SHOWDOWN ***
3c989a00 collected $0.57 from pot
*** SUMMARY ***
Total pot $0.6 | Rake $0.03 | Jackpot $0 | Bingo $0 | Fortune $0 | Tax $0
Seat 1: d25ababb (button) folded before Flop (didn't bet)
Seat 2: Hero (small blind) folded before Flop
Seat 3: 3c989a00 (big blind) collected ($0.57)
Seat 4: 3f1c4e6e folded before Flop (didn't bet)
Seat 5: 7f65d70 folded before Flop (didn't bet)
Seat 6: 47ae29b2 folded before Flop (didn't bet)


Poker Hand #RC3141726529: Hold'em No Limit ($0.05/$0.1) - 2024/12/12 13:12:37
Table 'RushAndCash22321789' 6-max Seat #1 is the button
Seat 1: 47ae29b2 ($15.01 in chips)
Seat 2: 671b32fd ($12.14 in chips)
Seat 3: d7f68c0e ($10.67 in chips)
Seat 4: Hero ($22.55 in chips)
Seat 5: 36e10f27 ($12.15 in chips)
Seat 6: 3c989a00 ($25.53 in chips)
671b32fd: posts small blind $0.05
d7f68c0e: posts big blind $0.1
*** HOLE CARDS ***
Dealt to 47ae29b2 
Dealt to 671b32fd 
Dealt to d7f68c0e 
Dealt to Hero [8c 3c]
Dealt to 36e10f27 
Dealt to 3c989a00 
Hero: folds
36e10f27: raises $0.2 to $0.3
3c989a00: folds
47ae29b2: folds
671b32fd: raises $0.65 to $0.95
d7f68c0e: folds
36e10f27: calls $0.65
*** FLOP *** [4h Ah 7d]
671b32fd: bets $0.5
36e10f27: calls $0.5
*** TURN *** [4h Ah 7d] [Qd]
671b32fd: checks
36e10f27: bets $0.99
671b32fd: calls $0.99
*** RIVER *** [4h Ah 7d Qd] [7s]
671b32fd: checks
36e10f27: checks
671b32fd: shows [Qs Kc] (Pair of Queens and Pair of Sevens)
36e10f27: shows [Kd Kh] (Pair of Kings and Pair of Sevens)
*** SHOWDOWN ***
36e10f27 collected $4.59 from pot
*** SUMMARY ***
Total pot $4.98 | Rake $0.24 | Jackpot $0.15 | Bingo $0 | Fortune $0 | Tax $0
Board [4h Ah 7d Qd 7s]
Seat 1: 47ae29b2 (button) folded before Flop (didn't bet)
Seat 2: 671b32fd (small blind) showed [Qs Kc] and lost with Pair of Queens and Pair of Sevens
Seat 3: d7f68c0e (big blind) folded before Flop
Seat 4: Hero folded before Flop (didn't bet)
Seat 5: 36e10f27 showed [Kd Kh] and won ($4.59) with Pair of Kings and Pair of Sevens
Seat 6: 3c989a00 folded before Flop (didn't bet)


Poker Hand #RC3141726518: Hold'em No Limit ($0.05/$0.1) - 2024/12/12 13:12:34
Table 'RushAndCash22321778' 6-max Seat #1 is the button
Seat 1: 24c2159e ($15.79 in chips)
Seat 2: 3c989a00 ($25.58 in chips)
Seat 3: b73105eb ($10.15 in chips)
Seat 4: b863ea8c ($27.6 in chips)
Seat 5: Hero ($22.55 in chips)
Seat 6: 5f7772c4 ($7.84 in chips)
3c989a00: posts small blind $0.05
b73105eb: posts big blind $0.1
*** HOLE CARDS ***
Dealt to 24c2159e 
Dealt to 3c989a00 
Dealt to b73105eb 
Dealt to b863ea8c 
Dealt to Hero [4d Jc]
Dealt to 5f7772c4 
b863ea8c: raises $0.1 to $0.2
Hero: folds
5f7772c4: folds
24c2159e: folds
3c989a00: folds
b73105eb: folds
Uncalled bet ($0.1) returned to b863ea8c
*** SHOWDOWN ***
b863ea8c collected $0.25 from pot
*** SUMMARY ***
Total pot $0.25 | Rake $0 | Jackpot $0 | Bingo $0 | Fortune $0 | Tax $0
Seat 1: 24c2159e (button) folded before Flop (didn't bet)
Seat 2: 3c989a00 (small blind) folded before Flop
Seat 3: b73105eb (big blind) folded before Flop
Seat 4: b863ea8c collected ($0.25)
Seat 5: Hero folded before Flop (didn't bet)
Seat 6: 5f7772c4 folded before Flop (didn't bet)


Poker Hand #RC3141726505: Hold'em No Limit ($0.05/$0.1) - 2024/12/12 13:12:30
Table 'RushAndCash22321765' 6-max Seat #1 is the button
Seat 1: Hero ($22.55 in chips)
Seat 2: 7b43c302 ($10 in chips)
Seat 3: 2edfec7c ($6.67 in chips)
Seat 4: 24c2159e ($15.79 in chips)
Seat 5: 5b982aa5 ($9.59 in chips)
Seat 6: d1764387 ($23.14 in chips)
7b43c302: posts small blind $0.05
2edfec7c: posts big blind $0.1
*** HOLE CARDS ***
Dealt to Hero [9h 3c]
Dealt to 7b43c302 
Dealt to 2edfec7c 
Dealt to 24c2159e 
Dealt to 5b982aa5 
Dealt to d1764387 
24c2159e: folds
5b982aa5: folds
d1764387: folds
Hero: folds
7b43c302: raises $0.2 to $0.3
2edfec7c: raises $0.65 to $0.95
7b43c302: folds
Uncalled bet ($0.65) returned to 2edfec7c
*** SHOWDOWN ***
2edfec7c collected $0.57 from pot
*** SUMMARY ***
Total pot $0.6 | Rake $0.03 | Jackpot $0 | Bingo $0 | Fortune $0 | Tax $0
Seat 1: Hero (button) folded before Flop (didn't bet)
Seat 2: 7b43c302 (small blind) folded before Flop
Seat 3: 2edfec7c (big blind) collected ($0.57)
Seat 4: 24c2159e folded before Flop (didn't bet)
Seat 5: 5b982aa5 folded before Flop (didn't bet)
Seat 6: d1764387 folded before Flop (didn't bet)


Poker Hand #RC3141726464: Hold'em No Limit ($0.05/$0.1) - 2024/12/12 13:12:20
Table 'RushAndCash22321724' 6-max Seat #1 is the button
Seat 1: be2bfc8f ($10 in chips)
Seat 2: f4a0e033 ($10 in chips)
Seat 3: Hero ($22.65 in chips)
Seat 4: 149da8e2 ($10 in chips)
Seat 5: 1d8dcfab ($66.94 in chips)
Seat 6: aaca7529 ($5.56 in chips)
f4a0e033: posts small blind $0.05
Hero: posts big blind $0.1
*** HOLE CARDS ***
Dealt to be2bfc8f 
Dealt to f4a0e033 
Dealt to Hero [Ac 2d]
Dealt to 149da8e2 
Dealt to 1d8dcfab 
Dealt to aaca7529 
149da8e2: raises $0.1 to $0.2
1d8dcfab: folds
aaca7529: folds
be2bfc8f: calls $0.2
f4a0e033: calls $0.15
Hero: folds
*** FLOP *** [6s 9c Ks]
f4a0e033: checks
149da8e2: checks
be2bfc8f: checks
*** TURN *** [6s 9c Ks] [6c]
f4a0e033: checks
149da8e2: checks
be2bfc8f: checks
*** RIVER *** [6s 9c Ks 6c] [3s]
f4a0e033: checks
149da8e2: checks
be2bfc8f: bets $0.7
f4a0e033: folds
149da8e2: folds
Uncalled bet ($0.7) returned to be2bfc8f
*** SHOWDOWN ***
be2bfc8f collected $0.67 from pot
*** SUMMARY ***
Total pot $0.7 | Rake $0.03 | Jackpot $0 | Bingo $0 | Fortune $0 | Tax $0
Board [6s 9c Ks 6c 3s]
Seat 1: be2bfc8f (button) won ($0.67)
Seat 2: f4a0e033 (small blind) folded on the River
Seat 3: Hero (big blind) folded before Flop
Seat 4: 149da8e2 folded on the River
Seat 5: 1d8dcfab folded before Flop (didn't bet)
Seat 6: aaca7529 folded before Flop (didn't bet)


Poker Hand #RC3141726401: Hold'em No Limit ($0.05/$0.1) - 2024/12/12 13:12:02
Table 'RushAndCash22321661' 6-max Seat #1 is the button
Seat 1: 81834a2f ($13.25 in chips)
Seat 2: Hero ($22.7 in chips)
Seat 3: b4bc8071 ($13.68 in chips)
Seat 4: b0559006 ($4 in chips)
Seat 5: b2132e5f ($10.28 in chips)
Seat 6: b738541f ($11.26 in chips)
Hero: posts small blind $0.05
b4bc8071: posts big blind $0.1
*** HOLE CARDS ***
Dealt to 81834a2f 
Dealt to Hero [Td 9h]
Dealt to b4bc8071 
Dealt to b0559006 
Dealt to b2132e5f 
Dealt to b738541f 
b0559006: folds
b2132e5f: folds
b738541f: folds
81834a2f: raises $0.15 to $0.25
Hero: folds
b4bc8071: folds
Uncalled bet ($0.15) returned to 81834a2f
*** SHOWDOWN ***
81834a2f collected $0.25 from pot
*** SUMMARY ***
Total pot $0.25 | Rake $0 | Jackpot $0 | Bingo $0 | Fortune $0 | Tax $0
Seat 1: 81834a2f (button) collected ($0.25)
Seat 2: Hero (small blind) folded before Flop
Seat 3: b4bc8071 (big blind) folded before Flop
Seat 4: b0559006 folded before Flop (didn't bet)
Seat 5: b2132e5f folded before Flop (didn't bet)
Seat 6: b738541f folded before Flop (didn't bet)


Poker Hand #RC3141726390: Hold'em No Limit ($0.05/$0.1) - 2024/12/12 13:11:58
Table 'RushAndCash22321650' 6-max Seat #1 is the button
Seat 1: 1d2be4c9 ($10.48 in chips)
Seat 2: 974f52 ($32.88 in chips)
Seat 3: 7d40d863 ($10.15 in chips)
Seat 4: Hero ($22.7 in chips)
Seat 5: 254fead6 ($5.2 in chips)
Seat 6: 101c026b ($34.19 in chips)
974f52: posts small blind $0.05
7d40d863: posts big blind $0.1
*** HOLE CARDS ***
Dealt to 1d2be4c9 
Dealt to 974f52 
Dealt to 7d40d863 
Dealt to Hero [Qh 7c]
Dealt to 254fead6 
Dealt to 101c026b 
Hero: folds
254fead6: folds
101c026b: folds
1d2be4c9: raises $0.1 to $0.2
974f52: folds
7d40d863: raises $0.45 to $0.65
1d2be4c9: calls $0.45
*** FLOP *** [7d Ts Ad]
7d40d863: bets $1.35
1d2be4c9: folds
Uncalled bet ($1.35) returned to 7d40d863
*** SHOWDOWN ***
7d40d863 collected $1.29 from pot
*** SUMMARY ***
Total pot $1.35 | Rake $0.06 | Jackpot $0 | Bingo $0 | Fortune $0 | Tax $0
Board [7d Ts Ad]
Seat 1: 1d2be4c9 (button) folded on the Flop
Seat 2: 974f52 (small blind) folded before Flop
Seat 3: 7d40d863 (big blind) won ($1.29)
Seat 4: Hero folded before Flop (didn't bet)
Seat 5: 254fead6 folded before Flop (didn't bet)
Seat 6: 101c026b folded before Flop (didn't bet)


Poker Hand #RC3141726376: Hold'em No Limit ($0.05/$0.1) - 2024/12/12 13:11:55
Table 'RushAndCash22321636' 6-max Seat #1 is the button
Seat 1: a730cdce ($11.3 in chips)
Seat 2: 111c75 ($10.14 in chips)
Seat 3: 16994a2d ($13.76 in chips)
Seat 4: Hero ($22.7 in chips)
Seat 5: 3c7673d9 ($10.71 in chips)
Seat 6: 208ee152 ($13.37 in chips)
111c75: posts small blind $0.05
16994a2d: posts big blind $0.1
*** HOLE CARDS ***
Dealt to a730cdce 
Dealt to 111c75 
Dealt to 16994a2d 
Dealt to Hero [8c 4h]
Dealt to 3c7673d9 
Dealt to 208ee152 
Hero: folds
3c7673d9: folds
208ee152: folds
a730cdce: raises $0.15 to $0.25
111c75: folds
16994a2d: folds
Uncalled bet ($0.15) returned to a730cdce
*** SHOWDOWN ***
a730cdce collected $0.25 from pot
*** SUMMARY ***
Total pot $0.25 | Rake $0 | Jackpot $0 | Bingo $0 | Fortune $0 | Tax $0
Seat 1: a730cdce (button) collected ($0.25)
Seat 2: 111c75 (small blind) folded before Flop
Seat 3: 16994a2d (big blind) folded before Flop
Seat 4: Hero folded before Flop (didn't bet)
Seat 5: 3c7673d9 folded before Flop (didn't bet)
Seat 6: 208ee152 folded before Flop (didn't bet)


Poker Hand #RC3141726321: Hold'em No Limit ($0.05/$0.1) - 2024/12/12 13:11:39
Table 'RushAndCash22321581' 6-max Seat #1 is the button
Seat 1: f564c212 ($12.08 in chips)
Seat 2: Hero ($22.75 in chips)
Seat 3: a2304e34 ($10 in chips)
Seat 4: 54d53a50 ($28.81 in chips)
Seat 5: 41ad32d3 ($22.93 in chips)
Seat 6: 2db5d1cb ($14.73 in chips)
Hero: posts small blind $0.05
a2304e34: posts big blind $0.1
*** HOLE CARDS ***
Dealt to f564c212 
Dealt to Hero [As 5c]
Dealt to a2304e34 
Dealt to 54d53a50 
Dealt to 41ad32d3 
Dealt to 2db5d1cb 
54d53a50: raises $0.1 to $0.2
41ad32d3: folds
2db5d1cb: folds
f564c212: folds
Hero: folds
a2304e34: calls $0.1
*** FLOP *** [Qh 3h 6h]
a2304e34: checks
54d53a50: bets $0.15
a2304e34: calls $0.15
*** TURN *** [Qh 3h 6h] [6c]
a2304e34: checks
54d53a50: bets $0.58
a2304e34: folds
Uncalled bet ($0.58) returned to 54d53a50
*** SHOWDOWN ***
54d53a50 collected $0.72 from pot
*** SUMMARY ***
Total pot $0.75 | Rake $0.03 | Jackpot $0 | Bingo $0 | Fortune $0 | Tax $0
Board [Qh 3h 6h 6c]
Seat 1: f564c212 (button) folded before Flop (didn't bet)
Seat 2: Hero (small blind) folded before Flop
Seat 3: a2304e34 (big blind) folded on the Turn
Seat 4: 54d53a50 won ($0.72)
Seat 5: 41ad32d3 folded before Flop (didn't bet)
Seat 6: 2db5d1cb folded before Flop (didn't bet)


Poker Hand #RC3141726286: Hold'em No Limit ($0.05/$0.1) - 2024/12/12 13:11:29
Table 'RushAndCash22321546' 6-max Seat #1 is the button
Seat 1: c75bf164 ($9.58 in chips)
Seat 2: d515d6ec ($11.63 in chips)
Seat 3: Hero ($22.85 in chips)
Seat 4: 643f85e7 ($10.63 in chips)
Seat 5: 2a6446ed ($12.57 in chips)
Seat 6: fe38852f ($10 in chips)
d515d6ec: posts small blind $0.05
Hero: posts big blind $0.1
*** HOLE CARDS ***
Dealt to c75bf164 
Dealt to d515d6ec 
Dealt to Hero [7h 8c]
Dealt to 643f85e7 
Dealt to 2a6446ed 
Dealt to fe38852f 
643f85e7: folds
2a6446ed: folds
fe38852f: folds
c75bf164: folds
d515d6ec: raises $0.18 to $0.28
Hero: folds
Uncalled bet ($0.18) returned to d515d6ec
*** SHOWDOWN ***
d515d6ec collected $0.2 from pot
*** SUMMARY ***
Total pot $0.2 | Rake $0 | Jackpot $0 | Bingo $0 | Fortune $0 | Tax $0
Seat 1: c75bf164 (button) folded before Flop (didn't bet)
Seat 2: d515d6ec (small blind) collected ($0.2)
Seat 3: Hero (big blind) folded before Flop
Seat 4: 643f85e7 folded before Flop (didn't bet)
Seat 5: 2a6446ed folded before Flop (didn't bet)
Seat 6: fe38852f folded before Flop (didn't bet)


Poker Hand #RC3141726272: Hold'em No Limit ($0.05/$0.1) - 2024/12/12 13:11:25
Table 'RushAndCash22321532' 6-max Seat #1 is the button
Seat 1: Hero ($22.85 in chips)
Seat 2: b9ea8dd9 ($4.38 in chips)
Seat 3: 9cfbee05 ($10 in chips)
Seat 4: bc2007a2 ($20.9 in chips)
Seat 5: fe38852f ($10 in chips)
Seat 6: 22222ecf ($10 in chips)
b9ea8dd9: posts small blind $0.05
9cfbee05: posts big blind $0.1
*** HOLE CARDS ***
Dealt to Hero [6s 3d]
Dealt to b9ea8dd9 
Dealt to 9cfbee05 
Dealt to bc2007a2 
Dealt to fe38852f 
Dealt to 22222ecf 
bc2007a2: folds
fe38852f: folds
22222ecf: folds
Hero: folds
b9ea8dd9: raises $0.1 to $0.2
9cfbee05: calls $0.1
*** FLOP *** [2c 2h 4c]
b9ea8dd9: bets $0.3
9cfbee05: folds
Uncalled bet ($0.3) returned to b9ea8dd9
*** SHOWDOWN ***
b9ea8dd9 collected $0.38 from pot
*** SUMMARY ***
Total pot $0.4 | Rake $0.02 | Jackpot $0 | Bingo $0 | Fortune $0 | Tax $0
Board [2c 2h 4c]
Seat 1: Hero (button) folded before Flop (didn't bet)
Seat 2: b9ea8dd9 (small blind) won ($0.38)
Seat 3: 9cfbee05 (big blind) folded on the Flop
Seat 4: bc2007a2 folded before Flop (didn't bet)
Seat 5: fe38852f folded before Flop (didn't bet)
Seat 6: 22222ecf folded before Flop (didn't bet)


Poker Hand #RC3141725953: Hold'em No Limit ($0.05/$0.1) - 2024/12/12 13:10:04
Table 'RushAndCash22321213' 6-max Seat #1 is the button
Seat 1: 4dd7bc95 ($10 in chips)
Seat 2: bc2007a2 ($20.53 in chips)
Seat 3: b9ea8dd9 ($4.58 in chips)
Seat 4: f3cd242a ($13.51 in chips)
Seat 5: Hero ($23.05 in chips)
Seat 6: 526323fa ($10.78 in chips)
bc2007a2: posts small blind $0.05
b9ea8dd9: posts big blind $0.1
*** HOLE CARDS ***
Dealt to 4dd7bc95 
Dealt to bc2007a2 
Dealt to b9ea8dd9 
Dealt to f3cd242a 
Dealt to Hero [6h 6c]
Dealt to 526323fa 
f3cd242a: folds
Hero: raises $0.1 to $0.2
526323fa: folds
4dd7bc95: folds
bc2007a2: calls $0.15
b9ea8dd9: calls $0.1
*** FLOP *** [8h Ts 7s]
bc2007a2: checks
b9ea8dd9: checks
Hero: checks
*** TURN *** [8h Ts 7s] [Js]
bc2007a2: checks
b9ea8dd9: checks
Hero: checks
*** RIVER *** [8h Ts 7s Js] [8c]
bc2007a2: bets $0.23
b9ea8dd9: folds
Hero: folds
Uncalled bet ($0.23) returned to bc2007a2
*** SHOWDOWN ***
bc2007a2 collected $0.57 from pot
*** SUMMARY ***
Total pot $0.6 | Rake $0.03 | Jackpot $0 | Bingo $0 | Fortune $0 | Tax $0
Board [8h Ts 7s Js 8c]
Seat 1: 4dd7bc95 (button) folded before Flop (didn't bet)
Seat 2: bc2007a2 (small blind) won ($0.57)
Seat 3: b9ea8dd9 (big blind) folded on the River
Seat 4: f3cd242a folded before Flop (didn't bet)
Seat 5: Hero folded on the River
Seat 6: 526323fa folded before Flop (didn't bet)


Poker Hand #RC3141725901: Hold'em No Limit ($0.05/$0.1) - 2024/12/12 13:09:52
Table 'RushAndCash22321161' 6-max Seat #1 is the button
Seat 1: d19ee248 ($9.39 in chips)
Seat 2: ee992e7e ($25.41 in chips)
Seat 3: 88133657 ($10.37 in chips)
Seat 4: 4b9faa96 ($12.1 in chips)
Seat 5: Hero ($22.9 in chips)
Seat 6: 844091a0 ($10.4 in chips)
ee992e7e: posts small blind $0.05
88133657: posts big blind $0.1
*** HOLE CARDS ***
Dealt to d19ee248 
Dealt to ee992e7e 
Dealt to 88133657 
Dealt to 4b9faa96 
Dealt to Hero [Ad Kd]
Dealt to 844091a0 
4b9faa96: folds
Hero: raises $0.1 to $0.2
844091a0: folds
d19ee248: folds
ee992e7e: folds
88133657: folds
Uncalled bet ($0.1) returned to Hero
*** SHOWDOWN ***
Hero collected $0.25 from pot
*** SUMMARY ***
Total pot $0.25 | Rake $0 | Jackpot $0 | Bingo $0 | Fortune $0 | Tax $0
Seat 1: d19ee248 (button) folded before Flop (didn't bet)
Seat 2: ee992e7e (small blind) folded before Flop
Seat 3: 88133657 (big blind) folded before Flop
Seat 4: 4b9faa96 folded before Flop (didn't bet)
Seat 5: Hero collected ($0.25)
Seat 6: 844091a0 folded before Flop (didn't bet)


Poker Hand #RC3141725884: Hold'em No Limit ($0.05/$0.1) - 2024/12/12 13:09:49
Table 'RushAndCash22321144' 6-max Seat #1 is the button
Seat 1: 208ee152 ($13.56 in chips)
Seat 2: d19ee248 ($9.44 in chips)
Seat 3: 73d90cc7 ($11.25 in chips)
Seat 4: Hero ($22.9 in chips)
Seat 5: 61709362 ($12.65 in chips)
Seat 6: f2b49ec ($11.47 in chips)
d19ee248: posts small blind $0.05
73d90cc7: posts big blind $0.1
*** HOLE CARDS ***
Dealt to 208ee152 
Dealt to d19ee248 
Dealt to 73d90cc7 
Dealt to Hero [Ks 7h]
Dealt to 61709362 
Dealt to f2b49ec 
Hero: folds
61709362: folds
f2b49ec: folds
208ee152: folds
d19ee248: folds
Uncalled bet ($0.05) returned to 73d90cc7
*** SHOWDOWN ***
73d90cc7 collected $0.1 from pot
*** SUMMARY ***
Total pot $0.1 | Rake $0 | Jackpot $0 | Bingo $0 | Fortune $0 | Tax $0
Seat 1: 208ee152 (button) folded before Flop (didn't bet)
Seat 2: d19ee248 (small blind) folded before Flop
Seat 3: 73d90cc7 (big blind) collected ($0.1)
Seat 4: Hero folded before Flop (didn't bet)
Seat 5: 61709362 folded before Flop (didn't bet)
Seat 6: f2b49ec folded before Flop (didn't bet)


Poker Hand #RC3141725868: Hold'em No Limit ($0.05/$0.1) - 2024/12/12 13:09:46
Table 'RushAndCash22321128' 6-max Seat #1 is the button
Seat 1: d4deed2f ($11.02 in chips)
Seat 2: 55e95fce ($11.16 in chips)
Seat 3: 974940e1 ($12.49 in chips)
Seat 4: Hero ($22.9 in chips)
Seat 5: a730cdce ($11.19 in chips)
Seat 6: 4cf26e8f ($12.5 in chips)
55e95fce: posts small blind $0.05
974940e1: posts big blind $0.1
*** HOLE CARDS ***
Dealt to d4deed2f 
Dealt to 55e95fce 
Dealt to 974940e1 
Dealt to Hero [Qd 9h]
Dealt to a730cdce 
Dealt to 4cf26e8f 
Hero: folds
a730cdce: folds
4cf26e8f: raises $0.1 to $0.2
d4deed2f: folds
55e95fce: folds
974940e1: calls $0.1
*** FLOP *** [9s 5c 8d]
974940e1: checks
4cf26e8f: bets $0.14
974940e1: folds
Uncalled bet ($0.14) returned to 4cf26e8f
*** SHOWDOWN ***
4cf26e8f collected $0.43 from pot
*** SUMMARY ***
Total pot $0.45 | Rake $0.02 | Jackpot $0 | Bingo $0 | Fortune $0 | Tax $0
Board [9s 5c 8d]
Seat 1: d4deed2f (button) folded before Flop (didn't bet)
Seat 2: 55e95fce (small blind) folded before Flop
Seat 3: 974940e1 (big blind) folded on the Flop
Seat 4: Hero folded before Flop (didn't bet)
Seat 5: a730cdce folded before Flop (didn't bet)
Seat 6: 4cf26e8f won ($0.43)


Poker Hand #RC3141725818: Hold'em No Limit ($0.05/$0.1) - 2024/12/12 13:09:34
Table 'RushAndCash22321078' 6-max Seat #1 is the button
Seat 1: 22ee6f58 ($10.15 in chips)
Seat 2: Hero ($22.95 in chips)
Seat 3: 41ef6e45 ($6.96 in chips)
Seat 4: a9eb45fc ($11.78 in chips)
Seat 5: 95a503e1 ($15.19 in chips)
Seat 6: 11a00985 ($18.01 in chips)
Hero: posts small blind $0.05
41ef6e45: posts big blind $0.1
*** HOLE CARDS ***
Dealt to 22ee6f58 
Dealt to Hero [2d Kd]
Dealt to 41ef6e45 
Dealt to a9eb45fc 
Dealt to 95a503e1 
Dealt to 11a00985 
a9eb45fc: folds
95a503e1: raises $0.14 to $0.24
11a00985: folds
22ee6f58: folds
Hero: folds
41ef6e45: folds
Uncalled bet ($0.14) returned to 95a503e1
*** SHOWDOWN ***
95a503e1 collected $0.25 from pot
*** SUMMARY ***
Total pot $0.25 | Rake $0 | Jackpot $0 | Bingo $0 | Fortune $0 | Tax $0
Seat 1: 22ee6f58 (button) folded before Flop (didn't bet)
Seat 2: Hero (small blind) folded before Flop
Seat 3: 41ef6e45 (big blind) folded before Flop
Seat 4: a9eb45fc folded before Flop (didn't bet)
Seat 5: 95a503e1 collected ($0.25)
Seat 6: 11a00985 folded before Flop (didn't bet)


Poker Hand #RC3141725792: Hold'em No Limit ($0.05/$0.1) - 2024/12/12 13:09:28
Table 'RushAndCash22321052' 6-max Seat #1 is the button
Seat 1: Hero ($22.95 in chips)
Seat 2: 3ff4efa1 ($19.73 in chips)
Seat 3: cc0ee7ad ($8.71 in chips)
Seat 4: 77162ce3 ($11.68 in chips)
Seat 5: bc6d42d6 ($8.75 in chips)
Seat 6: ee394d0a ($10.94 in chips)
3ff4efa1: posts small blind $0.05
cc0ee7ad: posts big blind $0.1
*** HOLE CARDS ***
Dealt to Hero [6d Jd]
Dealt to 3ff4efa1 
Dealt to cc0ee7ad 
Dealt to 77162ce3 
Dealt to bc6d42d6 
Dealt to ee394d0a 
77162ce3: folds
bc6d42d6: raises $0.2 to $0.3
ee394d0a: folds
Hero: folds
3ff4efa1: folds
cc0ee7ad: folds
Uncalled bet ($0.2) returned to bc6d42d6
*** SHOWDOWN ***
bc6d42d6 collected $0.25 from pot
*** SUMMARY ***
Total pot $0.25 | Rake $0 | Jackpot $0 | Bingo $0 | Fortune $0 | Tax $0
Seat 1: Hero (button) folded before Flop (didn't bet)
Seat 2: 3ff4efa1 (small blind) folded before Flop
Seat 3: cc0ee7ad (big blind) folded before Flop
Seat 4: 77162ce3 folded before Flop (didn't bet)
Seat 5: bc6d42d6 collected ($0.25)
Seat 6: ee394d0a folded before Flop (didn't bet)


Poker Hand #RC3141725775: Hold'em No Limit ($0.05/$0.1) - 2024/12/12 13:09:24
Table 'RushAndCash22321035' 6-max Seat #1 is the button
Seat 1: d2714301 ($4.46 in chips)
Seat 2: 11a00985 ($18.06 in chips)
Seat 3: Hero ($23.05 in chips)
Seat 4: 605c108c ($4.85 in chips)
Seat 5: 593f64c7 ($4.73 in chips)
Seat 6: d1764387 ($23.81 in chips)
11a00985: posts small blind $0.05
Hero: posts big blind $0.1
*** HOLE CARDS ***
Dealt to d2714301 
Dealt to 11a00985 
Dealt to Hero [2s 5c]
Dealt to 605c108c 
Dealt to 593f64c7 
Dealt to d1764387 
605c108c: raises $0.1 to $0.2
593f64c7: folds
d1764387: raises $0.42 to $0.62
d2714301: raises $3.84 to $4.46 and is all-in
11a00985: folds
Hero: folds
605c108c: folds
d1764387: folds
Uncalled bet ($3.84) returned to d2714301
*** SHOWDOWN ***
d2714301 collected $1.51 from pot
*** SUMMARY ***
Total pot $1.59 | Rake $0.08 | Jackpot $0 | Bingo $0 | Fortune $0 | Tax $0
Seat 1: d2714301 (button) collected ($1.51)
Seat 2: 11a00985 (small blind) folded before Flop
Seat 3: Hero (big blind) folded before Flop
Seat 4: 605c108c folded before Flop
Seat 5: 593f64c7 folded before Flop (didn't bet)
Seat 6: d1764387 folded before Flop


Poker Hand #RC3141725760: Hold'em No Limit ($0.05/$0.1) - 2024/12/12 13:09:20
Table 'RushAndCash22321020' 6-max Seat #1 is the button
Seat 1: c5141ec9 ($13.6 in chips)
Seat 2: 81834a2f ($13.57 in chips)
Seat 3: 4e5c7119 ($14.4 in chips)
Seat 4: c2b852ae ($7.7 in chips)
Seat 5: f32585e5 ($10 in chips)
Seat 6: Hero ($23.05 in chips)
81834a2f: posts small blind $0.05
4e5c7119: posts big blind $0.1
*** HOLE CARDS ***
Dealt to c5141ec9 
Dealt to 81834a2f 
Dealt to 4e5c7119 
Dealt to c2b852ae 
Dealt to f32585e5 
Dealt to Hero [5d 9h]
c2b852ae: folds
f32585e5: raises $0.1 to $0.2
Hero: folds
c5141ec9: folds
81834a2f: folds
4e5c7119: calls $0.1
*** FLOP *** [4s Td Kc]
4e5c7119: checks
f32585e5: bets $0.13
4e5c7119: calls $0.13
*** TURN *** [4s Td Kc] [Qd]
4e5c7119: checks
f32585e5: checks
*** RIVER *** [4s Td Kc Qd] [Ad]
4e5c7119: bets $0.5
f32585e5: folds
Uncalled bet ($0.5) returned to 4e5c7119
*** SHOWDOWN ***
4e5c7119 collected $0.68 from pot
*** SUMMARY ***
Total pot $0.71 | Rake $0.03 | Jackpot $0 | Bingo $0 | Fortune $0 | Tax $0
Board [4s Td Kc Qd Ad]
Seat 1: c5141ec9 (button) folded before Flop (didn't bet)
Seat 2: 81834a2f (small blind) folded before Flop
Seat 3: 4e5c7119 (big blind) won ($0.68)
Seat 4: c2b852ae folded before Flop (didn't bet)
Seat 5: f32585e5 folded on the River
Seat 6: Hero folded before Flop (didn't bet)


Poker Hand #RC3141725742: Hold'em No Limit ($0.05/$0.1) - 2024/12/12 13:09:17
Table 'RushAndCash22321002' 6-max Seat #1 is the button
Seat 1: Hero ($23.05 in chips)
Seat 2: 718b4a9 ($14.57 in chips)
Seat 3: 60b2f955 ($10.33 in chips)
Seat 4: 1e25b5bb ($15.26 in chips)
Seat 5: a9eb45fc ($11.73 in chips)
Seat 6: 11a00985 ($18.06 in chips)
718b4a9: posts small blind $0.05
60b2f955: posts big blind $0.1
*** HOLE CARDS ***
Dealt to Hero [Jd 4d]
Dealt to 718b4a9 
Dealt to 60b2f955 
Dealt to 1e25b5bb 
Dealt to a9eb45fc 
Dealt to 11a00985 
1e25b5bb: raises $0.1 to $0.2
a9eb45fc: folds
11a00985: folds
Hero: folds
718b4a9: calls $0.15
60b2f955: folds
*** FLOP *** [2c 5c Tc]
718b4a9: checks
1e25b5bb: bets $0.17
718b4a9: folds
Uncalled bet ($0.17) returned to 1e25b5bb
*** SHOWDOWN ***
1e25b5bb collected $0.48 from pot
*** SUMMARY ***
Total pot $0.5 | Rake $0.02 | Jackpot $0 | Bingo $0 | Fortune $0 | Tax $0
Board [2c 5c Tc]
Seat 1: Hero (button) folded before Flop (didn't bet)
Seat 2: 718b4a9 (small blind) folded on the Flop
Seat 3: 60b2f955 (big blind) folded before Flop
Seat 4: 1e25b5bb won ($0.48)
Seat 5: a9eb45fc folded before Flop (didn't bet)
Seat 6: 11a00985 folded before Flop (didn't bet)


Poker Hand #RC3141725726: Hold'em No Limit ($0.05/$0.1) - 2024/12/12 13:09:13
Table 'RushAndCash22320986' 6-max Seat #1 is the button
Seat 1: 48b7cbb7 ($10 in chips)
Seat 2: 526323fa ($10.6 in chips)
Seat 3: 6b0057b1 ($10 in chips)
Seat 4: Hero ($23.05 in chips)
Seat 5: b82279c3 ($26.61 in chips)
Seat 6: a6fdbe1b ($11.38 in chips)
526323fa: posts small blind $0.05
6b0057b1: posts big blind $0.1
*** HOLE CARDS ***
Dealt to 48b7cbb7 
Dealt to 526323fa 
Dealt to 6b0057b1 
Dealt to Hero [As 4d]
Dealt to b82279c3 
Dealt to a6fdbe1b 
Hero: folds
b82279c3: folds
a6fdbe1b: folds
48b7cbb7: raises $0.15 to $0.25
526323fa: folds
6b0057b1: folds
Uncalled bet ($0.15) returned to 48b7cbb7
*** SHOWDOWN ***
48b7cbb7 collected $0.25 from pot
*** SUMMARY ***
Total pot $0.25 | Rake $0 | Jackpot $0 | Bingo $0 | Fortune $0 | Tax $0
Seat 1: 48b7cbb7 (button) collected ($0.25)
Seat 2: 526323fa (small blind) folded before Flop
Seat 3: 6b0057b1 (big blind) folded before Flop
Seat 4: Hero folded before Flop (didn't bet)
Seat 5: b82279c3 folded before Flop (didn't bet)
Seat 6: a6fdbe1b folded before Flop (didn't bet)


Poker Hand #RC3141725454: Hold'em No Limit ($0.05/$0.1) - 2024/12/12 13:08:05
Table 'RushAndCash22320714' 6-max Seat #1 is the button
Seat 1: 727f0a35 ($10.37 in chips)
Seat 2: 8499417 ($11.44 in chips)
Seat 3: 1677a3f4 ($13.97 in chips)
Seat 4: Hero ($22.19 in chips)
Seat 5: f564c212 ($11.92 in chips)
Seat 6: 526323fa ($11.29 in chips)
8499417: posts small blind $0.05
1677a3f4: posts big blind $0.1
*** HOLE CARDS ***
Dealt to 727f0a35 
Dealt to 8499417 
Dealt to 1677a3f4 
Dealt to Hero [8c 8h]
Dealt to f564c212 
Dealt to 526323fa 
Hero: raises $0.1 to $0.2
f564c212: folds
526323fa: calls $0.2
727f0a35: folds
8499417: folds
1677a3f4: calls $0.1
*** FLOP *** [6s Th 8s]
1677a3f4: checks
Hero: checks
526323fa: bets $0.49
1677a3f4: folds
Hero: calls $0.49
*** TURN *** [6s Th 8s] [Js]
Hero: checks
526323fa: checks
*** RIVER *** [6s Th 8s Js] [9d]
Hero: bets $0.54
526323fa: folds
Uncalled bet ($0.54) returned to Hero
*** SHOWDOWN ***
Hero collected $1.55 from pot
*** SUMMARY ***
Total pot $1.63 | Rake $0.08 | Jackpot $0 | Bingo $0 | Fortune $0 | Tax $0
Board [6s Th 8s Js 9d]
Seat 1: 727f0a35 (button) folded before Flop (didn't bet)
Seat 2: 8499417 (small blind) folded before Flop
Seat 3: 1677a3f4 (big blind) folded on the Flop
Seat 4: Hero won ($1.55)
Seat 5: f564c212 folded before Flop (didn't bet)
Seat 6: 526323fa folded on the River


Poker Hand #RC3141725310: Hold'em No Limit ($0.05/$0.1) - 2024/12/12 13:07:28
Table 'RushAndCash22320570' 6-max Seat #1 is the button
Seat 1: 6b0057b1 ($10 in chips)
Seat 2: Hero ($21.82 in chips)
Seat 3: b0bb79df ($10 in chips)
Seat 4: 59d8dcea ($10.15 in chips)
Seat 5: 95a503e1 ($15.49 in chips)
Seat 6: 1677a3f4 ($14.27 in chips)
Hero: posts small blind $0.05
b0bb79df: posts big blind $0.1
*** HOLE CARDS ***
Dealt to 6b0057b1 
Dealt to Hero [Kh Ad]
Dealt to b0bb79df 
Dealt to 59d8dcea 
Dealt to 95a503e1 
Dealt to 1677a3f4 
59d8dcea: folds
95a503e1: folds
1677a3f4: raises $0.2 to $0.3
6b0057b1: folds
Hero: raises $0.7 to $1
b0bb79df: folds
1677a3f4: folds
Uncalled bet ($0.7) returned to Hero
*** SHOWDOWN ***
Hero collected $0.67 from pot
*** SUMMARY ***
Total pot $0.7 | Rake $0.03 | Jackpot $0 | Bingo $0 | Fortune $0 | Tax $0
Seat 1: 6b0057b1 (button) folded before Flop (didn't bet)
Seat 2: Hero (small blind) collected ($0.67)
Seat 3: b0bb79df (big blind) folded before Flop
Seat 4: 59d8dcea folded before Flop (didn't bet)
Seat 5: 95a503e1 folded before Flop (didn't bet)
Seat 6: 1677a3f4 folded before Flop


Poker Hand #RC3141725274: Hold'em No Limit ($0.05/$0.1) - 2024/12/12 13:07:20
Table 'RushAndCash22320534' 6-max Seat #1 is the button
Seat 1: f323cdf3 ($10.65 in chips)
Seat 2: 73d90cc7 ($11.04 in chips)
Seat 3: Hero ($21.92 in chips)
Seat 4: cce00e74 ($9.21 in chips)
Seat 5: f3cd242a ($16.06 in chips)
Seat 6: b8e03e64 ($10.54 in chips)
73d90cc7: posts small blind $0.05
Hero: posts big blind $0.1
*** HOLE CARDS ***
Dealt to f323cdf3 
Dealt to 73d90cc7 
Dealt to Hero [Kh 6c]
Dealt to cce00e74 
Dealt to f3cd242a 
Dealt to b8e03e64 
cce00e74: folds
f3cd242a: folds
b8e03e64: folds
f323cdf3: raises $0.15 to $0.25
73d90cc7: folds
Hero: folds
Uncalled bet ($0.15) returned to f323cdf3
*** SHOWDOWN ***
f323cdf3 collected $0.25 from pot
*** SUMMARY ***
Total pot $0.25 | Rake $0 | Jackpot $0 | Bingo $0 | Fortune $0 | Tax $0
Seat 1: f323cdf3 (button) collected ($0.25)
Seat 2: 73d90cc7 (small blind) folded before Flop
Seat 3: Hero (big blind) folded before Flop
Seat 4: cce00e74 folded before Flop (didn't bet)
Seat 5: f3cd242a folded before Flop (didn't bet)
Seat 6: b8e03e64 folded before Flop (didn't bet)


Poker Hand #RC3141725262: Hold'em No Limit ($0.05/$0.1) - 2024/12/12 13:07:16
Table 'RushAndCash22320522' 6-max Seat #1 is the button
Seat 1: 41ad32d3 ($13.28 in chips)
Seat 2: 647dd971 ($9.25 in chips)
Seat 3: 73d90cc7 ($11.14 in chips)
Seat 4: 22008681 ($6.79 in chips)
Seat 5: Hero ($21.92 in chips)
Seat 6: cce00e74 ($9.21 in chips)
647dd971: posts small blind $0.05
73d90cc7: posts big blind $0.1
*** HOLE CARDS ***
Dealt to 41ad32d3 
Dealt to 647dd971 
Dealt to 73d90cc7 
Dealt to 22008681 
Dealt to Hero [5d Td]
Dealt to cce00e74 
22008681: folds
Hero: folds
cce00e74: folds
41ad32d3: raises $0.15 to $0.25
647dd971: calls $0.2
73d90cc7: folds
*** FLOP *** [9d Qs 4d]
647dd971: bets $0.6
41ad32d3: folds
Uncalled bet ($0.6) returned to 647dd971
*** SHOWDOWN ***
647dd971 collected $0.57 from pot
*** SUMMARY ***
Total pot $0.6 | Rake $0.03 | Jackpot $0 | Bingo $0 | Fortune $0 | Tax $0
Board [9d Qs 4d]
Seat 1: 41ad32d3 (button) folded on the Flop
Seat 2: 647dd971 (small blind) won ($0.57)
Seat 3: 73d90cc7 (big blind) folded before Flop
Seat 4: 22008681 folded before Flop (didn't bet)
Seat 5: Hero folded before Flop (didn't bet)
Seat 6: cce00e74 folded before Flop (didn't bet)


Poker Hand #RC3141725248: Hold'em No Limit ($0.05/$0.1) - 2024/12/12 13:07:13
Table 'RushAndCash22320508' 6-max Seat #1 is the button
Seat 1: 54d53a50 ($29.83 in chips)
Seat 2: 3ff4efa1 ($19.06 in chips)
Seat 3: 1c087ec5 ($41.38 in chips)
Seat 4: d940390d ($19.01 in chips)
Seat 5: 20a8d101 ($38.14 in chips)
Seat 6: Hero ($21.92 in chips)
3ff4efa1: posts small blind $0.05
1c087ec5: posts big blind $0.1
*** HOLE CARDS ***
Dealt to 54d53a50 
Dealt to 3ff4efa1 
Dealt to 1c087ec5 
Dealt to d940390d 
Dealt to 20a8d101 
Dealt to Hero [4h 9c]
d940390d: folds
20a8d101: folds
Hero: folds
54d53a50: raises $0.15 to $0.25
3ff4efa1: folds
1c087ec5: calls $0.15
*** FLOP *** [9h 6s As]
1c087ec5: checks
54d53a50: checks
*** TURN *** [9h 6s As] [5h]
1c087ec5: checks
54d53a50: bets $0.43
1c087ec5: calls $0.43
*** RIVER *** [9h 6s As 5h] [Kh]
1c087ec5: checks
54d53a50: bets $0.95
1c087ec5: calls $0.95
54d53a50: shows [Ac 5d] (Pair of Aces and Pair of Fives)
1c087ec5: shows [Ad 7c] (Pair of Aces)
*** SHOWDOWN ***
54d53a50 collected $3.01 from pot
*** SUMMARY ***
Total pot $3.31 | Rake $0.15 | Jackpot $0.15 | Bingo $0 | Fortune $0 | Tax $0
Board [9h 6s As 5h Kh]
Seat 1: 54d53a50 (button) showed [Ac 5d] and won ($3.01) with Pair of Aces and Pair of Fives
Seat 2: 3ff4efa1 (small blind) folded before Flop
Seat 3: 1c087ec5 (big blind) showed [Ad 7c] and lost with Pair of Aces
Seat 4: d940390d folded before Flop (didn't bet)
Seat 5: 20a8d101 folded before Flop (didn't bet)
Seat 6: Hero folded before Flop (didn't bet)


Poker Hand #RC3141725233: Hold'em No Limit ($0.05/$0.1) - 2024/12/12 13:07:10
Table 'RushAndCash22320493' 6-max Seat #1 is the button
Seat 1: bc092e13 ($10 in chips)
Seat 2: 902b9d1a ($9.68 in chips)
Seat 3: ee992e7e ($24.3 in chips)
Seat 4: Hero ($21.92 in chips)
Seat 5: 84c13d8 ($27.65 in chips)
Seat 6: 3b12e634 ($12.73 in chips)
902b9d1a: posts small blind $0.05
ee992e7e: posts big blind $0.1
*** HOLE CARDS ***
Dealt to bc092e13 
Dealt to 902b9d1a 
Dealt to ee992e7e 
Dealt to Hero [7d 9c]
Dealt to 84c13d8 
Dealt to 3b12e634 
Hero: folds
84c13d8: raises $0.1 to $0.2
3b12e634: folds
bc092e13: folds
902b9d1a: folds
ee992e7e: calls $0.1
*** FLOP *** [Qh Kd Jc]
ee992e7e: checks
84c13d8: checks
*** TURN *** [Qh Kd Jc] [5d]
ee992e7e: bets $0.34
84c13d8: folds
Uncalled bet ($0.34) returned to ee992e7e
*** SHOWDOWN ***
ee992e7e collected $0.43 from pot
*** SUMMARY ***
Total pot $0.45 | Rake $0.02 | Jackpot $0 | Bingo $0 | Fortune $0 | Tax $0
Board [Qh Kd Jc 5d]
Seat 1: bc092e13 (button) folded before Flop (didn't bet)
Seat 2: 902b9d1a (small blind) folded before Flop
Seat 3: ee992e7e (big blind) won ($0.43)
Seat 4: Hero folded before Flop (didn't bet)
Seat 5: 84c13d8 folded on the Turn
Seat 6: 3b12e634 folded before Flop (didn't bet)


Poker Hand #RC3141725215: Hold'em No Limit ($0.05/$0.1) - 2024/12/12 13:07:05
Table 'RushAndCash22320475' 6-max Seat #1 is the button
Seat 1: 77907fc4 ($16.23 in chips)
Seat 2: 9c1507dc ($10.05 in chips)
Seat 3: 6d89c9cc ($12.61 in chips)
Seat 4: Hero ($21.92 in chips)
Seat 5: c8c2a1e ($10.26 in chips)
Seat 6: 1a8ef95a ($10 in chips)
9c1507dc: posts small blind $0.05
6d89c9cc: posts big blind $0.1
*** HOLE CARDS ***
Dealt to 77907fc4 
Dealt to 9c1507dc 
Dealt to 6d89c9cc 
Dealt to Hero [Ad 9h]
Dealt to c8c2a1e 
Dealt to 1a8ef95a 
Hero: folds
c8c2a1e: folds
1a8ef95a: folds
77907fc4: raises $0.15 to $0.25
9c1507dc: folds
6d89c9cc: raises $0.75 to $1
77907fc4: calls $0.75
*** FLOP *** [Qs 9s 8h]
6d89c9cc: bets $1.03
77907fc4: calls $1.03
*** TURN *** [Qs 9s 8h] [Ac]
6d89c9cc: bets $2.06
77907fc4: raises $12.14 to $14.2 and is all-in
6d89c9cc: calls $8.52 and is all-in
Uncalled bet ($3.62) returned to 77907fc4
77907fc4: shows [8d 8s] (Three Eights)
6d89c9cc: shows [Qc Qd] (Three Queens)
*** RIVER *** [Qs 9s 8h Ac] [4d]
*** SHOWDOWN ***
6d89c9cc collected $24.82 from pot
*** SUMMARY ***
Total pot $25.27 | Rake $0.3 | Jackpot $0.15 | Bingo $0 | Fortune $0 | Tax $0
Board [Qs 9s 8h Ac 4d]
Seat 1: 77907fc4 (button) showed [8d 8s] and lost with Three Eights
Seat 2: 9c1507dc (small blind) folded before Flop
Seat 3: 6d89c9cc (big blind) showed [Qc Qd] and won ($24.82) with Three Queens
Seat 4: Hero folded before Flop (didn't bet)
Seat 5: c8c2a1e folded before Flop (didn't bet)
Seat 6: 1a8ef95a folded before Flop (didn't bet)


Poker Hand #RC3141725138: Hold'em No Limit ($0.05/$0.1) - 2024/12/12 13:06:48
Table 'RushAndCash22320398' 6-max Seat #1 is the button
Seat 1: 593f64c7 ($2.27 in chips)
Seat 2: a6fdbe1b ($10.67 in chips)
Seat 3: Hero ($22.02 in chips)
Seat 4: c5141ec9 ($14.4 in chips)
Seat 5: 671b32fd ($14.91 in chips)
Seat 6: a0f1bc98 ($10.7 in chips)
a6fdbe1b: posts small blind $0.05
Hero: posts big blind $0.1
*** HOLE CARDS ***
Dealt to 593f64c7 
Dealt to a6fdbe1b 
Dealt to Hero [Ad 6h]
Dealt to c5141ec9 
Dealt to 671b32fd 
Dealt to a0f1bc98 
c5141ec9: raises $0.15 to $0.25
671b32fd: folds
a0f1bc98: folds
593f64c7: folds
a6fdbe1b: calls $0.2
Hero: folds
*** FLOP *** [7d 8h As]
a6fdbe1b: checks
c5141ec9: checks
*** TURN *** [7d 8h As] [Jc]
a6fdbe1b: checks
c5141ec9: checks
*** RIVER *** [7d 8h As Jc] [2c]
a6fdbe1b: bets $0.6
c5141ec9: calls $0.6
a6fdbe1b: shows [Js Ac] (Pair of Aces and Pair of Jacks)
c5141ec9: shows [Kh Kc] (Pair of Kings)
*** SHOWDOWN ***
a6fdbe1b collected $1.71 from pot
*** SUMMARY ***
Total pot $1.8 | Rake $0.09 | Jackpot $0 | Bingo $0 | Fortune $0 | Tax $0
Board [7d 8h As Jc 2c]
Seat 1: 593f64c7 (button) folded before Flop (didn't bet)
Seat 2: a6fdbe1b (small blind) showed [Js Ac] and won ($1.71) with Pair of Aces and Pair of Jacks
Seat 3: Hero (big blind) folded before Flop
Seat 4: c5141ec9 showed [Kh Kc] and lost with Pair of Kings
Seat 5: 671b32fd folded before Flop (didn't bet)
Seat 6: a0f1bc98 folded before Flop (didn't bet)


Poker Hand #RC3141725124: Hold'em No Limit ($0.05/$0.1) - 2024/12/12 13:06:45
Table 'RushAndCash22320384' 6-max Seat #1 is the button
Seat 1: 7b43c302 ($10 in chips)
Seat 2: Hero ($22.07 in chips)
Seat 3: d827b781 ($11.77 in chips)
Seat 4: 844091a0 ($10.91 in chips)
Seat 5: c4d674fe ($13.54 in chips)
Seat 6: 3ff4efa1 ($19.26 in chips)
Hero: posts small blind $0.05
d827b781: posts big blind $0.1
*** HOLE CARDS ***
Dealt to 7b43c302 
Dealt to Hero [8c 2s]
Dealt to d827b781 
Dealt to 844091a0 
Dealt to c4d674fe 
Dealt to 3ff4efa1 
844091a0: raises $0.12 to $0.22
c4d674fe: folds
3ff4efa1: folds
7b43c302: folds
Hero: folds
d827b781: folds
Uncalled bet ($0.12) returned to 844091a0
*** SHOWDOWN ***
844091a0 collected $0.25 from pot
*** SUMMARY ***
Total pot $0.25 | Rake $0 | Jackpot $0 | Bingo $0 | Fortune $0 | Tax $0
Seat 1: 7b43c302 (button) folded before Flop (didn't bet)
Seat 2: Hero (small blind) folded before Flop
Seat 3: d827b781 (big blind) folded before Flop
Seat 4: 844091a0 collected ($0.25)
Seat 5: c4d674fe folded before Flop (didn't bet)
Seat 6: 3ff4efa1 folded before Flop (didn't bet)


Poker Hand #RC3141725104: Hold'em No Limit ($0.05/$0.1) - 2024/12/12 13:06:41
Table 'RushAndCash22320364' 6-max Seat #1 is the button
Seat 1: 5b982aa5 ($10.51 in chips)
Seat 2: 68283690 ($15.08 in chips)
Seat 3: aecd8c87 ($11.21 in chips)
Seat 4: Hero ($22.07 in chips)
Seat 5: 9ef3daf1 ($17.98 in chips)
Seat 6: bf6a4250 ($10.7 in chips)
68283690: posts small blind $0.05
aecd8c87: posts big blind $0.1
*** HOLE CARDS ***
Dealt to 5b982aa5 
Dealt to 68283690 
Dealt to aecd8c87 
Dealt to Hero [4c Qc]
Dealt to 9ef3daf1 
Dealt to bf6a4250 
Hero: folds
9ef3daf1: folds
bf6a4250: raises $0.1 to $0.2
5b982aa5: folds
68283690: folds
aecd8c87: calls $0.1
*** FLOP *** [5s As Ks]
aecd8c87: checks
bf6a4250: bets $0.3
aecd8c87: calls $0.3
*** TURN *** [5s As Ks] [7h]
aecd8c87: checks
bf6a4250: bets $0.7
aecd8c87: folds
Uncalled bet ($0.7) returned to bf6a4250
*** SHOWDOWN ***
bf6a4250 collected $1 from pot
*** SUMMARY ***
Total pot $1.05 | Rake $0.05 | Jackpot $0 | Bingo $0 | Fortune $0 | Tax $0
Board [5s As Ks 7h]
Seat 1: 5b982aa5 (button) folded before Flop (didn't bet)
Seat 2: 68283690 (small blind) folded before Flop
Seat 3: aecd8c87 (big blind) folded on the Turn
Seat 4: Hero folded before Flop (didn't bet)
Seat 5: 9ef3daf1 folded before Flop (didn't bet)
Seat 6: bf6a4250 won ($1)


Poker Hand #RC3141725088: Hold'em No Limit ($0.05/$0.1) - 2024/12/12 13:06:37
Table 'RushAndCash22320348' 6-max Seat #1 is the button
Seat 1: a699d2de ($7.95 in chips)
Seat 2: 721d2ee6 ($13.74 in chips)
Seat 3: 42c70f64 ($10 in chips)
Seat 4: 3f1c4e6e ($11.45 in chips)
Seat 5: Hero ($22.07 in chips)
Seat 6: 4e5c7119 ($14.6 in chips)
721d2ee6: posts small blind $0.05
42c70f64: posts big blind $0.1
*** HOLE CARDS ***
Dealt to a699d2de 
Dealt to 721d2ee6 
Dealt to 42c70f64 
Dealt to 3f1c4e6e 
Dealt to Hero [6s 9h]
Dealt to 4e5c7119 
3f1c4e6e: folds
Hero: folds
4e5c7119: folds
a699d2de: folds
721d2ee6: folds
Uncalled bet ($0.05) returned to 42c70f64
*** SHOWDOWN ***
42c70f64 collected $0.1 from pot
*** SUMMARY ***
Total pot $0.1 | Rake $0 | Jackpot $0 | Bingo $0 | Fortune $0 | Tax $0
Seat 1: a699d2de (button) folded before Flop (didn't bet)
Seat 2: 721d2ee6 (small blind) folded before Flop
Seat 3: 42c70f64 (big blind) collected ($0.1)
Seat 4: 3f1c4e6e folded before Flop (didn't bet)
Seat 5: Hero folded before Flop (didn't bet)
Seat 6: 4e5c7119 folded before Flop (didn't bet)


Poker Hand #RC3141725072: Hold'em No Limit ($0.05/$0.1) - 2024/12/12 13:06:33
Table 'RushAndCash22320332' 6-max Seat #1 is the button
Seat 1: Hero ($22.07 in chips)
Seat 2: c4d674fe ($13.69 in chips)
Seat 3: 5b982aa5 ($10.61 in chips)
Seat 4: b8e03e64 ($10.79 in chips)
Seat 5: 2e3105a5 ($11.18 in chips)
Seat 6: 3f1c4e6e ($11.45 in chips)
c4d674fe: posts small blind $0.05
5b982aa5: posts big blind $0.1
*** HOLE CARDS ***
Dealt to Hero [Ts 2d]
Dealt to c4d674fe 
Dealt to 5b982aa5 
Dealt to b8e03e64 
Dealt to 2e3105a5 
Dealt to 3f1c4e6e 
b8e03e64: folds
2e3105a5: raises $0.15 to $0.25
3f1c4e6e: folds
Hero: folds
c4d674fe: folds
5b982aa5: folds
Uncalled bet ($0.15) returned to 2e3105a5
*** SHOWDOWN ***
2e3105a5 collected $0.25 from pot
*** SUMMARY ***
Total pot $0.25 | Rake $0 | Jackpot $0 | Bingo $0 | Fortune $0 | Tax $0
Seat 1: Hero (button) folded before Flop (didn't bet)
Seat 2: c4d674fe (small blind) folded before Flop
Seat 3: 5b982aa5 (big blind) folded before Flop
Seat 4: b8e03e64 folded before Flop (didn't bet)
Seat 5: 2e3105a5 collected ($0.25)
Seat 6: 3f1c4e6e folded before Flop (didn't bet)


Poker Hand #RC3141725060: Hold'em No Limit ($0.05/$0.1) - 2024/12/12 13:06:30
Table 'RushAndCash22320320' 6-max Seat #1 is the button
Seat 1: 1eed6c31 ($8.5 in chips)
Seat 2: Hero ($22.12 in chips)
Seat 3: 4e5c7119 ($14.55 in chips)
Seat 4: aa6f9192 ($10.15 in chips)
Seat 5: 6c4ba3fb ($17.12 in chips)
Seat 6: bc092e13 ($10 in chips)
Hero: posts small blind $0.05
4e5c7119: posts big blind $0.1
*** HOLE CARDS ***
Dealt to 1eed6c31 
Dealt to Hero [2h 7s]
Dealt to 4e5c7119 
Dealt to aa6f9192 
Dealt to 6c4ba3fb 
Dealt to bc092e13 
aa6f9192: folds
6c4ba3fb: folds
bc092e13: folds
1eed6c31: folds
Hero: folds
Uncalled bet ($0.05) returned to 4e5c7119
*** SHOWDOWN ***
4e5c7119 collected $0.1 from pot
*** SUMMARY ***
Total pot $0.1 | Rake $0 | Jackpot $0 | Bingo $0 | Fortune $0 | Tax $0
Seat 1: 1eed6c31 (button) folded before Flop (didn't bet)
Seat 2: Hero (small blind) folded before Flop
Seat 3: 4e5c7119 (big blind) collected ($0.1)
Seat 4: aa6f9192 folded before Flop (didn't bet)
Seat 5: 6c4ba3fb folded before Flop (didn't bet)
Seat 6: bc092e13 folded before Flop (didn't bet)


Poker Hand #RC3141725047: Hold'em No Limit ($0.05/$0.1) - 2024/12/12 13:06:26
Table 'RushAndCash22320307' 6-max Seat #1 is the button
Seat 1: Hero ($22.12 in chips)
Seat 2: b4bc8071 ($14.09 in chips)
Seat 3: c6786b68 ($12.49 in chips)
Seat 4: 37686872 ($14.84 in chips)
Seat 5: 6b0057b1 ($10.18 in chips)
Seat 6: bc2007a2 ($18.2 in chips)
b4bc8071: posts small blind $0.05
c6786b68: posts big blind $0.1
*** HOLE CARDS ***
Dealt to Hero [Qc 5c]
Dealt to b4bc8071 
Dealt to c6786b68 
Dealt to 37686872 
Dealt to 6b0057b1 
Dealt to bc2007a2 
37686872: folds
6b0057b1: folds
bc2007a2: folds
Hero: folds
b4bc8071: raises $0.15 to $0.25
c6786b68: folds
Uncalled bet ($0.15) returned to b4bc8071
*** SHOWDOWN ***
b4bc8071 collected $0.2 from pot
*** SUMMARY ***
Total pot $0.2 | Rake $0 | Jackpot $0 | Bingo $0 | Fortune $0 | Tax $0
Seat 1: Hero (button) folded before Flop (didn't bet)
Seat 2: b4bc8071 (small blind) collected ($0.2)
Seat 3: c6786b68 (big blind) folded before Flop
Seat 4: 37686872 folded before Flop (didn't bet)
Seat 5: 6b0057b1 folded before Flop (didn't bet)
Seat 6: bc2007a2 folded before Flop (didn't bet)


Poker Hand #RC3141725003: Hold'em No Limit ($0.05/$0.1) - 2024/12/12 13:06:14
Table 'RushAndCash22320263' 6-max Seat #1 is the button
Seat 1: bb0086cf ($10 in chips)
Seat 2: b8e03e64 ($10.84 in chips)
Seat 3: Hero ($22.07 in chips)
Seat 4: 264523b9 ($9.69 in chips)
Seat 5: 111c75 ($11.31 in chips)
Seat 6: a0f1bc98 ($10.85 in chips)
b8e03e64: posts small blind $0.05
Hero: posts big blind $0.1
*** HOLE CARDS ***
Dealt to bb0086cf 
Dealt to b8e03e64 
Dealt to Hero [3h 6d]
Dealt to 264523b9 
Dealt to 111c75 
Dealt to a0f1bc98 
264523b9: folds
111c75: folds
a0f1bc98: folds
bb0086cf: folds
b8e03e64: folds
Uncalled bet ($0.05) returned to Hero
*** SHOWDOWN ***
Hero collected $0.1 from pot
*** SUMMARY ***
Total pot $0.1 | Rake $0 | Jackpot $0 | Bingo $0 | Fortune $0 | Tax $0
Seat 1: bb0086cf (button) folded before Flop (didn't bet)
Seat 2: b8e03e64 (small blind) folded before Flop
Seat 3: Hero (big blind) collected ($0.1)
Seat 4: 264523b9 folded before Flop (didn't bet)
Seat 5: 111c75 folded before Flop (didn't bet)
Seat 6: a0f1bc98 folded before Flop (didn't bet)


Poker Hand #RC3141724987: Hold'em No Limit ($0.05/$0.1) - 2024/12/12 13:06:11
Table 'RushAndCash22320247' 6-max Seat #1 is the button
Seat 1: a0f1bc98 ($10.85 in chips)
Seat 2: 7bad2adb ($10 in chips)
Seat 3: 175b201a ($3.9 in chips)
Seat 4: bb0086cf ($10 in chips)
Seat 5: Hero ($22.07 in chips)
Seat 6: 22e8274e ($16.49 in chips)
7bad2adb: posts small blind $0.05
175b201a: posts big blind $0.1
*** HOLE CARDS ***
Dealt to a0f1bc98 
Dealt to 7bad2adb 
Dealt to 175b201a 
Dealt to bb0086cf 
Dealt to Hero [Td 6h]
Dealt to 22e8274e 
bb0086cf: folds
Hero: folds
22e8274e: folds
a0f1bc98: folds
7bad2adb: folds
Uncalled bet ($0.05) returned to 175b201a
*** SHOWDOWN ***
175b201a collected $0.1 from pot
*** SUMMARY ***
Total pot $0.1 | Rake $0 | Jackpot $0 | Bingo $0 | Fortune $0 | Tax $0
Seat 1: a0f1bc98 (button) folded before Flop (didn't bet)
Seat 2: 7bad2adb (small blind) folded before Flop
Seat 3: 175b201a (big blind) collected ($0.1)
Seat 4: bb0086cf folded before Flop (didn't bet)
Seat 5: Hero folded before Flop (didn't bet)
Seat 6: 22e8274e folded before Flop (didn't bet)


Poker Hand #RC3141724796: Hold'em No Limit ($0.05/$0.1) - 2024/12/12 13:05:21
Table 'RushAndCash22320056' 6-max Seat #1 is the button
Seat 1: ec911a8a ($22.68 in chips)
Seat 2: 3c989a00 ($24.74 in chips)
Seat 3: 208ee152 ($9.24 in chips)
Seat 4: Hero ($22.27 in chips)
Seat 5: 2769a057 ($10 in chips)
Seat 6: 11a00985 ($17.06 in chips)
3c989a00: posts small blind $0.05
208ee152: posts big blind $0.1
*** HOLE CARDS ***
Dealt to ec911a8a 
Dealt to 3c989a00 
Dealt to 208ee152 
Dealt to Hero [Ks 9s]
Dealt to 2769a057 
Dealt to 11a00985 
Hero: raises $0.1 to $0.2
2769a057: folds
11a00985: folds
ec911a8a: calls $0.2
3c989a00: folds
208ee152: folds
*** FLOP *** [3h Jc Td]
Hero: checks
ec911a8a: checks
*** TURN *** [3h Jc Td] [6s]
Hero: checks
ec911a8a: bets $0.32
Hero: folds
Uncalled bet ($0.32) returned to ec911a8a
*** SHOWDOWN ***
ec911a8a collected $0.53 from pot
*** SUMMARY ***
Total pot $0.55 | Rake $0.02 | Jackpot $0 | Bingo $0 | Fortune $0 | Tax $0
Board [3h Jc Td 6s]
Seat 1: ec911a8a (button) won ($0.53)
Seat 2: 3c989a00 (small blind) folded before Flop
Seat 3: 208ee152 (big blind) folded before Flop
Seat 4: Hero folded on the Turn
Seat 5: 2769a057 folded before Flop (didn't bet)
Seat 6: 11a00985 folded before Flop (didn't bet)


Poker Hand #RC3141724784: Hold'em No Limit ($0.05/$0.1) - 2024/12/12 13:05:17
Table 'RushAndCash22320044' 6-max Seat #1 is the button
Seat 1: bacbbd0c ($8.53 in chips)
Seat 2: e04e7077 ($10 in chips)
Seat 3: 1e25b5bb ($15.31 in chips)
Seat 4: Hero ($22.27 in chips)
Seat 5: a730cdce ($10.68 in chips)
Seat 6: b4bc8071 ($13.82 in chips)
e04e7077: posts small blind $0.05
1e25b5bb: posts big blind $0.1
*** HOLE CARDS ***
Dealt to bacbbd0c 
Dealt to e04e7077 
Dealt to 1e25b5bb 
Dealt to Hero [9c 5c]
Dealt to a730cdce 
Dealt to b4bc8071 
Hero: folds
a730cdce: folds
b4bc8071: folds
bacbbd0c: raises $0.1 to $0.2
e04e7077: folds
1e25b5bb: folds
Uncalled bet ($0.1) returned to bacbbd0c
*** SHOWDOWN ***
bacbbd0c collected $0.25 from pot
*** SUMMARY ***
Total pot $0.25 | Rake $0 | Jackpot $0 | Bingo $0 | Fortune $0 | Tax $0
Seat 1: bacbbd0c (button) collected ($0.25)
Seat 2: e04e7077 (small blind) folded before Flop
Seat 3: 1e25b5bb (big blind) folded before Flop
Seat 4: Hero folded before Flop (didn't bet)
Seat 5: a730cdce folded before Flop (didn't bet)
Seat 6: b4bc8071 folded before Flop (didn't bet)


Poker Hand #RC3141674720: Hold'em No Limit ($0.05/$0.1) - 2024/12/12 13:05:00
Table 'RushAndCash22319980' 6-max Seat #1 is the button
Seat 1: 36e85ed3 ($12.41 in chips)
Seat 2: 55e95fce ($11.34 in chips)
Seat 3: c6352e1c ($10 in chips)
Seat 4: cf64da1a ($22.31 in chips)
Seat 5: Hero ($22.12 in chips)
Seat 6: 226dbbb0 ($10.56 in chips)
55e95fce: posts small blind $0.05
c6352e1c: posts big blind $0.1
*** HOLE CARDS ***
Dealt to 36e85ed3 
Dealt to 55e95fce 
Dealt to c6352e1c 
Dealt to cf64da1a 
Dealt to Hero [Qd Jh]
Dealt to 226dbbb0 
cf64da1a: folds
Hero: raises $0.1 to $0.2
226dbbb0: folds
36e85ed3: folds
55e95fce: folds
c6352e1c: folds
Uncalled bet ($0.1) returned to Hero
*** SHOWDOWN ***
Hero collected $0.25 from pot
*** SUMMARY ***
Total pot $0.25 | Rake $0 | Jackpot $0 | Bingo $0 | Fortune $0 | Tax $0
Seat 1: 36e85ed3 (button) folded before Flop (didn't bet)
Seat 2: 55e95fce (small blind) folded before Flop
Seat 3: c6352e1c (big blind) folded before Flop
Seat 4: cf64da1a folded before Flop (didn't bet)
Seat 5: Hero collected ($0.25)
Seat 6: 226dbbb0 folded before Flop (didn't bet)


Poker Hand #RC3141674702: Hold'em No Limit ($0.05/$0.1) - 2024/12/12 13:04:54
Table 'RushAndCash22319962' 6-max Seat #1 is the button
Seat 1: afe10f69 ($10.23 in chips)
Seat 2: Hero ($22.17 in chips)
Seat 3: 86ee8e36 ($29.41 in chips)
Seat 4: b8e03e64 ($11.09 in chips)
Seat 5: 68283690 ($14.37 in chips)
Seat 6: 6731d495 ($10 in chips)
Hero: posts small blind $0.05
86ee8e36: posts big blind $0.1
*** HOLE CARDS ***
Dealt to afe10f69 
Dealt to Hero [9c Kh]
Dealt to 86ee8e36 
Dealt to b8e03e64 
Dealt to 68283690 
Dealt to 6731d495 
b8e03e64: raises $0.1 to $0.2
68283690: folds
6731d495: folds
afe10f69: folds
Hero: folds
86ee8e36: folds
Uncalled bet ($0.1) returned to b8e03e64
*** SHOWDOWN ***
b8e03e64 collected $0.25 from pot
*** SUMMARY ***
Total pot $0.25 | Rake $0 | Jackpot $0 | Bingo $0 | Fortune $0 | Tax $0
Seat 1: afe10f69 (button) folded before Flop (didn't bet)
Seat 2: Hero (small blind) folded before Flop
Seat 3: 86ee8e36 (big blind) folded before Flop
Seat 4: b8e03e64 collected ($0.25)
Seat 5: 68283690 folded before Flop (didn't bet)
Seat 6: 6731d495 folded before Flop (didn't bet)


Poker Hand #RC3141674424: Hold'em No Limit ($0.05/$0.1) - 2024/12/12 13:03:44
Table 'RushAndCash22319684' 6-max Seat #1 is the button
Seat 1: b8e03e64 ($14.38 in chips)
Seat 2: 4de3c51 ($10.45 in chips)
Seat 3: Hero ($19.28 in chips)
Seat 4: 58f45f04 ($11.47 in chips)
Seat 5: 5041f166 ($9.83 in chips)
Seat 6: 228a039d ($14.11 in chips)
4de3c51: posts small blind $0.05
Hero: posts big blind $0.1
*** HOLE CARDS ***
Dealt to b8e03e64 
Dealt to 4de3c51 
Dealt to Hero [Jh Qc]
Dealt to 58f45f04 
Dealt to 5041f166 
Dealt to 228a039d 
58f45f04: folds
5041f166: folds
228a039d: folds
b8e03e64: raises $0.1 to $0.2
4de3c51: folds
Hero: calls $0.1
*** FLOP *** [Ad Qh Qd]
Hero: checks
b8e03e64: bets $0.34
Hero: calls $0.34
*** TURN *** [Ad Qh Qd] [9h]
Hero: checks
b8e03e64: bets $0.85
Hero: calls $0.85
*** RIVER *** [Ad Qh Qd 9h] [2s]
Hero: checks
b8e03e64: bets $1.9
Hero: calls $1.9
b8e03e64: shows [Qs Ts] (Three Queens)
Hero: shows [Jh Qc] (Three Queens)
*** SHOWDOWN ***
Hero collected $6.18 from pot
*** SUMMARY ***
Total pot $6.63 | Rake $0.3 | Jackpot $0.15 | Bingo $0 | Fortune $0 | Tax $0
Board [Ad Qh Qd 9h 2s]
Seat 1: b8e03e64 (button) showed [Qs Ts] and lost with Three Queens
Seat 2: 4de3c51 (small blind) folded before Flop
Seat 3: Hero (big blind) showed [Jh Qc] and won ($6.18) with Three Queens
Seat 4: 58f45f04 folded before Flop (didn't bet)
Seat 5: 5041f166 folded before Flop (didn't bet)
Seat 6: 228a039d folded before Flop (didn't bet)


Poker Hand #RC3141674394: Hold'em No Limit ($0.05/$0.1) - 2024/12/12 13:03:37
Table 'RushAndCash22319654' 6-max Seat #1 is the button
Seat 1: Hero ($19.28 in chips)
Seat 2: f383ae87 ($21.71 in chips)
Seat 3: cce00e74 ($9.56 in chips)
Seat 4: b738541f ($13.12 in chips)
Seat 5: c2b852ae ($9.44 in chips)
Seat 6: c7bc4949 ($8.83 in chips)
f383ae87: posts small blind $0.05
cce00e74: posts big blind $0.1
*** HOLE CARDS ***
Dealt to Hero [Qs Jc]
Dealt to f383ae87 
Dealt to cce00e74 
Dealt to b738541f 
Dealt to c2b852ae 
Dealt to c7bc4949 
b738541f: folds
c2b852ae: raises $0.12 to $0.22
c7bc4949: calls $0.22
Hero: folds
f383ae87: folds
cce00e74: folds
*** FLOP *** [2d Th Ad]
c2b852ae: checks
c7bc4949: checks
*** TURN *** [2d Th Ad] [Qc]
c2b852ae: checks
c7bc4949: bets $0.3
c2b852ae: folds
Uncalled bet ($0.3) returned to c7bc4949
*** SHOWDOWN ***
c7bc4949 collected $0.56 from pot
*** SUMMARY ***
Total pot $0.59 | Rake $0.03 | Jackpot $0 | Bingo $0 | Fortune $0 | Tax $0
Board [2d Th Ad Qc]
Seat 1: Hero (button) folded before Flop (didn't bet)
Seat 2: f383ae87 (small blind) folded before Flop
Seat 3: cce00e74 (big blind) folded before Flop
Seat 4: b738541f folded before Flop (didn't bet)
Seat 5: c2b852ae folded on the Turn
Seat 6: c7bc4949 won ($0.56)


Poker Hand #RC3141674381: Hold'em No Limit ($0.05/$0.1) - 2024/12/12 13:03:34
Table 'RushAndCash22319641' 6-max Seat #1 is the button
Seat 1: 66a73913 ($17.1 in chips)
Seat 2: f347a136 ($11.6 in chips)
Seat 3: f5628a04 ($15.71 in chips)
Seat 4: cce00e74 ($9.56 in chips)
Seat 5: b738541f ($13.12 in chips)
Seat 6: Hero ($19.28 in chips)
f347a136: posts small blind $0.05
f5628a04: posts big blind $0.1
*** HOLE CARDS ***
Dealt to 66a73913 
Dealt to f347a136 
Dealt to f5628a04 
Dealt to cce00e74 
Dealt to b738541f 
Dealt to Hero [7s Qd]
cce00e74: folds
b738541f: folds
Hero: folds
66a73913: folds
f347a136: folds
Uncalled bet ($0.05) returned to f5628a04
*** SHOWDOWN ***
f5628a04 collected $0.1 from pot
*** SUMMARY ***
Total pot $0.1 | Rake $0 | Jackpot $0 | Bingo $0 | Fortune $0 | Tax $0
Seat 1: 66a73913 (button) folded before Flop (didn't bet)
Seat 2: f347a136 (small blind) folded before Flop
Seat 3: f5628a04 (big blind) collected ($0.1)
Seat 4: cce00e74 folded before Flop (didn't bet)
Seat 5: b738541f folded before Flop (didn't bet)
Seat 6: Hero folded before Flop (didn't bet)


Poker Hand #RC3141674369: Hold'em No Limit ($0.05/$0.1) - 2024/12/12 13:03:30
Table 'RushAndCash22319629' 6-max Seat #1 is the button
Seat 1: 36e85ed3 ($12.56 in chips)
Seat 2: 24c2159e ($10.15 in chips)
Seat 3: b8e03e64 ($14.58 in chips)
Seat 4: bb835227 ($11.8 in chips)
Seat 5: cce00e74 ($9.56 in chips)
Seat 6: Hero ($19.28 in chips)
24c2159e: posts small blind $0.05
b8e03e64: posts big blind $0.1
*** HOLE CARDS ***
Dealt to 36e85ed3 
Dealt to 24c2159e 
Dealt to b8e03e64 
Dealt to bb835227 
Dealt to cce00e74 
Dealt to Hero [8h 3c]
bb835227: folds
cce00e74: folds
Hero: folds
36e85ed3: folds
24c2159e: raises $0.2 to $0.3
b8e03e64: folds
Uncalled bet ($0.2) returned to 24c2159e
*** SHOWDOWN ***
24c2159e collected $0.2 from pot
*** SUMMARY ***
Total pot $0.2 | Rake $0 | Jackpot $0 | Bingo $0 | Fortune $0 | Tax $0
Seat 1: 36e85ed3 (button) folded before Flop (didn't bet)
Seat 2: 24c2159e (small blind) collected ($0.2)
Seat 3: b8e03e64 (big blind) folded before Flop
Seat 4: bb835227 folded before Flop (didn't bet)
Seat 5: cce00e74 folded before Flop (didn't bet)
Seat 6: Hero folded before Flop (didn't bet)


Poker Hand #RC3141674329: Hold'em No Limit ($0.05/$0.1) - 2024/12/12 13:03:20
Table 'RushAndCash22319589' 6-max Seat #1 is the button
Seat 1: b0559006 ($9.9 in chips)
Seat 2: f1e9bea0 ($39.33 in chips)
Seat 3: 228a039d ($14.21 in chips)
Seat 4: Hero ($19.48 in chips)
Seat 5: f500aed7 ($10.42 in chips)
Seat 6: 24af28af ($9.63 in chips)
f1e9bea0: posts small blind $0.05
228a039d: posts big blind $0.1
*** HOLE CARDS ***
Dealt to b0559006 
Dealt to f1e9bea0 
Dealt to 228a039d 
Dealt to Hero [As 7s]
Dealt to f500aed7 
Dealt to 24af28af 
Hero: raises $0.1 to $0.2
f500aed7: folds
24af28af: raises $0.55 to $0.75
b0559006: folds
f1e9bea0: folds
228a039d: folds
Hero: folds
Uncalled bet ($0.55) returned to 24af28af
*** SHOWDOWN ***
24af28af collected $0.53 from pot
*** SUMMARY ***
Total pot $0.55 | Rake $0.02 | Jackpot $0 | Bingo $0 | Fortune $0 | Tax $0
Seat 1: b0559006 (button) folded before Flop (didn't bet)
Seat 2: f1e9bea0 (small blind) folded before Flop
Seat 3: 228a039d (big blind) folded before Flop
Seat 4: Hero folded before Flop
Seat 5: f500aed7 folded before Flop (didn't bet)
Seat 6: 24af28af collected ($0.53)


Poker Hand #RC3141674286: Hold'em No Limit ($0.05/$0.1) - 2024/12/12 13:03:08
Table 'RushAndCash22319546' 6-max Seat #1 is the button
Seat 1: 1cefc6e8 ($12.6 in chips)
Seat 2: Hero ($19.53 in chips)
Seat 3: 593f64c7 ($4.88 in chips)
Seat 4: bc8cb2ed ($5.77 in chips)
Seat 5: f5628a04 ($15.71 in chips)
Seat 6: 7ee23c5e ($11.8 in chips)
Hero: posts small blind $0.05
593f64c7: posts big blind $0.1
*** HOLE CARDS ***
Dealt to 1cefc6e8 
Dealt to Hero [As 9s]
Dealt to 593f64c7 
Dealt to bc8cb2ed 
Dealt to f5628a04 
Dealt to 7ee23c5e 
bc8cb2ed: raises $0.1 to $0.2
f5628a04: folds
7ee23c5e: folds
1cefc6e8: calls $0.2
Hero: folds
593f64c7: calls $0.1
*** FLOP *** [5d 7s Td]
593f64c7: checks
bc8cb2ed: checks
1cefc6e8: bets $0.33
593f64c7: calls $0.33
bc8cb2ed: folds
*** TURN *** [5d 7s Td] [6h]
593f64c7: checks
1cefc6e8: bets $0.66
593f64c7: calls $0.66
*** RIVER *** [5d 7s Td 6h] [6d]
593f64c7: bets $1.4
1cefc6e8: calls $1.4
593f64c7: shows [8h 6c] (Three Sixes)
1cefc6e8: shows [8d 9d] (Ten High Flush)
*** SHOWDOWN ***
1cefc6e8 collected $5.02 from pot
*** SUMMARY ***
Total pot $5.43 | Rake $0.26 | Jackpot $0.15 | Bingo $0 | Fortune $0 | Tax $0
Board [5d 7s Td 6h 6d]
Seat 1: 1cefc6e8 (button) showed [8d 9d] and won ($5.02) with Ten High Flush
Seat 2: Hero (small blind) folded before Flop
Seat 3: 593f64c7 (big blind) showed [8h 6c] and lost with Three Sixes
Seat 4: bc8cb2ed folded on the Flop
Seat 5: f5628a04 folded before Flop (didn't bet)
Seat 6: 7ee23c5e folded before Flop (didn't bet)


Poker Hand #RC3141674116: Hold'em No Limit ($0.05/$0.1) - 2024/12/12 13:02:25
Table 'RushAndCash22319376' 6-max Seat #1 is the button
Seat 1: Hero ($19.25 in chips)
Seat 2: c036357d ($9.9 in chips)
Seat 3: 7ee23c5e ($12.05 in chips)
Seat 4: 73d90cc7 ($11.7 in chips)
Seat 5: c46a27c1 ($14.61 in chips)
Seat 6: 59d8dcea ($10.1 in chips)
c036357d: posts small blind $0.05
7ee23c5e: posts big blind $0.1
*** HOLE CARDS ***
Dealt to Hero [Ts Td]
Dealt to c036357d 
Dealt to 7ee23c5e 
Dealt to 73d90cc7 
Dealt to c46a27c1 
Dealt to 59d8dcea 
73d90cc7: folds
c46a27c1: folds
59d8dcea: folds
Hero: raises $0.15 to $0.25
c036357d: folds
7ee23c5e: calls $0.15
*** FLOP *** [3c 5d 9c]
7ee23c5e: checks
Hero: bets $0.42
7ee23c5e: folds
Uncalled bet ($0.42) returned to Hero
*** SHOWDOWN ***
Hero collected $0.53 from pot
*** SUMMARY ***
Total pot $0.55 | Rake $0.02 | Jackpot $0 | Bingo $0 | Fortune $0 | Tax $0
Board [3c 5d 9c]
Seat 1: Hero (button) won ($0.53)
Seat 2: c036357d (small blind) folded before Flop
Seat 3: 7ee23c5e (big blind) folded on the Flop
Seat 4: 73d90cc7 folded before Flop (didn't bet)
Seat 5: c46a27c1 folded before Flop (didn't bet)
Seat 6: 59d8dcea folded before Flop (didn't bet)


Poker Hand #RC3141674099: Hold'em No Limit ($0.05/$0.1) - 2024/12/12 13:02:22
Table 'RushAndCash22319359' 6-max Seat #1 is the button
Seat 1: 53a81839 ($9.89 in chips)
Seat 2: b4bc8071 ($11.36 in chips)
Seat 3: Hero ($19.35 in chips)
Seat 4: 73d90cc7 ($11.7 in chips)
Seat 5: 95a503e1 ($14.75 in chips)
Seat 6: 24c2159e ($10 in chips)
b4bc8071: posts small blind $0.05
Hero: posts big blind $0.1
*** HOLE CARDS ***
Dealt to 53a81839 
Dealt to b4bc8071 
Dealt to Hero [4s 3c]
Dealt to 73d90cc7 
Dealt to 95a503e1 
Dealt to 24c2159e 
73d90cc7: folds
95a503e1: folds
24c2159e: raises $0.1 to $0.2
53a81839: folds
b4bc8071: raises $0.8 to $1
Hero: folds
24c2159e: folds
Uncalled bet ($0.8) returned to b4bc8071
*** SHOWDOWN ***
b4bc8071 collected $0.48 from pot
*** SUMMARY ***
Total pot $0.5 | Rake $0.02 | Jackpot $0 | Bingo $0 | Fortune $0 | Tax $0
Seat 1: 53a81839 (button) folded before Flop (didn't bet)
Seat 2: b4bc8071 (small blind) collected ($0.48)
Seat 3: Hero (big blind) folded before Flop
Seat 4: 73d90cc7 folded before Flop (didn't bet)
Seat 5: 95a503e1 folded before Flop (didn't bet)
Seat 6: 24c2159e folded before Flop


Poker Hand #RC3141674084: Hold'em No Limit ($0.05/$0.1) - 2024/12/12 13:02:19
Table 'RushAndCash22319344' 6-max Seat #1 is the button
Seat 1: 24c2159e ($10 in chips)
Seat 2: 101c026b ($35.68 in chips)
Seat 3: 53a81839 ($9.99 in chips)
Seat 4: Hero ($19.35 in chips)
Seat 5: bc092e13 ($13.34 in chips)
Seat 6: c0d18d50 ($4.15 in chips)
101c026b: posts small blind $0.05
53a81839: posts big blind $0.1
*** HOLE CARDS ***
Dealt to 24c2159e 
Dealt to 101c026b 
Dealt to 53a81839 
Dealt to Hero [2d 8d]
Dealt to bc092e13 
Dealt to c0d18d50 
Hero: folds
bc092e13: folds
c0d18d50: folds
24c2159e: folds
101c026b: folds
Uncalled bet ($0.05) returned to 53a81839
*** SHOWDOWN ***
53a81839 collected $0.1 from pot
*** SUMMARY ***
Total pot $0.1 | Rake $0 | Jackpot $0 | Bingo $0 | Fortune $0 | Tax $0
Seat 1: 24c2159e (button) folded before Flop (didn't bet)
Seat 2: 101c026b (small blind) folded before Flop
Seat 3: 53a81839 (big blind) collected ($0.1)
Seat 4: Hero folded before Flop (didn't bet)
Seat 5: bc092e13 folded before Flop (didn't bet)
Seat 6: c0d18d50 folded before Flop (didn't bet)


Poker Hand #RC3141674070: Hold'em No Limit ($0.05/$0.1) - 2024/12/12 13:02:15
Table 'RushAndCash22319330' 6-max Seat #1 is the button
Seat 1: f564c212 ($10.11 in chips)
Seat 2: 53a81839 ($10.04 in chips)
Seat 3: 17b5c9c3 ($11.76 in chips)
Seat 4: 1dc50d10 ($10.28 in chips)
Seat 5: 671b32fd ($14.59 in chips)
Seat 6: Hero ($19.35 in chips)
53a81839: posts small blind $0.05
17b5c9c3: posts big blind $0.1
*** HOLE CARDS ***
Dealt to f564c212 
Dealt to 53a81839 
Dealt to 17b5c9c3 
Dealt to 1dc50d10 
Dealt to 671b32fd 
Dealt to Hero [5c Qh]
1dc50d10: folds
671b32fd: folds
Hero: folds
f564c212: folds
53a81839: folds
Uncalled bet ($0.05) returned to 17b5c9c3
*** SHOWDOWN ***
17b5c9c3 collected $0.1 from pot
*** SUMMARY ***
Total pot $0.1 | Rake $0 | Jackpot $0 | Bingo $0 | Fortune $0 | Tax $0
Seat 1: f564c212 (button) folded before Flop (didn't bet)
Seat 2: 53a81839 (small blind) folded before Flop
Seat 3: 17b5c9c3 (big blind) collected ($0.1)
Seat 4: 1dc50d10 folded before Flop (didn't bet)
Seat 5: 671b32fd folded before Flop (didn't bet)
Seat 6: Hero folded before Flop (didn't bet)


Poker Hand #RC3141674056: Hold'em No Limit ($0.05/$0.1) - 2024/12/12 13:02:12
Table 'RushAndCash22319316' 6-max Seat #1 is the button
Seat 1: d940390d ($18.59 in chips)
Seat 2: 16994a2d ($12.41 in chips)
Seat 3: eb765b8f ($11.34 in chips)
Seat 4: Hero ($19.35 in chips)
Seat 5: 35b5987 ($20.6 in chips)
Seat 6: 9ef3daf1 ($16.51 in chips)
16994a2d: posts small blind $0.05
eb765b8f: posts big blind $0.1
*** HOLE CARDS ***
Dealt to d940390d 
Dealt to 16994a2d 
Dealt to eb765b8f 
Dealt to Hero [7d 6h]
Dealt to 35b5987 
Dealt to 9ef3daf1 
Hero: folds
35b5987: raises $0.1 to $0.2
9ef3daf1: raises $0.5 to $0.7
d940390d: folds
16994a2d: folds
eb765b8f: folds
35b5987: folds
Uncalled bet ($0.5) returned to 9ef3daf1
*** SHOWDOWN ***
9ef3daf1 collected $0.53 from pot
*** SUMMARY ***
Total pot $0.55 | Rake $0.02 | Jackpot $0 | Bingo $0 | Fortune $0 | Tax $0
Seat 1: d940390d (button) folded before Flop (didn't bet)
Seat 2: 16994a2d (small blind) folded before Flop
Seat 3: eb765b8f (big blind) folded before Flop
Seat 4: Hero folded before Flop (didn't bet)
Seat 5: 35b5987 folded before Flop
Seat 6: 9ef3daf1 collected ($0.53)


Poker Hand #RC3141673984: Hold'em No Limit ($0.05/$0.1) - 2024/12/12 13:01:55
Table 'RushAndCash22319244' 6-max Seat #1 is the button
Seat 1: b2132e5f ($13.98 in chips)
Seat 2: 713307d1 ($4.05 in chips)
Seat 3: Hero ($19.45 in chips)
Seat 4: d2714301 ($6.04 in chips)
Seat 5: 4de3c51 ($10.6 in chips)
Seat 6: 3f5e12f8 ($10.47 in chips)
713307d1: posts small blind $0.05
Hero: posts big blind $0.1
*** HOLE CARDS ***
Dealt to b2132e5f 
Dealt to 713307d1 
Dealt to Hero [4c 4d]
Dealt to d2714301 
Dealt to 4de3c51 
Dealt to 3f5e12f8 
d2714301: raises $0.1 to $0.2
4de3c51: folds
3f5e12f8: folds
b2132e5f: raises $0.6 to $0.8
713307d1: folds
Hero: folds
d2714301: calls $0.6
*** FLOP *** [Kd Tc Ts]
d2714301: bets $0.1
b2132e5f: calls $0.1
*** TURN *** [Kd Tc Ts] [Ks]
d2714301: bets $0.1
b2132e5f: calls $0.1
*** RIVER *** [Kd Tc Ts Ks] [8d]
d2714301: bets $0.1
b2132e5f: calls $0.1
d2714301: shows [2s As] (Pair of Kings and Pair of Tens)
b2132e5f: shows [Ac Jc] (Pair of Kings and Pair of Tens)
*** SHOWDOWN ***
d2714301 collected $1.13 from pot
b2132e5f collected $1.12 from pot
*** SUMMARY ***
Total pot $2.35 | Rake $0.1 | Jackpot $0 | Bingo $0 | Fortune $0 | Tax $0
Board [Kd Tc Ts Ks 8d]
Seat 1: b2132e5f (button) showed [Ac Jc] and won ($1.12) with Pair of Kings and Pair of Tens
Seat 2: 713307d1 (small blind) folded before Flop
Seat 3: Hero (big blind) folded before Flop
Seat 4: d2714301 showed [2s As] and won ($1.13) with Pair of Kings and Pair of Tens
Seat 5: 4de3c51 folded before Flop (didn't bet)
Seat 6: 3f5e12f8 folded before Flop (didn't bet)


Poker Hand #RC3141673972: Hold'em No Limit ($0.05/$0.1) - 2024/12/12 13:01:52
Table 'RushAndCash22319232' 6-max Seat #1 is the button
Seat 1: Hero ($19.45 in chips)
Seat 2: ead6156b ($5.53 in chips)
Seat 3: aaca7529 ($8.33 in chips)
Seat 4: bc6d42d6 ($9.75 in chips)
Seat 5: 5eb518f3 ($9.85 in chips)
Seat 6: 24af28af ($9.7 in chips)
ead6156b: posts small blind $0.05
aaca7529: posts big blind $0.1
*** HOLE CARDS ***
Dealt to Hero [7s 6c]
Dealt to ead6156b 
Dealt to aaca7529 
Dealt to bc6d42d6 
Dealt to 5eb518f3 
Dealt to 24af28af 
bc6d42d6: raises $0.2 to $0.3
5eb518f3: folds
24af28af: folds
Hero: folds
ead6156b: folds
aaca7529: calls $0.2
*** FLOP *** [6h 9h Kd]
aaca7529: checks
bc6d42d6: bets $0.49
aaca7529: folds
Uncalled bet ($0.49) returned to bc6d42d6
*** SHOWDOWN ***
bc6d42d6 collected $0.62 from pot
*** SUMMARY ***
Total pot $0.65 | Rake $0.03 | Jackpot $0 | Bingo $0 | Fortune $0 | Tax $0
Board [6h 9h Kd]
Seat 1: Hero (button) folded before Flop (didn't bet)
Seat 2: ead6156b (small blind) folded before Flop
Seat 3: aaca7529 (big blind) folded on the Flop
Seat 4: bc6d42d6 won ($0.62)
Seat 5: 5eb518f3 folded before Flop (didn't bet)
Seat 6: 24af28af folded before Flop (didn't bet)


Poker Hand #RC3141673958: Hold'em No Limit ($0.05/$0.1) - 2024/12/12 13:01:48
Table 'RushAndCash22319218' 6-max Seat #1 is the button
Seat 1: 4975a180 ($10.23 in chips)
Seat 2: 8ebad06f ($10.15 in chips)
Seat 3: d1122f42 ($10 in chips)
Seat 4: 5b982aa5 ($17.35 in chips)
Seat 5: a4bd4854 ($10 in chips)
Seat 6: Hero ($19.45 in chips)
8ebad06f: posts small blind $0.05
d1122f42: posts big blind $0.1
*** HOLE CARDS ***
Dealt to 4975a180 
Dealt to 8ebad06f 
Dealt to d1122f42 
Dealt to 5b982aa5 
Dealt to a4bd4854 
Dealt to Hero [Ks 5h]
5b982aa5: folds
a4bd4854: folds
Hero: folds
4975a180: raises $0.11 to $0.21
8ebad06f: folds
d1122f42: calls $0.11
*** FLOP *** [Td 8c 5s]
d1122f42: checks
4975a180: bets $0.36
d1122f42: folds
Uncalled bet ($0.36) returned to 4975a180
*** SHOWDOWN ***
4975a180 collected $0.45 from pot
*** SUMMARY ***
Total pot $0.47 | Rake $0.02 | Jackpot $0 | Bingo $0 | Fortune $0 | Tax $0
Board [Td 8c 5s]
Seat 1: 4975a180 (button) won ($0.45)
Seat 2: 8ebad06f (small blind) folded before Flop
Seat 3: d1122f42 (big blind) folded on the Flop
Seat 4: 5b982aa5 folded before Flop (didn't bet)
Seat 5: a4bd4854 folded before Flop (didn't bet)
Seat 6: Hero folded before Flop (didn't bet)


Poker Hand #RC3141673922: Hold'em No Limit ($0.05/$0.1) - 2024/12/12 13:01:39
Table 'RushAndCash22319182' 6-max Seat #1 is the button
Seat 1: bc8cb2ed ($5.12 in chips)
Seat 2: Hero ($19.5 in chips)
Seat 3: 5041f166 ($9.53 in chips)
Seat 4: 2ff0a04b ($46.59 in chips)
Seat 5: a3d9ddb9 ($10.98 in chips)
Seat 6: 24af28af ($9.55 in chips)
Hero: posts small blind $0.05
5041f166: posts big blind $0.1
*** HOLE CARDS ***
Dealt to bc8cb2ed 
Dealt to Hero [Jh Th]
Dealt to 5041f166 
Dealt to 2ff0a04b 
Dealt to a3d9ddb9 
Dealt to 24af28af 
2ff0a04b: folds
a3d9ddb9: folds
24af28af: raises $0.1 to $0.2
bc8cb2ed: folds
Hero: folds
5041f166: folds
Uncalled bet ($0.1) returned to 24af28af
*** SHOWDOWN ***
24af28af collected $0.25 from pot
*** SUMMARY ***
Total pot $0.25 | Rake $0 | Jackpot $0 | Bingo $0 | Fortune $0 | Tax $0
Seat 1: bc8cb2ed (button) folded before Flop (didn't bet)
Seat 2: Hero (small blind) folded before Flop
Seat 3: 5041f166 (big blind) folded before Flop
Seat 4: 2ff0a04b folded before Flop (didn't bet)
Seat 5: a3d9ddb9 folded before Flop (didn't bet)
Seat 6: 24af28af collected ($0.25)


Poker Hand #RC3141673909: Hold'em No Limit ($0.05/$0.1) - 2024/12/12 13:01:36
Table 'RushAndCash22319169' 6-max Seat #1 is the button
Seat 1: d940390d ($18.54 in chips)
Seat 2: fd36d45d ($13.01 in chips)
Seat 3: caa14983 ($10.97 in chips)
Seat 4: Hero ($19.5 in chips)
Seat 5: 24af28af ($9.55 in chips)
Seat 6: 5041f166 ($9.53 in chips)
fd36d45d: posts small blind $0.05
caa14983: posts big blind $0.1
*** HOLE CARDS ***
Dealt to d940390d 
Dealt to fd36d45d 
Dealt to caa14983 
Dealt to Hero [3c Td]
Dealt to 24af28af 
Dealt to 5041f166 
Hero: folds
24af28af: folds
5041f166: folds
d940390d: folds
fd36d45d: raises $0.11 to $0.21
caa14983: raises $0.39 to $0.6
fd36d45d: folds
Uncalled bet ($0.39) returned to caa14983
*** SHOWDOWN ***
caa14983 collected $0.4 from pot
*** SUMMARY ***
Total pot $0.42 | Rake $0.02 | Jackpot $0 | Bingo $0 | Fortune $0 | Tax $0
Seat 1: d940390d (button) folded before Flop (didn't bet)
Seat 2: fd36d45d (small blind) folded before Flop
Seat 3: caa14983 (big blind) collected ($0.4)
Seat 4: Hero folded before Flop (didn't bet)
Seat 5: 24af28af folded before Flop (didn't bet)
Seat 6: 5041f166 folded before Flop (didn't bet)


Poker Hand #RC3141673895: Hold'em No Limit ($0.05/$0.1) - 2024/12/12 13:01:33
Table 'RushAndCash22319155' 6-max Seat #1 is the button
Seat 1: 24af28af ($9.55 in chips)
Seat 2: 41ad32d3 ($21.65 in chips)
Seat 3: 91e6eecf ($11.59 in chips)
Seat 4: Hero ($19.5 in chips)
Seat 5: d09451f5 ($13.09 in chips)
Seat 6: b4bc8071 ($11.46 in chips)
41ad32d3: posts small blind $0.05
91e6eecf: posts big blind $0.1
*** HOLE CARDS ***
Dealt to 24af28af 
Dealt to 41ad32d3 
Dealt to 91e6eecf 
Dealt to Hero [5s 8c]
Dealt to d09451f5 
Dealt to b4bc8071 
Hero: folds
d09451f5: folds
b4bc8071: raises $0.1 to $0.2
24af28af: folds
41ad32d3: folds
91e6eecf: folds
Uncalled bet ($0.1) returned to b4bc8071
*** SHOWDOWN ***
b4bc8071 collected $0.25 from pot
*** SUMMARY ***
Total pot $0.25 | Rake $0 | Jackpot $0 | Bingo $0 | Fortune $0 | Tax $0
Seat 1: 24af28af (button) folded before Flop (didn't bet)
Seat 2: 41ad32d3 (small blind) folded before Flop
Seat 3: 91e6eecf (big blind) folded before Flop
Seat 4: Hero folded before Flop (didn't bet)
Seat 5: d09451f5 folded before Flop (didn't bet)
Seat 6: b4bc8071 collected ($0.25)


Poker Hand #RC3141673728: Hold'em No Limit ($0.05/$0.1) - 2024/12/12 13:00:54
Table 'RushAndCash22318988' 6-max Seat #1 is the button
Seat 1: c44f394 ($10.28 in chips)
Seat 2: 6b9a34dd ($10.11 in chips)
Seat 3: Hero ($19.75 in chips)
Seat 4: 1dc50d10 ($10.43 in chips)
Seat 5: 721d2ee6 ($15.01 in chips)
Seat 6: 91e6eecf ($11.31 in chips)
6b9a34dd: posts small blind $0.05
Hero: posts big blind $0.1
*** HOLE CARDS ***
Dealt to c44f394 
Dealt to 6b9a34dd 
Dealt to Hero [5s 5d]
Dealt to 1dc50d10 
Dealt to 721d2ee6 
Dealt to 91e6eecf 
1dc50d10: folds
721d2ee6: folds
91e6eecf: raises $0.15 to $0.25
c44f394: folds
6b9a34dd: folds
Hero: calls $0.15
*** FLOP *** [Tc 6h Ac]
Hero: checks
91e6eecf: bets $0.28
Hero: folds
Uncalled bet ($0.28) returned to 91e6eecf
*** SHOWDOWN ***
91e6eecf collected $0.53 from pot
*** SUMMARY ***
Total pot $0.55 | Rake $0.02 | Jackpot $0 | Bingo $0 | Fortune $0 | Tax $0
Board [Tc 6h Ac]
Seat 1: c44f394 (button) folded before Flop (didn't bet)
Seat 2: 6b9a34dd (small blind) folded before Flop
Seat 3: Hero (big blind) folded on the Flop
Seat 4: 1dc50d10 folded before Flop (didn't bet)
Seat 5: 721d2ee6 folded before Flop (didn't bet)
Seat 6: 91e6eecf won ($0.53)


Poker Hand #RC3141673650: Hold'em No Limit ($0.05/$0.1) - 2024/12/12 13:00:36
Table 'RushAndCash22318910' 6-max Seat #1 is the button
Seat 1: Hero ($20 in chips)
Seat 2: afe10f69 ($10.15 in chips)
Seat 3: c44f394 ($10 in chips)
Seat 4: 5b32d7fc ($10 in chips)
Seat 5: 101c026b ($35.55 in chips)
Seat 6: 645be922 ($10 in chips)
afe10f69: posts small blind $0.05
c44f394: posts big blind $0.1
*** HOLE CARDS ***
Dealt to Hero [Tc As]
Dealt to afe10f69 
Dealt to c44f394 
Dealt to 5b32d7fc 
Dealt to 101c026b 
Dealt to 645be922 
5b32d7fc: folds
101c026b: folds
645be922: folds
Hero: raises $0.15 to $0.25
afe10f69: folds
c44f394: raises $0.82 to $1.07
Hero: folds
Uncalled bet ($0.82) returned to c44f394
*** SHOWDOWN ***
c44f394 collected $0.53 from pot
*** SUMMARY ***
Total pot $0.55 | Rake $0.02 | Jackpot $0 | Bingo $0 | Fortune $0 | Tax $0
Seat 1: Hero (button) folded before Flop
Seat 2: afe10f69 (small blind) folded before Flop
Seat 3: c44f394 (big blind) collected ($0.53)
Seat 4: 5b32d7fc folded before Flop (didn't bet)
Seat 5: 101c026b folded before Flop (didn't bet)
Seat 6: 645be922 folded before Flop (didn't bet)


Poker Hand #RC3141673617: Hold'em No Limit ($0.05/$0.1) - 2024/12/12 13:00:28
Table 'RushAndCash22318877' 6-max Seat #1 is the button
Seat 1: 3954586d ($11.55 in chips)
Seat 2: Hero ($20.05 in chips)
Seat 3: f383ae87 ($23.67 in chips)
Seat 4: 111c75 ($10.58 in chips)
Seat 5: bc2007a2 ($18.19 in chips)
Seat 6: 2441c176 ($10.59 in chips)
Hero: posts small blind $0.05
f383ae87: posts big blind $0.1
*** HOLE CARDS ***
Dealt to 3954586d 
Dealt to Hero [Qc 5s]
Dealt to f383ae87 
Dealt to 111c75 
Dealt to bc2007a2 
Dealt to 2441c176 
111c75: folds
bc2007a2: folds
2441c176: raises $0.15 to $0.25
3954586d: folds
Hero: folds
f383ae87: raises $0.8 to $1.05
2441c176: raises $1.35 to $2.4
f383ae87: folds
Uncalled bet ($1.35) returned to 2441c176
*** SHOWDOWN ***
2441c176 collected $2.05 from pot
*** SUMMARY ***
Total pot $2.15 | Rake $0.1 | Jackpot $0 | Bingo $0 | Fortune $0 | Tax $0
Seat 1: 3954586d (button) folded before Flop (didn't bet)
Seat 2: Hero (small blind) folded before Flop
Seat 3: f383ae87 (big blind) folded before Flop
Seat 4: 111c75 folded before Flop (didn't bet)
Seat 5: bc2007a2 folded before Flop (didn't bet)
Seat 6: 2441c176 collected ($2.05)


Poker Hand #RC3141673604: Hold'em No Limit ($0.05/$0.1) - 2024/12/12 13:00:24
Table 'RushAndCash22318864' 6-max Seat #1 is the button
Seat 1: cb8dca6d ($10.15 in chips)
Seat 2: 4229e6bd ($11.58 in chips)
Seat 3: 1d2dacdf ($10 in chips)
Seat 4: 9b962a1c ($9.85 in chips)
Seat 5: Hero ($20.05 in chips)
Seat 6: 2b1a7fe5 ($16.57 in chips)
4229e6bd: posts small blind $0.05
1d2dacdf: posts big blind $0.1
*** HOLE CARDS ***
Dealt to cb8dca6d 
Dealt to 4229e6bd 
Dealt to 1d2dacdf 
Dealt to 9b962a1c 
Dealt to Hero [6s Kh]
Dealt to 2b1a7fe5 
9b962a1c: raises $0.14 to $0.24
Hero: folds
2b1a7fe5: calls $0.24
cb8dca6d: folds
4229e6bd: folds
1d2dacdf: calls $0.14
*** FLOP *** [As 4h Td]
1d2dacdf: checks
9b962a1c: bets $0.45
2b1a7fe5: folds
1d2dacdf: folds
Uncalled bet ($0.45) returned to 9b962a1c
*** SHOWDOWN ***
9b962a1c collected $0.74 from pot
*** SUMMARY ***
Total pot $0.77 | Rake $0.03 | Jackpot $0 | Bingo $0 | Fortune $0 | Tax $0
Board [As 4h Td]
Seat 1: cb8dca6d (button) folded before Flop (didn't bet)
Seat 2: 4229e6bd (small blind) folded before Flop
Seat 3: 1d2dacdf (big blind) folded on the Flop
Seat 4: 9b962a1c won ($0.74)
Seat 5: Hero folded before Flop (didn't bet)
Seat 6: 2b1a7fe5 folded on the Flop


Poker Hand #RC3141673573: Hold'em No Limit ($0.05/$0.1) - 2024/12/12 13:00:16
Table 'RushAndCash22318833' 6-max Seat #1 is the button
Seat 1: Hero ($19.9 in chips)
Seat 2: 4d1634eb ($11.98 in chips)
Seat 3: 4b728c96 ($10.03 in chips)
Seat 4: c44f394 ($10 in chips)
Seat 5: 8d92b14e ($10 in chips)
Seat 6: f500aed7 ($10.06 in chips)
4d1634eb: posts small blind $0.05
4b728c96: posts big blind $0.1
*** HOLE CARDS ***
Dealt to Hero [Jh 6h]
Dealt to 4d1634eb 
Dealt to 4b728c96 
Dealt to c44f394 
Dealt to 8d92b14e 
Dealt to f500aed7 
c44f394: folds
8d92b14e: raises $0.1 to $0.2
f500aed7: raises $0.43 to $0.63
Hero: folds
4d1634eb: folds
4b728c96: folds
8d92b14e: folds
Uncalled bet ($0.43) returned to f500aed7
*** SHOWDOWN ***
f500aed7 collected $0.53 from pot
*** SUMMARY ***
Total pot $0.55 | Rake $0.02 | Jackpot $0 | Bingo $0 | Fortune $0 | Tax $0
Seat 1: Hero (button) folded before Flop (didn't bet)
Seat 2: 4d1634eb (small blind) folded before Flop
Seat 3: 4b728c96 (big blind) folded before Flop
Seat 4: c44f394 folded before Flop (didn't bet)
Seat 5: 8d92b14e folded before Flop
Seat 6: f500aed7 collected ($0.53)


Poker Hand #RC3141673559: Hold'em No Limit ($0.05/$0.1) - 2024/12/12 13:00:13
Table 'RushAndCash22318819' 6-max Seat #1 is the button
Seat 1: 1e0385e8 ($10 in chips)
Seat 2: 86ee8e36 ($28.68 in chips)
Seat 3: 1c087ec5 ($41.03 in chips)
Seat 4: 3c75bc00 ($36.49 in chips)
Seat 5: Hero ($19.9 in chips)
Seat 6: f4a6a825 ($16.87 in chips)
86ee8e36: posts small blind $0.05
1c087ec5: posts big blind $0.1
*** HOLE CARDS ***
Dealt to 1e0385e8 
Dealt to 86ee8e36 
Dealt to 1c087ec5 
Dealt to 3c75bc00 
Dealt to Hero [4s 6s]
Dealt to f4a6a825 
3c75bc00: folds
Hero: folds
f4a6a825: folds
1e0385e8: folds
86ee8e36: folds
Uncalled bet ($0.05) returned to 1c087ec5
*** SHOWDOWN ***
1c087ec5 collected $0.1 from pot
*** SUMMARY ***
Total pot $0.1 | Rake $0 | Jackpot $0 | Bingo $0 | Fortune $0 | Tax $0
Seat 1: 1e0385e8 (button) folded before Flop (didn't bet)
Seat 2: 86ee8e36 (small blind) folded before Flop
Seat 3: 1c087ec5 (big blind) collected ($0.1)
Seat 4: 3c75bc00 folded before Flop (didn't bet)
Seat 5: Hero folded before Flop (didn't bet)
Seat 6: f4a6a825 folded before Flop (didn't bet)


Poker Hand #RC3141673544: Hold'em No Limit ($0.05/$0.1) - 2024/12/12 13:00:10
Table 'RushAndCash22318804' 6-max Seat #1 is the button
Seat 1: 81834a2f ($15.04 in chips)
Seat 2: 4740c06b ($17.86 in chips)
Seat 3: Hero ($20 in chips)
Seat 4: 4d1634eb ($11.98 in chips)
Seat 5: 643f85e7 ($12.45 in chips)
Seat 6: 5142132f ($5.89 in chips)
4740c06b: posts small blind $0.05
Hero: posts big blind $0.1
*** HOLE CARDS ***
Dealt to 81834a2f 
Dealt to 4740c06b 
Dealt to Hero [Ks 7h]
Dealt to 4d1634eb 
Dealt to 643f85e7 
Dealt to 5142132f 
4d1634eb: folds
643f85e7: folds
5142132f: folds
81834a2f: folds
4740c06b: folds
Uncalled bet ($0.05) returned to Hero
*** SHOWDOWN ***
Hero collected $0.1 from pot
*** SUMMARY ***
Total pot $0.1 | Rake $0 | Jackpot $0 | Bingo $0 | Fortune $0 | Tax $0
Seat 1: 81834a2f (button) folded before Flop (didn't bet)
Seat 2: 4740c06b (small blind) folded before Flop
Seat 3: Hero (big blind) collected ($0.1)
Seat 4: 4d1634eb folded before Flop (didn't bet)
Seat 5: 643f85e7 folded before Flop (didn't bet)
Seat 6: 5142132f folded before Flop (didn't bet)


Poker Hand #RC3141673514: Hold'em No Limit ($0.05/$0.1) - 2024/12/12 13:00:02
Table 'RushAndCash22318774' 6-max Seat #1 is the button
Seat 1: a7936163 ($14.31 in chips)
Seat 2: 2b1a7fe5 ($16.72 in chips)
Seat 3: a4bd4854 ($10 in chips)
Seat 4: 73df44d1 ($10.93 in chips)
Seat 5: Hero ($20 in chips)
Seat 6: ae47099b ($17.85 in chips)
2b1a7fe5: posts small blind $0.05
a4bd4854: posts big blind $0.1
*** HOLE CARDS ***
Dealt to a7936163 
Dealt to 2b1a7fe5 
Dealt to a4bd4854 
Dealt to 73df44d1 
Dealt to Hero [8d 8h]
Dealt to ae47099b 
73df44d1: raises $0.1 to $0.2
Hero: folds
ae47099b: folds
a7936163: folds
2b1a7fe5: folds
a4bd4854: folds
Uncalled bet ($0.1) returned to 73df44d1
*** SHOWDOWN ***
73df44d1 collected $0.25 from pot
*** SUMMARY ***
Total pot $0.25 | Rake $0 | Jackpot $0 | Bingo $0 | Fortune $0 | Tax $0
Seat 1: a7936163 (button) folded before Flop (didn't bet)
Seat 2: 2b1a7fe5 (small blind) folded before Flop
Seat 3: a4bd4854 (big blind) folded before Flop
Seat 4: 73df44d1 collected ($0.25)
Seat 5: Hero folded before Flop (didn't bet)
Seat 6: ae47099b folded before Flop (didn't bet)


Poker Hand #RC3141673486: Hold'em No Limit ($0.05/$0.1) - 2024/12/12 12:59:55
Table 'RushAndCash22318746' 6-max Seat #1 is the button
Seat 1: 5ddf2544 ($13.35 in chips)
Seat 2: Hero ($20.05 in chips)
Seat 3: a699d2de ($10.41 in chips)
Seat 4: c86d72c6 ($6.72 in chips)
Seat 5: 8424fd65 ($14.69 in chips)
Seat 6: bb0086cf ($10 in chips)
Hero: posts small blind $0.05
a699d2de: posts big blind $0.1
*** HOLE CARDS ***
Dealt to 5ddf2544 
Dealt to Hero [8d 4d]
Dealt to a699d2de 
Dealt to c86d72c6 
Dealt to 8424fd65 
Dealt to bb0086cf 
c86d72c6: folds
8424fd65: raises $0.1 to $0.2
bb0086cf: folds
5ddf2544: folds
Hero: folds
a699d2de: calls $0.1
*** FLOP *** [Kh Qd Qs]
a699d2de: checks
8424fd65: bets $0.15
a699d2de: calls $0.15
*** TURN *** [Kh Qd Qs] [5s]
a699d2de: checks
8424fd65: bets $0.57
a699d2de: folds
Uncalled bet ($0.57) returned to 8424fd65
*** SHOWDOWN ***
8424fd65 collected $0.72 from pot
*** SUMMARY ***
Total pot $0.75 | Rake $0.03 | Jackpot $0 | Bingo $0 | Fortune $0 | Tax $0
Board [Kh Qd Qs 5s]
Seat 1: 5ddf2544 (button) folded before Flop (didn't bet)
Seat 2: Hero (small blind) folded before Flop
Seat 3: a699d2de (big blind) folded on the Turn
Seat 4: c86d72c6 folded before Flop (didn't bet)
Seat 5: 8424fd65 won ($0.72)
Seat 6: bb0086cf folded before Flop (didn't bet)


Poker Hand #RC3141673470: Hold'em No Limit ($0.05/$0.1) - 2024/12/12 12:59:52
Table 'RushAndCash22318730' 6-max Seat #1 is the button
Seat 1: a3382d82 ($26.05 in chips)
Seat 2: b863ea8c ($22.45 in chips)
Seat 3: 17b5c9c3 ($10.87 in chips)
Seat 4: 8efbf75 ($9.85 in chips)
Seat 5: Hero ($20.05 in chips)
Seat 6: 59de94fc ($10.7 in chips)
b863ea8c: posts small blind $0.05
17b5c9c3: posts big blind $0.1
*** HOLE CARDS ***
Dealt to a3382d82 
Dealt to b863ea8c 
Dealt to 17b5c9c3 
Dealt to 8efbf75 
Dealt to Hero [6c 3c]
Dealt to 59de94fc 
8efbf75: folds
Hero: folds
59de94fc: folds
a3382d82: folds
b863ea8c: folds
Uncalled bet ($0.05) returned to 17b5c9c3
*** SHOWDOWN ***
17b5c9c3 collected $0.1 from pot
*** SUMMARY ***
Total pot $0.1 | Rake $0 | Jackpot $0 | Bingo $0 | Fortune $0 | Tax $0
Seat 1: a3382d82 (button) folded before Flop (didn't bet)
Seat 2: b863ea8c (small blind) folded before Flop
Seat 3: 17b5c9c3 (big blind) collected ($0.1)
Seat 4: 8efbf75 folded before Flop (didn't bet)
Seat 5: Hero folded before Flop (didn't bet)
Seat 6: 59de94fc folded before Flop (didn't bet)


Poker Hand #RC3141673458: Hold'em No Limit ($0.05/$0.1) - 2024/12/12 12:59:48
Table 'RushAndCash22318718' 6-max Seat #1 is the button
Seat 1: 721d2ee6 ($14.79 in chips)
Seat 2: 73df44d1 ($10.98 in chips)
Seat 3: 745c6911 ($14.46 in chips)
Seat 4: 17b5c9c3 ($10.87 in chips)
Seat 5: 4229e6bd ($11.58 in chips)
Seat 6: Hero ($20.05 in chips)
73df44d1: posts small blind $0.05
745c6911: posts big blind $0.1
*** HOLE CARDS ***
Dealt to 721d2ee6 
Dealt to 73df44d1 
Dealt to 745c6911 
Dealt to 17b5c9c3 
Dealt to 4229e6bd 
Dealt to Hero [Jh Tc]
17b5c9c3: folds
4229e6bd: raises $0.1 to $0.2
Hero: folds
721d2ee6: folds
73df44d1: folds
745c6911: folds
Uncalled bet ($0.1) returned to 4229e6bd
*** SHOWDOWN ***
4229e6bd collected $0.25 from pot
*** SUMMARY ***
Total pot $0.25 | Rake $0 | Jackpot $0 | Bingo $0 | Fortune $0 | Tax $0
Seat 1: 721d2ee6 (button) folded before Flop (didn't bet)
Seat 2: 73df44d1 (small blind) folded before Flop
Seat 3: 745c6911 (big blind) folded before Flop
Seat 4: 17b5c9c3 folded before Flop (didn't bet)
Seat 5: 4229e6bd collected ($0.25)
Seat 6: Hero folded before Flop (didn't bet)


Poker Hand #RC3141673033: Hold'em No Limit ($0.05/$0.1) - 2024/12/12 12:58:07
Table 'RushAndCash22318293' 6-max Seat #1 is the button
Seat 1: 78854bfa ($9.85 in chips)
Seat 2: Hero ($10.1 in chips)
Seat 3: 3f5e12f8 ($10 in chips)
Seat 4: 2b1a7fe5 ($17.67 in chips)
Seat 5: 5b32d7fc ($10.32 in chips)
Seat 6: a88ccb70 ($11.2 in chips)
Hero: posts small blind $0.05
3f5e12f8: posts big blind $0.1
*** HOLE CARDS ***
Dealt to 78854bfa 
Dealt to Hero [Kh Kd]
Dealt to 3f5e12f8 
Dealt to 2b1a7fe5 
Dealt to 5b32d7fc 
Dealt to a88ccb70 
2b1a7fe5: folds
5b32d7fc: raises $0.1 to $0.2
a88ccb70: raises $0.5 to $0.7
78854bfa: folds
Hero: raises $1.3 to $2
3f5e12f8: folds
5b32d7fc: folds
a88ccb70: calls $1.3
*** FLOP *** [9c 3h 5s]
Hero: bets $8.1 and is all-in
a88ccb70: calls $8.1
Hero: shows [Kh Kd] (Pair of Kings)
a88ccb70: shows [As Ks] (Ace-High)
*** TURN *** [9c 3h 5s] [Tc]
*** RIVER *** [9c 3h 5s Tc] [4d]
*** SHOWDOWN ***
Hero collected $20.05 from pot
*** SUMMARY ***
Total pot $20.5 | Rake $0.3 | Jackpot $0.15 | Bingo $0 | Fortune $0 | Tax $0
Board [9c 3h 5s Tc 4d]
Seat 1: 78854bfa (button) folded before Flop (didn't bet)
Seat 2: Hero (small blind) showed [Kh Kd] and won ($20.05) with Pair of Kings
Seat 3: 3f5e12f8 (big blind) folded before Flop
Seat 4: 2b1a7fe5 folded before Flop (didn't bet)
Seat 5: 5b32d7fc folded before Flop
Seat 6: a88ccb70 showed [As Ks] and lost with Ace-High


Poker Hand #RC3141673022: Hold'em No Limit ($0.05/$0.1) - 2024/12/12 12:58:04
Table 'RushAndCash22318282' 6-max Seat #1 is the button
Seat 1: 5e5bf12a ($7.66 in chips)
Seat 2: a88ccb70 ($11.25 in chips)
Seat 3: fed66cf6 ($11.98 in chips)
Seat 4: Hero ($10.1 in chips)
Seat 5: 58f45f04 ($10.2 in chips)
Seat 6: d827b781 ($11.7 in chips)
a88ccb70: posts small blind $0.05
fed66cf6: posts big blind $0.1
*** HOLE CARDS ***
Dealt to 5e5bf12a 
Dealt to a88ccb70 
Dealt to fed66cf6 
Dealt to Hero [4h 9d]
Dealt to 58f45f04 
Dealt to d827b781 
Hero: folds
58f45f04: folds
d827b781: folds
5e5bf12a: raises $0.15 to $0.25
a88ccb70: folds
fed66cf6: folds
Uncalled bet ($0.15) returned to 5e5bf12a
*** SHOWDOWN ***
5e5bf12a collected $0.25 from pot
*** SUMMARY ***
Total pot $0.25 | Rake $0 | Jackpot $0 | Bingo $0 | Fortune $0 | Tax $0
Seat 1: 5e5bf12a (button) collected ($0.25)
Seat 2: a88ccb70 (small blind) folded before Flop
Seat 3: fed66cf6 (big blind) folded before Flop
Seat 4: Hero folded before Flop (didn't bet)
Seat 5: 58f45f04 folded before Flop (didn't bet)
Seat 6: d827b781 folded before Flop (didn't bet)


Poker Hand #RC3141672990: Hold'em No Limit ($0.05/$0.1) - 2024/12/12 12:57:55
Table 'RushAndCash22318250' 6-max Seat #1 is the button
Seat 1: 8efbf75 ($9.85 in chips)
Seat 2: 89d15c60 ($11.8 in chips)
Seat 3: Hero ($10.05 in chips)
Seat 4: 645be922 ($10.04 in chips)
Seat 5: c86d72c6 ($6.31 in chips)
Seat 6: 2db5d1cb ($11.01 in chips)
89d15c60: posts small blind $0.05
Hero: posts big blind $0.1
*** HOLE CARDS ***
Dealt to 8efbf75 
Dealt to 89d15c60 
Dealt to Hero [6h Ks]
Dealt to 645be922 
Dealt to c86d72c6 
Dealt to 2db5d1cb 
645be922: folds
c86d72c6: folds
2db5d1cb: folds
8efbf75: folds
89d15c60: folds
Uncalled bet ($0.05) returned to Hero
*** SHOWDOWN ***
Hero collected $0.1 from pot
*** SUMMARY ***
Total pot $0.1 | Rake $0 | Jackpot $0 | Bingo $0 | Fortune $0 | Tax $0
Seat 1: 8efbf75 (button) folded before Flop (didn't bet)
Seat 2: 89d15c60 (small blind) folded before Flop
Seat 3: Hero (big blind) collected ($0.1)
Seat 4: 645be922 folded before Flop (didn't bet)
Seat 5: c86d72c6 folded before Flop (didn't bet)
Seat 6: 2db5d1cb folded before Flop (didn't bet)


Poker Hand #RC3141672978: Hold'em No Limit ($0.05/$0.1) - 2024/12/12 12:57:52
Table 'RushAndCash22318238' 6-max Seat #1 is the button
Seat 1: Hero ($10.05 in chips)
Seat 2: f2b49ec ($11.08 in chips)
Seat 3: 8d92b14e ($10.3 in chips)
Seat 4: 352ed62b ($10.55 in chips)
Seat 5: 81834a2f ($15.59 in chips)
Seat 6: 41ef6e45 ($10.94 in chips)
f2b49ec: posts small blind $0.05
8d92b14e: posts big blind $0.1
*** HOLE CARDS ***
Dealt to Hero [8h 2c]
Dealt to f2b49ec 
Dealt to 8d92b14e 
Dealt to 352ed62b 
Dealt to 81834a2f 
Dealt to 41ef6e45 
352ed62b: raises $0.12 to $0.22
81834a2f: folds
41ef6e45: folds
Hero: folds
f2b49ec: folds
8d92b14e: folds
Uncalled bet ($0.12) returned to 352ed62b
*** SHOWDOWN ***
352ed62b collected $0.25 from pot
*** SUMMARY ***
Total pot $0.25 | Rake $0 | Jackpot $0 | Bingo $0 | Fortune $0 | Tax $0
Seat 1: Hero (button) folded before Flop (didn't bet)
Seat 2: f2b49ec (small blind) folded before Flop
Seat 3: 8d92b14e (big blind) folded before Flop
Seat 4: 352ed62b collected ($0.25)
Seat 5: 81834a2f folded before Flop (didn't bet)
Seat 6: 41ef6e45 folded before Flop (didn't bet)


Poker Hand #RC3141672967: Hold'em No Limit ($0.05/$0.1) - 2024/12/12 12:57:49
Table 'RushAndCash22318227' 6-max Seat #1 is the button
Seat 1: f3cd242a ($15.34 in chips)
Seat 2: 44a078c0 ($12.65 in chips)
Seat 3: cf64da1a ($22.39 in chips)
Seat 4: Hero ($10.05 in chips)
Seat 5: f2b49ec ($11.08 in chips)
Seat 6: 68283690 ($10.54 in chips)
44a078c0: posts small blind $0.05
cf64da1a: posts big blind $0.1
*** HOLE CARDS ***
Dealt to f3cd242a 
Dealt to 44a078c0 
Dealt to cf64da1a 
Dealt to Hero [3c 5h]
Dealt to f2b49ec 
Dealt to 68283690 
Hero: folds
f2b49ec: folds
68283690: raises $0.15 to $0.25
f3cd242a: folds
44a078c0: calls $0.2
cf64da1a: calls $0.15
*** FLOP *** [7d Kd 3s]
44a078c0: checks
cf64da1a: checks
68283690: checks
*** TURN *** [7d Kd 3s] [Qc]
44a078c0: bets $0.39
cf64da1a: folds
68283690: calls $0.39
*** RIVER *** [7d Kd 3s Qc] [5s]
44a078c0: bets $1.89
68283690: calls $1.89
44a078c0: shows [Ah Ac] (Pair of Aces)
68283690: shows [Kc Th] (Pair of Kings)
*** SHOWDOWN ***
44a078c0 collected $4.91 from pot
*** SUMMARY ***
Total pot $5.31 | Rake $0.25 | Jackpot $0.15 | Bingo $0 | Fortune $0 | Tax $0
Board [7d Kd 3s Qc 5s]
Seat 1: f3cd242a (button) folded before Flop (didn't bet)
Seat 2: 44a078c0 (small blind) showed [Ah Ac] and won ($4.91) with Pair of Aces
Seat 3: cf64da1a (big blind) folded on the Turn
Seat 4: Hero folded before Flop (didn't bet)
Seat 5: f2b49ec folded before Flop (didn't bet)
Seat 6: 68283690 showed [Kc Th] and lost with Pair of Kings


Poker Hand #RC3141672935: Hold'em No Limit ($0.05/$0.1) - 2024/12/12 12:57:42
Table 'RushAndCash22318195' 6-max Seat #1 is the button
Seat 1: bbe73ee2 ($10.84 in chips)
Seat 2: 101c026b ($35.65 in chips)
Seat 3: Hero ($10 in chips)
Seat 4: 88fddf8e ($10 in chips)
Seat 5: 9a52083d ($25.13 in chips)
Seat 6: 88133657 ($10.16 in chips)
101c026b: posts small blind $0.05
Hero: posts big blind $0.1
*** HOLE CARDS ***
Dealt to bbe73ee2 
Dealt to 101c026b 
Dealt to Hero [5d 6h]
Dealt to 88fddf8e 
Dealt to 9a52083d 
Dealt to 88133657 
88fddf8e: folds
9a52083d: folds
88133657: folds
bbe73ee2: folds
101c026b: folds
Uncalled bet ($0.05) returned to Hero
*** SHOWDOWN ***
Hero collected $0.1 from pot
*** SUMMARY ***
Total pot $0.1 | Rake $0 | Jackpot $0 | Bingo $0 | Fortune $0 | Tax $0
Seat 1: bbe73ee2 (button) folded before Flop (didn't bet)
Seat 2: 101c026b (small blind) folded before Flop
Seat 3: Hero (big blind) collected ($0.1)
Seat 4: 88fddf8e folded before Flop (didn't bet)
Seat 5: 9a52083d folded before Flop (didn't bet)
Seat 6: 88133657 folded before Flop (didn't bet)


Poker Hand #RC3141672916: Hold'em No Limit ($0.05/$0.1) - 2024/12/12 12:57:37
Table 'RushAndCash22318176' 6-max Seat #1 is the button
Seat 1: a3382d82 ($25.92 in chips)
Seat 2: 88133657 ($10.21 in chips)
Seat 3: 4cf26e8f ($10 in chips)
Seat 4: dbcd9107 ($20.51 in chips)
Seat 5: 4859226e ($9.88 in chips)
Seat 6: Hero ($10 in chips)
88133657: posts small blind $0.05
4cf26e8f: posts big blind $0.1
*** HOLE CARDS ***
Dealt to a3382d82 
Dealt to 88133657 
Dealt to 4cf26e8f 
Dealt to dbcd9107 
Dealt to 4859226e 
Dealt to Hero [7s 5h]
dbcd9107: folds
4859226e: calls $0.1
Hero: folds
a3382d82: folds
88133657: folds
4cf26e8f: checks
*** FLOP *** [Ac Ah Th]
4cf26e8f: checks
4859226e: checks
*** TURN *** [Ac Ah Th] [Jd]
4cf26e8f: checks
4859226e: checks
*** RIVER *** [Ac Ah Th Jd] [7c]
4cf26e8f: checks
4859226e: bets $0.25
4cf26e8f: folds
Uncalled bet ($0.25) returned to 4859226e
*** SHOWDOWN ***
4859226e collected $0.24 from pot
*** SUMMARY ***
Total pot $0.25 | Rake $0.01 | Jackpot $0 | Bingo $0 | Fortune $0 | Tax $0
Board [Ac Ah Th Jd 7c]
Seat 1: a3382d82 (button) folded before Flop (didn't bet)
Seat 2: 88133657 (small blind) folded before Flop
Seat 3: 4cf26e8f (big blind) folded on the River
Seat 4: dbcd9107 folded before Flop (didn't bet)
Seat 5: 4859226e won ($0.24)
Seat 6: Hero folded before Flop (didn't bet)


Poker Hand #RC3141672902: Hold'em No Limit ($0.05/$0.1) - 2024/12/12 12:57:34
Table 'RushAndCash22318162' 6-max Seat #1 is the button
Seat 1: f1e9bea0 ($36.97 in chips)
Seat 2: bc2007a2 ($17.26 in chips)
Seat 3: 2583ab41 ($9.9 in chips)
Seat 4: bc8cb2ed ($4.3 in chips)
Seat 5: 6b9a34dd ($12.18 in chips)
Seat 6: Hero ($10 in chips)
bc2007a2: posts small blind $0.05
2583ab41: posts big blind $0.1
*** HOLE CARDS ***
Dealt to f1e9bea0 
Dealt to bc2007a2 
Dealt to 2583ab41 
Dealt to bc8cb2ed 
Dealt to 6b9a34dd 
Dealt to Hero [Jd 2c]
bc8cb2ed: folds
6b9a34dd: raises $0.15 to $0.25
Hero: folds
f1e9bea0: folds
bc2007a2: folds
2583ab41: calls $0.15
*** FLOP *** [2h 9c 7h]
2583ab41: checks
6b9a34dd: bets $0.22
2583ab41: calls $0.22
*** TURN *** [2h 9c 7h] [Ac]
2583ab41: checks
6b9a34dd: checks
*** RIVER *** [2h 9c 7h Ac] [5d]
2583ab41: checks
6b9a34dd: checks
2583ab41: shows [8c 7c] (Pair of Sevens)
6b9a34dd: shows [Kc Jh] (Ace-High)
*** SHOWDOWN ***
2583ab41 collected $0.94 from pot
*** SUMMARY ***
Total pot $0.99 | Rake $0.05 | Jackpot $0 | Bingo $0 | Fortune $0 | Tax $0
Board [2h 9c 7h Ac 5d]
Seat 1: f1e9bea0 (button) folded before Flop (didn't bet)
Seat 2: bc2007a2 (small blind) folded before Flop
Seat 3: 2583ab41 (big blind) showed [8c 7c] and won ($0.94) with Pair of Sevens
Seat 4: bc8cb2ed folded before Flop (didn't bet)
Seat 5: 6b9a34dd showed [Kc Jh] and lost with Ace-High
Seat 6: Hero folded before Flop (didn't bet)


Poker Hand #RC3141672889: Hold'em No Limit ($0.05/$0.1) - 2024/12/12 12:57:30
Table 'RushAndCash22318149' 6-max Seat #1 is the button
Seat 1: d6974a94 ($28.52 in chips)
Seat 2: Hero ($10 in chips)
Seat 3: c279dad0 ($10.82 in chips)
Seat 4: ead6156b ($6.52 in chips)
Seat 5: cb8dca6d ($10 in chips)
Seat 6: 35b5987 ($18.84 in chips)
Hero: posts small blind $0.05
c279dad0: posts big blind $0.1
*** HOLE CARDS ***
Dealt to d6974a94 
Dealt to Hero [Tc 4s]
Dealt to c279dad0 
Dealt to ead6156b 
Dealt to cb8dca6d 
Dealt to 35b5987 
ead6156b: raises $0.1 to $0.2
cb8dca6d: folds
35b5987: folds
d6974a94: raises $0.4 to $0.6
Hero: folds
c279dad0: calls $0.5
ead6156b: calls $0.4
*** FLOP *** [8d Td 6s]
c279dad0: checks
ead6156b: checks
d6974a94: bets $0.93
c279dad0: calls $0.93
ead6156b: folds
*** TURN *** [8d Td 6s] [2s]
c279dad0: checks
d6974a94: checks
*** RIVER *** [8d Td 6s 2s] [Qs]
c279dad0: checks
d6974a94: bets $2.8
c279dad0: calls $2.8
d6974a94: shows [Ad Qc] (Pair of Queens)
c279dad0: shows [Jh Th] (Pair of Tens)
*** SHOWDOWN ***
d6974a94 collected $8.86 from pot
*** SUMMARY ***
Total pot $9.31 | Rake $0.3 | Jackpot $0.15 | Bingo $0 | Fortune $0 | Tax $0
Board [8d Td 6s 2s Qs]
Seat 1: d6974a94 (button) showed [Ad Qc] and won ($8.86) with Pair of Queens
Seat 2: Hero (small blind) folded before Flop
Seat 3: c279dad0 (big blind) showed [Jh Th] and lost with Pair of Tens
Seat 4: ead6156b folded on the Flop
Seat 5: cb8dca6d folded before Flop (didn't bet)
Seat 6: 35b5987 folded before Flop (didn't bet)


Poker Hand #RC3141672795: Hold'em No Limit ($0.05/$0.1) - 2024/12/12 12:57:08
Table 'RushAndCash22318055' 6-max Seat #1 is the button
Seat 1: Hero ($10.25 in chips)
Seat 2: b738541f ($10.42 in chips)
Seat 3: aa6f9192 ($10 in chips)
Seat 4: 1aa8c909 ($10.31 in chips)
Seat 5: 844091a0 ($13.1 in chips)
Seat 6: 5b14e7af ($26.88 in chips)
b738541f: posts small blind $0.05
aa6f9192: posts big blind $0.1
*** HOLE CARDS ***
Dealt to Hero [Ah Js]
Dealt to b738541f 
Dealt to aa6f9192 
Dealt to 1aa8c909 
Dealt to 844091a0 
Dealt to 5b14e7af 
1aa8c909: folds
844091a0: folds
5b14e7af: folds
Hero: raises $0.15 to $0.25
b738541f: calls $0.2
aa6f9192: raises $1 to $1.25
Hero: folds
b738541f: folds
Uncalled bet ($1) returned to aa6f9192
*** SHOWDOWN ***
aa6f9192 collected $0.72 from pot
*** SUMMARY ***
Total pot $0.75 | Rake $0.03 | Jackpot $0 | Bingo $0 | Fortune $0 | Tax $0
Seat 1: Hero (button) folded before Flop
Seat 2: b738541f (small blind) folded before Flop
Seat 3: aa6f9192 (big blind) collected ($0.72)
Seat 4: 1aa8c909 folded before Flop (didn't bet)
Seat 5: 844091a0 folded before Flop (didn't bet)
Seat 6: 5b14e7af folded before Flop (didn't bet)


Poker Hand #RC3141672755: Hold'em No Limit ($0.05/$0.1) - 2024/12/12 12:56:57
Table 'RushAndCash22318015' 6-max Seat #1 is the button
Seat 1: 20a8d101 ($30.73 in chips)
Seat 2: d827b781 ($12.75 in chips)
Seat 3: 619e7abb ($4 in chips)
Seat 4: Hero ($10.1 in chips)
Seat 5: 58f45f04 ($10.3 in chips)
Seat 6: 232c056f ($9.57 in chips)
d827b781: posts small blind $0.05
619e7abb: posts big blind $0.1
*** HOLE CARDS ***
Dealt to 20a8d101 
Dealt to d827b781 
Dealt to 619e7abb 
Dealt to Hero [Ah Ts]
Dealt to 58f45f04 
Dealt to 232c056f 
Hero: raises $0.1 to $0.2
58f45f04: folds
232c056f: folds
20a8d101: folds
d827b781: folds
619e7abb: folds
Uncalled bet ($0.1) returned to Hero
*** SHOWDOWN ***
Hero collected $0.25 from pot
*** SUMMARY ***
Total pot $0.25 | Rake $0 | Jackpot $0 | Bingo $0 | Fortune $0 | Tax $0
Seat 1: 20a8d101 (button) folded before Flop (didn't bet)
Seat 2: d827b781 (small blind) folded before Flop
Seat 3: 619e7abb (big blind) folded before Flop
Seat 4: Hero collected ($0.25)
Seat 5: 58f45f04 folded before Flop (didn't bet)
Seat 6: 232c056f folded before Flop (didn't bet)


Poker Hand #RC3141672706: Hold'em No Limit ($0.05/$0.1) - 2024/12/12 12:56:43
Table 'RushAndCash22317966' 6-max Seat #1 is the button
Seat 1: c279dad0 ($10.67 in chips)
Seat 2: Hero ($10 in chips)
Seat 3: c5141ec9 ($12.8 in chips)
Seat 4: 6c4ba3fb ($15.03 in chips)
Seat 5: 2fb13304 ($11.22 in chips)
Seat 6: 111c75 ($10.75 in chips)
Hero: posts small blind $0.05
c5141ec9: posts big blind $0.1
*** HOLE CARDS ***
Dealt to c279dad0 
Dealt to Hero [Qh 9s]
Dealt to c5141ec9 
Dealt to 6c4ba3fb 
Dealt to 2fb13304 
Dealt to 111c75 
6c4ba3fb: folds
2fb13304: folds
111c75: folds
c279dad0: folds
Hero: raises $0.2 to $0.3
c5141ec9: folds
Uncalled bet ($0.2) returned to Hero
*** SHOWDOWN ***
Hero collected $0.2 from pot
*** SUMMARY ***
Total pot $0.2 | Rake $0 | Jackpot $0 | Bingo $0 | Fortune $0 | Tax $0
Seat 1: c279dad0 (button) folded before Flop (didn't bet)
Seat 2: Hero (small blind) collected ($0.2)
Seat 3: c5141ec9 (big blind) folded before Flop
Seat 4: 6c4ba3fb folded before Flop (didn't bet)
Seat 5: 2fb13304 folded before Flop (didn't bet)
Seat 6: 111c75 folded before Flop (didn't bet)


Poker Hand #RC3141672675: Hold'em No Limit ($0.05/$0.1) - 2024/12/12 12:56:36
Table 'RushAndCash22317935' 6-max Seat #1 is the button
Seat 1: 1e0385e8 ($10.05 in chips)
Seat 2: 6ac23d86 ($11.5 in chips)
Seat 3: Hero ($10 in chips)
Seat 4: 2ff0a04b ($46.42 in chips)
Seat 5: 1a8ef95a ($10.28 in chips)
Seat 6: 86ee8e36 ($29.11 in chips)
6ac23d86: posts small blind $0.05
Hero: posts big blind $0.1
*** HOLE CARDS ***
Dealt to 1e0385e8 
Dealt to 6ac23d86 
Dealt to Hero [7d Js]
Dealt to 2ff0a04b 
Dealt to 1a8ef95a 
Dealt to 86ee8e36 
2ff0a04b: folds
1a8ef95a: raises $0.11 to $0.21
86ee8e36: folds
1e0385e8: folds
6ac23d86: folds
Hero: folds
Uncalled bet ($0.11) returned to 1a8ef95a
*** SHOWDOWN ***
1a8ef95a collected $0.25 from pot
*** SUMMARY ***
Total pot $0.25 | Rake $0 | Jackpot $0 | Bingo $0 | Fortune $0 | Tax $0
Seat 1: 1e0385e8 (button) folded before Flop (didn't bet)
Seat 2: 6ac23d86 (small blind) folded before Flop
Seat 3: Hero (big blind) folded before Flop
Seat 4: 2ff0a04b folded before Flop (didn't bet)
Seat 5: 1a8ef95a collected ($0.25)
Seat 6: 86ee8e36 folded before Flop (didn't bet)


Poker Hand #RC3141672662: Hold'em No Limit ($0.05/$0.1) - 2024/12/12 12:56:33
Table 'RushAndCash22317922' 6-max Seat #1 is the button
Seat 1: 4898aa10 ($30.69 in chips)
Seat 2: 481b7ef8 ($17.26 in chips)
Seat 3: e2a23377 ($10 in chips)
Seat 4: 9ab5b010 ($24.13 in chips)
Seat 5: Hero ($10 in chips)
Seat 6: 647dd971 ($7.34 in chips)
481b7ef8: posts small blind $0.05
e2a23377: posts big blind $0.1
*** HOLE CARDS ***
Dealt to 4898aa10 
Dealt to 481b7ef8 
Dealt to e2a23377 
Dealt to 9ab5b010 
Dealt to Hero [Kh 4s]
Dealt to 647dd971 
9ab5b010: folds
Hero: folds
647dd971: folds
4898aa10: folds
481b7ef8: folds
Uncalled bet ($0.05) returned to e2a23377
*** SHOWDOWN ***
e2a23377 collected $0.1 from pot
*** SUMMARY ***
Total pot $0.1 | Rake $0 | Jackpot $0 | Bingo $0 | Fortune $0 | Tax $0
Seat 1: 4898aa10 (button) folded before Flop (didn't bet)
Seat 2: 481b7ef8 (small blind) folded before Flop
Seat 3: e2a23377 (big blind) collected ($0.1)
Seat 4: 9ab5b010 folded before Flop (didn't bet)
Seat 5: Hero folded before Flop (didn't bet)
Seat 6: 647dd971 folded before Flop (didn't bet)


Poker Hand #RC3141672647: Hold'em No Limit ($0.05/$0.1) - 2024/12/12 12:56:29
Table 'RushAndCash22317907' 6-max Seat #1 is the button
Seat 1: Hero ($10 in chips)
Seat 2: 208ee152 ($14.47 in chips)
Seat 3: c199627b ($7.63 in chips)
Seat 4: 3f908364 ($22.75 in chips)
Seat 5: d4deed2f ($10.53 in chips)
Seat 6: 54d53a50 ($17.72 in chips)
208ee152: posts small blind $0.05
c199627b: posts big blind $0.1
*** HOLE CARDS ***
Dealt to Hero [2s 6c]
Dealt to 208ee152 
Dealt to c199627b 
Dealt to 3f908364 
Dealt to d4deed2f 
Dealt to 54d53a50 
3f908364: raises $0.1 to $0.2
d4deed2f: folds
54d53a50: folds
Hero: folds
208ee152: folds
c199627b: raises $0.6 to $0.8
3f908364: raises $1.5 to $2.3
c199627b: raises $2.42 to $4.72
3f908364: raises $11.87 to $16.59
c199627b: calls $2.91 and is all-in
Uncalled bet ($8.96) returned to 3f908364
3f908364: shows [Ks Kd]
c199627b: shows [Ah Ad]
*** FLOP *** [9c 7c 4h]
*** TURN *** [9c 7c 4h] [5c]
*** RIVER *** [9c 7c 4h 5c] [6s]
*** SHOWDOWN ***
c199627b collected $14.86 from pot
*** SUMMARY ***
Total pot $15.31 | Rake $0.3 | Jackpot $0.15 | Bingo $0 | Fortune $0 | Tax $0
Board [9c 7c 4h 5c 6s]
Seat 1: Hero (button) folded before Flop (didn't bet)
Seat 2: 208ee152 (small blind) folded before Flop
Seat 3: c199627b (big blind) showed [Ah Ad] and won ($14.86) with Pair of Aces
Seat 4: 3f908364 showed [Ks Kd] and lost with Pair of Kings
Seat 5: d4deed2f folded before Flop (didn't bet)
Seat 6: 54d53a50 folded before Flop (didn't bet)


Poker Hand #RC3141672596: Hold'em No Limit ($0.05/$0.1) - 2024/12/12 12:56:15
Table 'RushAndCash22317856' 6-max Seat #1 is the button
Seat 1: 647dd971 ($7.34 in chips)
Seat 2: 9ef3daf1 ($15.18 in chips)
Seat 3: 645be922 ($10 in chips)
Seat 4: Hero ($10 in chips)
Seat 5: ed5538ab ($13.33 in chips)
Seat 6: 17b5c9c3 ($10 in chips)
9ef3daf1: posts small blind $0.05
645be922: posts big blind $0.1
*** HOLE CARDS ***
Dealt to 647dd971 
Dealt to 9ef3daf1 
Dealt to 645be922 
Dealt to Hero [2h 2d]
Dealt to ed5538ab 
Dealt to 17b5c9c3 
Hero: folds
ed5538ab: raises $0.11 to $0.21
17b5c9c3: folds
647dd971: folds
9ef3daf1: folds
645be922: calls $0.11
*** FLOP *** [7s 6s Td]
645be922: checks
ed5538ab: checks
*** TURN *** [7s 6s Td] [Ac]
645be922: checks
ed5538ab: checks
*** RIVER *** [7s 6s Td Ac] [7c]
645be922: checks
ed5538ab: checks
645be922: shows [Jd Th] (Pair of Tens and Pair of Sevens)
ed5538ab: shows [Qh Kc] (Pair of Sevens)
*** SHOWDOWN ***
645be922 collected $0.45 from pot
*** SUMMARY ***
Total pot $0.47 | Rake $0.02 | Jackpot $0 | Bingo $0 | Fortune $0 | Tax $0
Board [7s 6s Td Ac 7c]
Seat 1: 647dd971 (button) folded before Flop (didn't bet)
Seat 2: 9ef3daf1 (small blind) folded before Flop
Seat 3: 645be922 (big blind) showed [Jd Th] and won ($0.45) with Pair of Tens and Pair of Sevens
Seat 4: Hero folded before Flop (didn't bet)
Seat 5: ed5538ab showed [Qh Kc] and lost with Pair of Sevens
Seat 6: 17b5c9c3 folded before Flop (didn't bet)


Poker Hand #RC3141672531: Hold'em No Limit ($0.05/$0.1) - 2024/12/12 12:55:58
Table 'RushAndCash22317791' 6-max Seat #1 is the button
Seat 1: cfe70ef2 ($10.25 in chips)
Seat 2: 5041f166 ($12.38 in chips)
Seat 3: be2bfc8f ($10.63 in chips)
Seat 4: ead6156b ($7.47 in chips)
Seat 5: a9eb45fc ($11.28 in chips)
Seat 6: Hero ($10 in chips)
5041f166: posts small blind $0.05
be2bfc8f: posts big blind $0.1
*** HOLE CARDS ***
Dealt to cfe70ef2 
Dealt to 5041f166 
Dealt to be2bfc8f 
Dealt to ead6156b 
Dealt to a9eb45fc 
Dealt to Hero [Td Jh]
ead6156b: raises $0.1 to $0.2
a9eb45fc: folds
Hero: folds
cfe70ef2: folds
5041f166: folds
be2bfc8f: folds
Uncalled bet ($0.1) returned to ead6156b
*** SHOWDOWN ***
ead6156b collected $0.25 from pot
*** SUMMARY ***
Total pot $0.25 | Rake $0 | Jackpot $0 | Bingo $0 | Fortune $0 | Tax $0
Seat 1: cfe70ef2 (button) folded before Flop (didn't bet)
Seat 2: 5041f166 (small blind) folded before Flop
Seat 3: be2bfc8f (big blind) folded before Flop
Seat 4: ead6156b collected ($0.25)
Seat 5: a9eb45fc folded before Flop (didn't bet)
Seat 6: Hero folded before Flop (didn't bet)


Poker Hand #RC3141672514: Hold'em No Limit ($0.05/$0.1) - 2024/12/12 12:55:54
Table 'RushAndCash22317774' 6-max Seat #1 is the button
Seat 1: b053d810 ($14.02 in chips)
Seat 2: 14311dad ($11.82 in chips)
Seat 3: 7ec40c0d ($10 in chips)
Seat 4: Hero ($10 in chips)
Seat 5: 1d37642 ($4.71 in chips)
Seat 6: b1f396f4 ($20.82 in chips)
14311dad: posts small blind $0.05
7ec40c0d: posts big blind $0.1
*** HOLE CARDS ***
Dealt to b053d810 
Dealt to 14311dad 
Dealt to 7ec40c0d 
Dealt to Hero [6d Qs]
Dealt to 1d37642 
Dealt to b1f396f4 
Hero: folds
1d37642: folds
b1f396f4: folds
b053d810: folds
14311dad: folds
Uncalled bet ($0.05) returned to 7ec40c0d
*** SHOWDOWN ***
7ec40c0d collected $0.1 from pot
*** SUMMARY ***
Total pot $0.1 | Rake $0 | Jackpot $0 | Bingo $0 | Fortune $0 | Tax $0
Seat 1: b053d810 (button) folded before Flop (didn't bet)
Seat 2: 14311dad (small blind) folded before Flop
Seat 3: 7ec40c0d (big blind) collected ($0.1)
Seat 4: Hero folded before Flop (didn't bet)
Seat 5: 1d37642 folded before Flop (didn't bet)
Seat 6: b1f396f4 folded before Flop (didn't bet)


Poker Hand #RC3141672434: Hold'em No Limit ($0.05/$0.1) - 2024/12/12 12:55:33
Table 'RushAndCash22317694' 6-max Seat #1 is the button
Seat 1: d6b17ac7 ($12.24 in chips)
Seat 2: 86ee8e36 ($29.51 in chips)
Seat 3: 14311dad ($11.92 in chips)
Seat 4: 2e3105a5 ($12.62 in chips)
Seat 5: 4cf26e8f ($10 in chips)
Seat 6: Hero ($10 in chips)
Cash Drop to Pot : total $1 
86ee8e36: posts small blind $0.05
14311dad: posts big blind $0.1
*** HOLE CARDS ***
Dealt to d6b17ac7 
Dealt to 86ee8e36 
Dealt to 14311dad 
Dealt to 2e3105a5 
Dealt to 4cf26e8f 
Dealt to Hero [4d 8s]
2e3105a5: calls $0.1
4cf26e8f: folds
Hero: folds
d6b17ac7: raises $0.68 to $0.78
86ee8e36: folds
14311dad: folds
2e3105a5: folds
Uncalled bet ($0.68) returned to d6b17ac7
*** SHOWDOWN ***
d6b17ac7 collected $1.29 from pot
*** SUMMARY ***
Total pot $1.35 | Rake $0.06 | Jackpot $0 | Bingo $0 | Fortune $0 | Tax $0
Seat 1: d6b17ac7 (button) collected ($1.29)
Seat 2: 86ee8e36 (small blind) folded before Flop
Seat 3: 14311dad (big blind) folded before Flop
Seat 4: 2e3105a5 folded before Flop
Seat 5: 4cf26e8f folded before Flop (didn't bet)
Seat 6: Hero folded before Flop (didn't bet)


Poker Hand #RC3141672411: Hold'em No Limit ($0.05/$0.1) - 2024/12/12 12:55:27
Table 'RushAndCash22317671' 6-max Seat #1 is the button
Seat 1: Hero ($10 in chips)
Seat 2: 3cdac696 ($9.45 in chips)
Seat 3: ead05d7d ($12.74 in chips)
Seat 4: f1e9bea0 ($37.36 in chips)
Seat 5: ead6156b ($7.82 in chips)
Seat 6: ab081f1e ($10.15 in chips)
3cdac696: posts small blind $0.05
ead05d7d: posts big blind $0.1
*** HOLE CARDS ***
Dealt to Hero [Qd 5h]
Dealt to 3cdac696 
Dealt to ead05d7d 
Dealt to f1e9bea0 
Dealt to ead6156b 
Dealt to ab081f1e 
f1e9bea0: folds
ead6156b: folds
ab081f1e: raises $0.1 to $0.2
Hero: folds
3cdac696: folds
ead05d7d: calls $0.1
*** FLOP *** [8h Jd 9d]
ead05d7d: checks
ab081f1e: bets $0.23
ead05d7d: calls $0.23
*** TURN *** [8h Jd 9d] [5s]
ead05d7d: checks
ab081f1e: bets $0.66
ead05d7d: raises $1.14 to $1.8
ab081f1e: calls $1.14
*** RIVER *** [8h Jd 9d 5s] [Tc]
ead05d7d: bets $1.13
ab081f1e: folds
Uncalled bet ($1.13) returned to ead05d7d
*** SHOWDOWN ***
ead05d7d collected $4.15 from pot
*** SUMMARY ***
Total pot $4.51 | Rake $0.21 | Jackpot $0.15 | Bingo $0 | Fortune $0 | Tax $0
Board [8h Jd 9d 5s Tc]
Seat 1: Hero (button) folded before Flop (didn't bet)
Seat 2: 3cdac696 (small blind) folded before Flop
Seat 3: ead05d7d (big blind) won ($4.15)
Seat 4: f1e9bea0 folded before Flop (didn't bet)
Seat 5: ead6156b folded before Flop (didn't bet)
Seat 6: ab081f1e folded on the River


Poker Hand #RC3141672348: Hold'em No Limit ($0.05/$0.1) - 2024/12/12 12:55:11
Table 'RushAndCash22317608' 6-max Seat #1 is the button
Seat 1: 8e0a697 ($13.17 in chips)
Seat 2: bc2007a2 ($20.53 in chips)
Seat 3: Hero ($10 in chips)
Seat 4: 7a6f40ec ($11.42 in chips)
Seat 5: 71ddee08 ($11.2 in chips)
Seat 6: afe10f69 ($10 in chips)
bc2007a2: posts small blind $0.05
Hero: posts big blind $0.1
*** HOLE CARDS ***
Dealt to 8e0a697 
Dealt to bc2007a2 
Dealt to Hero [9d 5h]
Dealt to 7a6f40ec 
Dealt to 71ddee08 
Dealt to afe10f69 
7a6f40ec: folds
71ddee08: folds
afe10f69: raises $0.15 to $0.25
8e0a697: folds
bc2007a2: folds
Hero: folds
Uncalled bet ($0.15) returned to afe10f69
*** SHOWDOWN ***
afe10f69 collected $0.25 from pot
*** SUMMARY ***
Total pot $0.25 | Rake $0 | Jackpot $0 | Bingo $0 | Fortune $0 | Tax $0
Seat 1: 8e0a697 (button) folded before Flop (didn't bet)
Seat 2: bc2007a2 (small blind) folded before Flop
Seat 3: Hero (big blind) folded before Flop
Seat 4: 7a6f40ec folded before Flop (didn't bet)
Seat 5: 71ddee08 folded before Flop (didn't bet)
Seat 6: afe10f69 collected ($0.25)


Poker Hand #RC3141672260: Hold'em No Limit ($0.05/$0.1) - 2024/12/12 12:54:52
Table 'RushAndCash22317520' 6-max Seat #1 is the button
Seat 1: 1d656e64 ($99.41 in chips)
Seat 2: Hero ($10 in chips)
Seat 3: d19ee248 ($9.83 in chips)
Seat 4: 8e0a697 ($13.07 in chips)
Seat 5: 38fd477d ($10.43 in chips)
Seat 6: 295cc1bc ($11.99 in chips)
Hero: posts small blind $0.05
d19ee248: posts big blind $0.1
*** HOLE CARDS ***
Dealt to 1d656e64 
Dealt to Hero [Qc Ts]
Dealt to d19ee248 
Dealt to 8e0a697 
Dealt to 38fd477d 
Dealt to 295cc1bc 
8e0a697: folds
38fd477d: folds
295cc1bc: raises $0.15 to $0.25
1d656e64: calls $0.25
Hero: folds
d19ee248: folds
*** FLOP *** [7h 7c 5h]
295cc1bc: checks
1d656e64: checks
*** TURN *** [7h 7c 5h] [Td]
295cc1bc: checks
1d656e64: bets $0.33
295cc1bc: folds
Uncalled bet ($0.33) returned to 1d656e64
*** SHOWDOWN ***
1d656e64 collected $0.63 from pot
*** SUMMARY ***
Total pot $0.65 | Rake $0.02 | Jackpot $0 | Bingo $0 | Fortune $0 | Tax $0
Board [7h 7c 5h Td]
Seat 1: 1d656e64 (button) won ($0.63)
Seat 2: Hero (small blind) folded before Flop
Seat 3: d19ee248 (big blind) folded before Flop
Seat 4: 8e0a697 folded before Flop (didn't bet)
Seat 5: 38fd477d folded before Flop (didn't bet)
Seat 6: 295cc1bc folded on the Turn


Poker Hand #RC3141671980: Hold'em No Limit ($0.05/$0.1) - 2024/12/12 12:53:38
Table 'RushAndCash22317240' 6-max Seat #1 is the button
Seat 1: e12528c0 ($32.8 in chips)
Seat 2: 1dc50d10 ($10 in chips)
Seat 3: 8e0a697 ($12.79 in chips)
Seat 4: 2441c176 ($10 in chips)
Seat 5: 645be922 ($10 in chips)
Seat 6: Hero ($10.05 in chips)
1dc50d10: posts small blind $0.05
8e0a697: posts big blind $0.1
*** HOLE CARDS ***
Dealt to e12528c0 
Dealt to 1dc50d10 
Dealt to 8e0a697 
Dealt to 2441c176 
Dealt to 645be922 
Dealt to Hero [As 9s]
2441c176: folds
645be922: folds
Hero: raises $0.15 to $0.25
e12528c0: folds
1dc50d10: folds
8e0a697: calls $0.15
*** FLOP *** [Tc Js Td]
8e0a697: checks
Hero: checks
*** TURN *** [Tc Js Td] [4d]
8e0a697: bets $0.62
Hero: folds
Uncalled bet ($0.62) returned to 8e0a697
*** SHOWDOWN ***
8e0a697 collected $0.53 from pot
*** SUMMARY ***
Total pot $0.55 | Rake $0.02 | Jackpot $0 | Bingo $0 | Fortune $0 | Tax $0
Board [Tc Js Td 4d]
Seat 1: e12528c0 (button) folded before Flop (didn't bet)
Seat 2: 1dc50d10 (small blind) folded before Flop
Seat 3: 8e0a697 (big blind) won ($0.53)
Seat 4: 2441c176 folded before Flop (didn't bet)
Seat 5: 645be922 folded before Flop (didn't bet)
Seat 6: Hero folded on the Turn


Poker Hand #RC3141671950: Hold'em No Limit ($0.05/$0.1) - 2024/12/12 12:53:31
Table 'RushAndCash22317210' 6-max Seat #1 is the button
Seat 1: d4deed2f ($10.37 in chips)
Seat 2: 71ddee08 ($11.45 in chips)
Seat 3: 8a55880e ($10 in chips)
Seat 4: 37686872 ($15.85 in chips)
Seat 5: 3d5af037 ($12.45 in chips)
Seat 6: Hero ($10.05 in chips)
71ddee08: posts small blind $0.05
8a55880e: posts big blind $0.1
*** HOLE CARDS ***
Dealt to d4deed2f 
Dealt to 71ddee08 
Dealt to 8a55880e 
Dealt to 37686872 
Dealt to 3d5af037 
Dealt to Hero [As 7c]
37686872: folds
3d5af037: raises $0.15 to $0.25
Hero: folds
d4deed2f: folds
71ddee08: calls $0.2
8a55880e: folds
*** FLOP *** [2d 7d Kc]
71ddee08: checks
3d5af037: bets $0.15
71ddee08: folds
Uncalled bet ($0.15) returned to 3d5af037
*** SHOWDOWN ***
3d5af037 collected $0.57 from pot
*** SUMMARY ***
Total pot $0.6 | Rake $0.03 | Jackpot $0 | Bingo $0 | Fortune $0 | Tax $0
Board [2d 7d Kc]
Seat 1: d4deed2f (button) folded before Flop (didn't bet)
Seat 2: 71ddee08 (small blind) folded on the Flop
Seat 3: 8a55880e (big blind) folded before Flop
Seat 4: 37686872 folded before Flop (didn't bet)
Seat 5: 3d5af037 won ($0.57)
Seat 6: Hero folded before Flop (didn't bet)


Poker Hand #RC3141671937: Hold'em No Limit ($0.05/$0.1) - 2024/12/12 12:53:27
Table 'RushAndCash22317197' 6-max Seat #1 is the button
Seat 1: 54d53a50 ($17.72 in chips)
Seat 2: 2441c176 ($10 in chips)
Seat 3: 1e25b5bb ($17.8 in chips)
Seat 4: a1f416c7 ($14.64 in chips)
Seat 5: Hero ($10.05 in chips)
Seat 6: 8a31e4cb ($18.1 in chips)
2441c176: posts small blind $0.05
1e25b5bb: posts big blind $0.1
*** HOLE CARDS ***
Dealt to 54d53a50 
Dealt to 2441c176 
Dealt to 1e25b5bb 
Dealt to a1f416c7 
Dealt to Hero [Kd 4c]
Dealt to 8a31e4cb 
a1f416c7: folds
Hero: folds
8a31e4cb: raises $0.11 to $0.21
54d53a50: folds
2441c176: folds
1e25b5bb: calls $0.11
*** FLOP *** [Th 5s Tc]
1e25b5bb: checks
8a31e4cb: checks
*** TURN *** [Th 5s Tc] [Qs]
1e25b5bb: checks
8a31e4cb: checks
*** RIVER *** [Th 5s Tc Qs] [Kh]
1e25b5bb: checks
8a31e4cb: checks
1e25b5bb: shows [7h 7d] (Pair of Tens and Pair of Sevens)
8a31e4cb: shows [9s 9d] (Pair of Tens and Pair of Nines)
*** SHOWDOWN ***
8a31e4cb collected $0.45 from pot
*** SUMMARY ***
Total pot $0.47 | Rake $0.02 | Jackpot $0 | Bingo $0 | Fortune $0 | Tax $0
Board [Th 5s Tc Qs Kh]
Seat 1: 54d53a50 (button) folded before Flop (didn't bet)
Seat 2: 2441c176 (small blind) folded before Flop
Seat 3: 1e25b5bb (big blind) showed [7h 7d] and lost with Pair of Tens and Pair of Sevens
Seat 4: a1f416c7 folded before Flop (didn't bet)
Seat 5: Hero folded before Flop (didn't bet)
Seat 6: 8a31e4cb showed [9s 9d] and won ($0.45) with Pair of Tens and Pair of Nines


Poker Hand #RC3141671924: Hold'em No Limit ($0.05/$0.1) - 2024/12/12 12:53:24
Table 'RushAndCash22317184' 6-max Seat #1 is the button
Seat 1: Hero ($10.05 in chips)
Seat 2: a3382d82 ($19.16 in chips)
Seat 3: 1dc50d10 ($10 in chips)
Seat 4: be885022 ($12.97 in chips)
Seat 5: a1907a02 ($22.23 in chips)
Seat 6: 77907fc4 ($22.73 in chips)
a3382d82: posts small blind $0.05
1dc50d10: posts big blind $0.1
*** HOLE CARDS ***
Dealt to Hero [5h Qd]
Dealt to a3382d82 
Dealt to 1dc50d10 
Dealt to be885022 
Dealt to a1907a02 
Dealt to 77907fc4 
be885022: folds
a1907a02: raises $0.11 to $0.21
77907fc4: folds
Hero: folds
a3382d82: folds
1dc50d10: folds
Uncalled bet ($0.11) returned to a1907a02
*** SHOWDOWN ***
a1907a02 collected $0.25 from pot
*** SUMMARY ***
Total pot $0.25 | Rake $0 | Jackpot $0 | Bingo $0 | Fortune $0 | Tax $0
Seat 1: Hero (button) folded before Flop (didn't bet)
Seat 2: a3382d82 (small blind) folded before Flop
Seat 3: 1dc50d10 (big blind) folded before Flop
Seat 4: be885022 folded before Flop (didn't bet)
Seat 5: a1907a02 collected ($0.25)
Seat 6: 77907fc4 folded before Flop (didn't bet)


Poker Hand #RC3141671898: Hold'em No Limit ($0.05/$0.1) - 2024/12/12 12:53:17
Table 'RushAndCash22317158' 6-max Seat #1 is the button
Seat 1: 4dd7bc95 ($10.98 in chips)
Seat 2: 22e8274e ($15.28 in chips)
Seat 3: Hero ($10.15 in chips)
Seat 4: a7936163 ($15.69 in chips)
Seat 5: 1d37642 ($5.68 in chips)
Seat 6: 44a078c0 ($10.98 in chips)
22e8274e: posts small blind $0.05
Hero: posts big blind $0.1
*** HOLE CARDS ***
Dealt to 4dd7bc95 
Dealt to 22e8274e 
Dealt to Hero [6c 3c]
Dealt to a7936163 
Dealt to 1d37642 
Dealt to 44a078c0 
a7936163: folds
1d37642: folds
44a078c0: folds
4dd7bc95: raises $0.15 to $0.25
22e8274e: folds
Hero: folds
Uncalled bet ($0.15) returned to 4dd7bc95
*** SHOWDOWN ***
4dd7bc95 collected $0.25 from pot
*** SUMMARY ***
Total pot $0.25 | Rake $0 | Jackpot $0 | Bingo $0 | Fortune $0 | Tax $0
Seat 1: 4dd7bc95 (button) collected ($0.25)
Seat 2: 22e8274e (small blind) folded before Flop
Seat 3: Hero (big blind) folded before Flop
Seat 4: a7936163 folded before Flop (didn't bet)
Seat 5: 1d37642 folded before Flop (didn't bet)
Seat 6: 44a078c0 folded before Flop (didn't bet)


Poker Hand #RC3141671822: Hold'em No Limit ($0.05/$0.1) - 2024/12/12 12:52:57
Table 'RushAndCash22317082' 6-max Seat #1 is the button
Seat 1: 5ddf2544 ($13.79 in chips)
Seat 2: Hero ($10.2 in chips)
Seat 3: bc8cb2ed ($7.3 in chips)
Seat 4: b17f5bfe ($6.82 in chips)
Seat 5: d07ab82c ($10.35 in chips)
Seat 6: e3244dc0 ($11.76 in chips)
Hero: posts small blind $0.05
bc8cb2ed: posts big blind $0.1
*** HOLE CARDS ***
Dealt to 5ddf2544 
Dealt to Hero [9c 9h]
Dealt to bc8cb2ed 
Dealt to b17f5bfe 
Dealt to d07ab82c 
Dealt to e3244dc0 
b17f5bfe: folds
d07ab82c: raises $0.1 to $0.2
e3244dc0: calls $0.2
5ddf2544: folds
Hero: folds
bc8cb2ed: calls $0.1
*** FLOP *** [4c 3d 2c]
bc8cb2ed: checks
d07ab82c: checks
e3244dc0: checks
*** TURN *** [4c 3d 2c] [3h]
bc8cb2ed: bets $0.33
d07ab82c: calls $0.33
e3244dc0: folds
*** RIVER *** [4c 3d 2c 3h] [Ah]
bc8cb2ed: bets $0.99
d07ab82c: calls $0.99
bc8cb2ed: shows [5s 5c] (Fives-High Straight)
d07ab82c: shows [Kc As] (Pair of Aces and Pair of Treys)
*** SHOWDOWN ***
bc8cb2ed collected $2.99 from pot
*** SUMMARY ***
Total pot $3.29 | Rake $0.15 | Jackpot $0.15 | Bingo $0 | Fortune $0 | Tax $0
Board [4c 3d 2c 3h Ah]
Seat 1: 5ddf2544 (button) folded before Flop (didn't bet)
Seat 2: Hero (small blind) folded before Flop
Seat 3: bc8cb2ed (big blind) showed [5s 5c] and won ($2.99) with Fives-High Straight
Seat 4: b17f5bfe folded before Flop (didn't bet)
Seat 5: d07ab82c showed [Kc As] and lost with Pair of Aces and Pair of Treys
Seat 6: e3244dc0 folded on the Turn


Poker Hand #RC3141671808: Hold'em No Limit ($0.05/$0.1) - 2024/12/12 12:52:54
Table 'RushAndCash22317068' 6-max Seat #1 is the button
Seat 1: 218d031b ($12.2 in chips)
Seat 2: e3244dc0 ($11.81 in chips)
Seat 3: a730cdce ($10.43 in chips)
Seat 4: f2ece23 ($14.23 in chips)
Seat 5: b17f5bfe ($6.82 in chips)
Seat 6: Hero ($10.2 in chips)
e3244dc0: posts small blind $0.05
a730cdce: posts big blind $0.1
*** HOLE CARDS ***
Dealt to 218d031b 
Dealt to e3244dc0 
Dealt to a730cdce 
Dealt to f2ece23 
Dealt to b17f5bfe 
Dealt to Hero [5h 7s]
f2ece23: folds
b17f5bfe: folds
Hero: folds
218d031b: raises $0.2 to $0.3
e3244dc0: folds
a730cdce: folds
Uncalled bet ($0.2) returned to 218d031b
*** SHOWDOWN ***
218d031b collected $0.25 from pot
*** SUMMARY ***
Total pot $0.25 | Rake $0 | Jackpot $0 | Bingo $0 | Fortune $0 | Tax $0
Seat 1: 218d031b (button) collected ($0.25)
Seat 2: e3244dc0 (small blind) folded before Flop
Seat 3: a730cdce (big blind) folded before Flop
Seat 4: f2ece23 folded before Flop (didn't bet)
Seat 5: b17f5bfe folded before Flop (didn't bet)
Seat 6: Hero folded before Flop (didn't bet)


Poker Hand #RC3141671763: Hold'em No Limit ($0.05/$0.1) - 2024/12/12 12:52:42
Table 'RushAndCash22317023' 6-max Seat #1 is the button
Seat 1: 2a6446ed ($19.79 in chips)
Seat 2: 3ad08c03 ($10.64 in chips)
Seat 3: f3cd242a ($18.26 in chips)
Seat 4: Hero ($10.05 in chips)
Seat 5: 8a55880e ($10.05 in chips)
Seat 6: 74b4c8de ($9.85 in chips)
3ad08c03: posts small blind $0.05
f3cd242a: posts big blind $0.1
*** HOLE CARDS ***
Dealt to 2a6446ed 
Dealt to 3ad08c03 
Dealt to f3cd242a 
Dealt to Hero [3h Ah]
Dealt to 8a55880e 
Dealt to 74b4c8de 
Hero: raises $0.1 to $0.2
8a55880e: folds
74b4c8de: folds
2a6446ed: folds
3ad08c03: folds
f3cd242a: folds
Uncalled bet ($0.1) returned to Hero
*** SHOWDOWN ***
Hero collected $0.25 from pot
*** SUMMARY ***
Total pot $0.25 | Rake $0 | Jackpot $0 | Bingo $0 | Fortune $0 | Tax $0
Seat 1: 2a6446ed (button) folded before Flop (didn't bet)
Seat 2: 3ad08c03 (small blind) folded before Flop
Seat 3: f3cd242a (big blind) folded before Flop
Seat 4: Hero collected ($0.25)
Seat 5: 8a55880e folded before Flop (didn't bet)
Seat 6: 74b4c8de folded before Flop (didn't bet)


Poker Hand #RC3141671750: Hold'em No Limit ($0.05/$0.1) - 2024/12/12 12:52:38
Table 'RushAndCash22317010' 6-max Seat #1 is the button
Seat 1: ead6156b ($7.21 in chips)
Seat 2: caa1a4d ($10.55 in chips)
Seat 3: 4740c06b ($10.94 in chips)
Seat 4: 8a55880e ($10.05 in chips)
Seat 5: c8c2a1e ($10.66 in chips)
Seat 6: Hero ($10.05 in chips)
caa1a4d: posts small blind $0.05
4740c06b: posts big blind $0.1
*** HOLE CARDS ***
Dealt to ead6156b 
Dealt to caa1a4d 
Dealt to 4740c06b 
Dealt to 8a55880e 
Dealt to c8c2a1e 
Dealt to Hero [8h Tc]
8a55880e: folds
c8c2a1e: folds
Hero: folds
ead6156b: raises $0.1 to $0.2
caa1a4d: folds
4740c06b: folds
Uncalled bet ($0.1) returned to ead6156b
*** SHOWDOWN ***
ead6156b collected $0.25 from pot
*** SUMMARY ***
Total pot $0.25 | Rake $0 | Jackpot $0 | Bingo $0 | Fortune $0 | Tax $0
Seat 1: ead6156b (button) collected ($0.25)
Seat 2: caa1a4d (small blind) folded before Flop
Seat 3: 4740c06b (big blind) folded before Flop
Seat 4: 8a55880e folded before Flop (didn't bet)
Seat 5: c8c2a1e folded before Flop (didn't bet)
Seat 6: Hero folded before Flop (didn't bet)


Poker Hand #RC3141671735: Hold'em No Limit ($0.05/$0.1) - 2024/12/12 12:52:35
Table 'RushAndCash22316995' 6-max Seat #1 is the button
Seat 1: 6ac23d86 ($10 in chips)
Seat 2: Hero ($10.1 in chips)
Seat 3: a7936163 ($15.84 in chips)
Seat 4: 4740c06b ($10.94 in chips)
Seat 5: d1764387 ($15.28 in chips)
Seat 6: 43eb8c8a ($10 in chips)
Hero: posts small blind $0.05
a7936163: posts big blind $0.1
*** HOLE CARDS ***
Dealt to 6ac23d86 
Dealt to Hero [7h 3d]
Dealt to a7936163 
Dealt to 4740c06b 
Dealt to d1764387 
Dealt to 43eb8c8a 
4740c06b: folds
d1764387: folds
43eb8c8a: raises $0.15 to $0.25
6ac23d86: raises $0.5 to $0.75
Hero: folds
a7936163: folds
43eb8c8a: calls $0.5
*** FLOP *** [8c Kd 2d]
43eb8c8a: checks
6ac23d86: bets $0.55
43eb8c8a: calls $0.55
*** TURN *** [8c Kd 2d] [9d]
43eb8c8a: checks
6ac23d86: checks
*** RIVER *** [8c Kd 2d 9d] [6c]
43eb8c8a: checks
6ac23d86: bets $2.15
43eb8c8a: folds
Uncalled bet ($2.15) returned to 6ac23d86
*** SHOWDOWN ***
6ac23d86 collected $2.62 from pot
*** SUMMARY ***
Total pot $2.75 | Rake $0.13 | Jackpot $0 | Bingo $0 | Fortune $0 | Tax $0
Board [8c Kd 2d 9d 6c]
Seat 1: 6ac23d86 (button) won ($2.62)
Seat 2: Hero (small blind) folded before Flop
Seat 3: a7936163 (big blind) folded before Flop
Seat 4: 4740c06b folded before Flop (didn't bet)
Seat 5: d1764387 folded before Flop (didn't bet)
Seat 6: 43eb8c8a folded on the River


Poker Hand #RC3141671710: Hold'em No Limit ($0.05/$0.1) - 2024/12/12 12:52:29
Table 'RushAndCash22316970' 6-max Seat #1 is the button
Seat 1: Hero ($10.1 in chips)
Seat 2: d1764387 ($15.33 in chips)
Seat 3: b863ea8c ($13.76 in chips)
Seat 4: fd36d45d ($9.85 in chips)
Seat 5: 4a1f9c37 ($7.35 in chips)
Seat 6: 2746c1f0 ($10 in chips)
d1764387: posts small blind $0.05
b863ea8c: posts big blind $0.1
*** HOLE CARDS ***
Dealt to Hero [Th Kc]
Dealt to d1764387 
Dealt to b863ea8c 
Dealt to fd36d45d 
Dealt to 4a1f9c37 
Dealt to 2746c1f0 
fd36d45d: raises $0.11 to $0.21
4a1f9c37: folds
2746c1f0: folds
Hero: folds
d1764387: folds
b863ea8c: folds
Uncalled bet ($0.11) returned to fd36d45d
*** SHOWDOWN ***
fd36d45d collected $0.25 from pot
*** SUMMARY ***
Total pot $0.25 | Rake $0 | Jackpot $0 | Bingo $0 | Fortune $0 | Tax $0
Seat 1: Hero (button) folded before Flop (didn't bet)
Seat 2: d1764387 (small blind) folded before Flop
Seat 3: b863ea8c (big blind) folded before Flop
Seat 4: fd36d45d collected ($0.25)
Seat 5: 4a1f9c37 folded before Flop (didn't bet)
Seat 6: 2746c1f0 folded before Flop (didn't bet)


Poker Hand #RC3141671482: Hold'em No Limit ($0.05/$0.1) - 2024/12/12 12:51:28
Table 'RushAndCash22316742' 6-max Seat #1 is the button
Seat 1: bf6a4250 ($18.96 in chips)
Seat 2: e12528c0 ($33.49 in chips)
Seat 3: Hero ($10.3 in chips)
Seat 4: 566d8ba0 ($10 in chips)
Seat 5: f209060b ($10 in chips)
Seat 6: 77907fc4 ($22.23 in chips)
e12528c0: posts small blind $0.05
Hero: posts big blind $0.1
*** HOLE CARDS ***
Dealt to bf6a4250 
Dealt to e12528c0 
Dealt to Hero [5h 4h]
Dealt to 566d8ba0 
Dealt to f209060b 
Dealt to 77907fc4 
566d8ba0: raises $0.1 to $0.2
f209060b: folds
77907fc4: folds
bf6a4250: folds
e12528c0: folds
Hero: calls $0.1
*** FLOP *** [Jc Qc Qh]
Hero: checks
566d8ba0: bets $0.3
Hero: folds
Uncalled bet ($0.3) returned to 566d8ba0
*** SHOWDOWN ***
566d8ba0 collected $0.43 from pot
*** SUMMARY ***
Total pot $0.45 | Rake $0.02 | Jackpot $0 | Bingo $0 | Fortune $0 | Tax $0
Board [Jc Qc Qh]
Seat 1: bf6a4250 (button) folded before Flop (didn't bet)
Seat 2: e12528c0 (small blind) folded before Flop
Seat 3: Hero (big blind) folded on the Flop
Seat 4: 566d8ba0 won ($0.43)
Seat 5: f209060b folded before Flop (didn't bet)
Seat 6: 77907fc4 folded before Flop (didn't bet)


Poker Hand #RC3141671351: Hold'em No Limit ($0.05/$0.1) - 2024/12/12 12:50:55
Table 'RushAndCash22316611' 6-max Seat #1 is the button
Seat 1: d1764387 ($15.28 in chips)
Seat 2: f323cdf3 ($11.9 in chips)
Seat 3: e12528c0 ($33.74 in chips)
Seat 4: 645be922 ($10.33 in chips)
Seat 5: 719fb29e ($13.78 in chips)
Seat 6: Hero ($10.02 in chips)
f323cdf3: posts small blind $0.05
e12528c0: posts big blind $0.1
*** HOLE CARDS ***
Dealt to d1764387 
Dealt to f323cdf3 
Dealt to e12528c0 
Dealt to 645be922 
Dealt to 719fb29e 
Dealt to Hero [Ad 5d]
645be922: folds
719fb29e: folds
Hero: raises $0.15 to $0.25
d1764387: folds
f323cdf3: folds
e12528c0: calls $0.15
*** FLOP *** [Jc Qd Qc]
e12528c0: checks
Hero: bets $0.14
e12528c0: folds
Uncalled bet ($0.14) returned to Hero
*** SHOWDOWN ***
Hero collected $0.53 from pot
*** SUMMARY ***
Total pot $0.55 | Rake $0.02 | Jackpot $0 | Bingo $0 | Fortune $0 | Tax $0
Board [Jc Qd Qc]
Seat 1: d1764387 (button) folded before Flop (didn't bet)
Seat 2: f323cdf3 (small blind) folded before Flop
Seat 3: e12528c0 (big blind) folded on the Flop
Seat 4: 645be922 folded before Flop (didn't bet)
Seat 5: 719fb29e folded before Flop (didn't bet)
Seat 6: Hero won ($0.53)


Poker Hand #RC3141671335: Hold'em No Limit ($0.05/$0.1) - 2024/12/12 12:50:51
Table 'RushAndCash22316595' 6-max Seat #1 is the button
Seat 1: 902b9d1a ($9.63 in chips)
Seat 2: d8e077e9 ($40.23 in chips)
Seat 3: c8c2a1e ($10.37 in chips)
Seat 4: 719fb29e ($13.78 in chips)
Seat 5: Hero ($10.02 in chips)
Seat 6: c6786b68 ($16.08 in chips)
d8e077e9: posts small blind $0.05
c8c2a1e: posts big blind $0.1
*** HOLE CARDS ***
Dealt to 902b9d1a 
Dealt to d8e077e9 
Dealt to c8c2a1e 
Dealt to 719fb29e 
Dealt to Hero [4h 9c]
Dealt to c6786b68 
719fb29e: folds
Hero: folds
c6786b68: folds
902b9d1a: folds
d8e077e9: raises $0.2 to $0.3
c8c2a1e: calls $0.2
*** FLOP *** [3c 6d Qc]
d8e077e9: checks
c8c2a1e: bets $0.3
d8e077e9: calls $0.3
*** TURN *** [3c 6d Qc] [Jd]
d8e077e9: checks
c8c2a1e: bets $0.96
d8e077e9: folds
Uncalled bet ($0.96) returned to c8c2a1e
*** SHOWDOWN ***
c8c2a1e collected $1.14 from pot
*** SUMMARY ***
Total pot $1.2 | Rake $0.06 | Jackpot $0 | Bingo $0 | Fortune $0 | Tax $0
Board [3c 6d Qc Jd]
Seat 1: 902b9d1a (button) folded before Flop (didn't bet)
Seat 2: d8e077e9 (small blind) folded on the Turn
Seat 3: c8c2a1e (big blind) won ($1.14)
Seat 4: 719fb29e folded before Flop (didn't bet)
Seat 5: Hero folded before Flop (didn't bet)
Seat 6: c6786b68 folded before Flop (didn't bet)


Poker Hand #RC3141671320: Hold'em No Limit ($0.05/$0.1) - 2024/12/12 12:50:48
Table 'RushAndCash22316580' 6-max Seat #1 is the button
Seat 1: daa081a6 ($10.82 in chips)
Seat 2: c6786b68 ($16.13 in chips)
Seat 3: fc90d2af ($8.11 in chips)
Seat 4: Hero ($10.02 in chips)
Seat 5: 6b9a34dd ($11.47 in chips)
Seat 6: d8e077e9 ($40.23 in chips)
c6786b68: posts small blind $0.05
fc90d2af: posts big blind $0.1
*** HOLE CARDS ***
Dealt to daa081a6 
Dealt to c6786b68 
Dealt to fc90d2af 
Dealt to Hero [4c Tc]
Dealt to 6b9a34dd 
Dealt to d8e077e9 
Hero: folds
6b9a34dd: folds
d8e077e9: folds
daa081a6: folds
c6786b68: folds
Uncalled bet ($0.05) returned to fc90d2af
*** SHOWDOWN ***
fc90d2af collected $0.1 from pot
*** SUMMARY ***
Total pot $0.1 | Rake $0 | Jackpot $0 | Bingo $0 | Fortune $0 | Tax $0
Seat 1: daa081a6 (button) folded before Flop (didn't bet)
Seat 2: c6786b68 (small blind) folded before Flop
Seat 3: fc90d2af (big blind) collected ($0.1)
Seat 4: Hero folded before Flop (didn't bet)
Seat 5: 6b9a34dd folded before Flop (didn't bet)
Seat 6: d8e077e9 folded before Flop (didn't bet)


Poker Hand #RC3141671262: Hold'em No Limit ($0.05/$0.1) - 2024/12/12 12:50:33
Table 'RushAndCash22316522' 6-max Seat #1 is the button
Seat 1: Hero ($10.02 in chips)
Seat 2: a1907a02 ($20.56 in chips)
Seat 3: 1d2dacdf ($11.11 in chips)
Seat 4: aaf493a ($14.79 in chips)
Seat 5: caa1a4d ($11 in chips)
Seat 6: 2fb13304 ($10.01 in chips)
a1907a02: posts small blind $0.05
1d2dacdf: posts big blind $0.1
*** HOLE CARDS ***
Dealt to Hero [5h Ah]
Dealt to a1907a02 
Dealt to 1d2dacdf 
Dealt to aaf493a 
Dealt to caa1a4d 
Dealt to 2fb13304 
aaf493a: folds
caa1a4d: folds
2fb13304: raises $0.1 to $0.2
Hero: folds
a1907a02: folds
1d2dacdf: calls $0.1
*** FLOP *** [6h Ts 2c]
1d2dacdf: checks
2fb13304: checks
*** TURN *** [6h Ts 2c] [7d]
1d2dacdf: checks
2fb13304: checks
*** RIVER *** [6h Ts 2c 7d] [8d]
1d2dacdf: checks
2fb13304: checks
1d2dacdf: shows [Qc 3c] (Queen-High)
2fb13304: shows [Ks Ad] (Ace-High)
*** SHOWDOWN ***
2fb13304 collected $0.43 from pot
*** SUMMARY ***
Total pot $0.45 | Rake $0.02 | Jackpot $0 | Bingo $0 | Fortune $0 | Tax $0
Board [6h Ts 2c 7d 8d]
Seat 1: Hero (button) folded before Flop (didn't bet)
Seat 2: a1907a02 (small blind) folded before Flop
Seat 3: 1d2dacdf (big blind) showed [Qc 3c] and lost with Queen-High
Seat 4: aaf493a folded before Flop (didn't bet)
Seat 5: caa1a4d folded before Flop (didn't bet)
Seat 6: 2fb13304 showed [Ks Ad] and won ($0.43) with Ace-High


Poker Hand #RC3141671234: Hold'em No Limit ($0.05/$0.1) - 2024/12/12 12:50:26
Table 'RushAndCash22316494' 6-max Seat #1 is the button
Seat 1: 3a317c38 ($17.17 in chips)
Seat 2: 1a8ef95a ($11.47 in chips)
Seat 3: Hero ($10.12 in chips)
Seat 4: dbcd9107 ($19.47 in chips)
Seat 5: caa1a4d ($11 in chips)
Seat 6: 86ee8e36 ($26.31 in chips)
1a8ef95a: posts small blind $0.05
Hero: posts big blind $0.1
*** HOLE CARDS ***
Dealt to 3a317c38 
Dealt to 1a8ef95a 
Dealt to Hero [3c 8c]
Dealt to dbcd9107 
Dealt to caa1a4d 
Dealt to 86ee8e36 
dbcd9107: folds
caa1a4d: folds
86ee8e36: folds
3a317c38: folds
1a8ef95a: raises $0.11 to $0.21
Hero: folds
Uncalled bet ($0.11) returned to 1a8ef95a
*** SHOWDOWN ***
1a8ef95a collected $0.2 from pot
*** SUMMARY ***
Total pot $0.2 | Rake $0 | Jackpot $0 | Bingo $0 | Fortune $0 | Tax $0
Seat 1: 3a317c38 (button) folded before Flop (didn't bet)
Seat 2: 1a8ef95a (small blind) collected ($0.2)
Seat 3: Hero (big blind) folded before Flop
Seat 4: dbcd9107 folded before Flop (didn't bet)
Seat 5: caa1a4d folded before Flop (didn't bet)
Seat 6: 86ee8e36 folded before Flop (didn't bet)


Poker Hand #RC3141671112: Hold'em No Limit ($0.05/$0.1) - 2024/12/12 12:49:56
Table 'RushAndCash22316372' 6-max Seat #1 is the button
Seat 1: caa1a4d ($10 in chips)
Seat 2: Hero ($11.12 in chips)
Seat 3: 916c6bd3 ($9.36 in chips)
Seat 4: 2ff0a04b ($49.56 in chips)
Seat 5: 745c6911 ($10.47 in chips)
Seat 6: 59307d25 ($13.36 in chips)
Hero: posts small blind $0.05
916c6bd3: posts big blind $0.1
*** HOLE CARDS ***
Dealt to caa1a4d 
Dealt to Hero [Ad Ts]
Dealt to 916c6bd3 
Dealt to 2ff0a04b 
Dealt to 745c6911 
Dealt to 59307d25 
2ff0a04b: folds
745c6911: folds
59307d25: folds
caa1a4d: raises $0.13 to $0.23
Hero: raises $0.77 to $1
916c6bd3: folds
caa1a4d: raises $1.25 to $2.25
Hero: folds
Uncalled bet ($1.25) returned to caa1a4d
*** SHOWDOWN ***
caa1a4d collected $2 from pot
*** SUMMARY ***
Total pot $2.1 | Rake $0.1 | Jackpot $0 | Bingo $0 | Fortune $0 | Tax $0
Seat 1: caa1a4d (button) collected ($2)
Seat 2: Hero (small blind) folded before Flop
Seat 3: 916c6bd3 (big blind) folded before Flop
Seat 4: 2ff0a04b folded before Flop (didn't bet)
Seat 5: 745c6911 folded before Flop (didn't bet)
Seat 6: 59307d25 folded before Flop (didn't bet)


Poker Hand #RC3141671099: Hold'em No Limit ($0.05/$0.1) - 2024/12/12 12:49:53
Table 'RushAndCash22316359' 6-max Seat #1 is the button
Seat 1: d6b17ac7 ($10.97 in chips)
Seat 2: a1f416c7 ($10.56 in chips)
Seat 3: f383ae87 ($23.97 in chips)
Seat 4: 216abb36 ($10 in chips)
Seat 5: Hero ($11.12 in chips)
Seat 6: 24c2159e ($10 in chips)
a1f416c7: posts small blind $0.05
f383ae87: posts big blind $0.1
*** HOLE CARDS ***
Dealt to d6b17ac7 
Dealt to a1f416c7 
Dealt to f383ae87 
Dealt to 216abb36 
Dealt to Hero [4h 3s]
Dealt to 24c2159e 
216abb36: raises $0.1 to $0.2
Hero: folds
24c2159e: raises $0.42 to $0.62
d6b17ac7: folds
a1f416c7: folds
f383ae87: folds
216abb36: calls $0.42
*** FLOP *** [Ks 7c Th]
216abb36: checks
24c2159e: bets $0.46
216abb36: folds
Uncalled bet ($0.46) returned to 24c2159e
*** SHOWDOWN ***
24c2159e collected $1.32 from pot
*** SUMMARY ***
Total pot $1.39 | Rake $0.07 | Jackpot $0 | Bingo $0 | Fortune $0 | Tax $0
Board [Ks 7c Th]
Seat 1: d6b17ac7 (button) folded before Flop (didn't bet)
Seat 2: a1f416c7 (small blind) folded before Flop
Seat 3: f383ae87 (big blind) folded before Flop
Seat 4: 216abb36 folded on the Flop
Seat 5: Hero folded before Flop (didn't bet)
Seat 6: 24c2159e won ($1.32)


Poker Hand #RC3141671086: Hold'em No Limit ($0.05/$0.1) - 2024/12/12 12:49:49
Table 'RushAndCash22316346' 6-max Seat #1 is the button
Seat 1: f383ae87 ($23.97 in chips)
Seat 2: cfe70ef2 ($10.51 in chips)
Seat 3: 59307d25 ($13.46 in chips)
Seat 4: 24c2159e ($10 in chips)
Seat 5: Hero ($11.12 in chips)
Seat 6: 9a52083d ($24.97 in chips)
cfe70ef2: posts small blind $0.05
59307d25: posts big blind $0.1
*** HOLE CARDS ***
Dealt to f383ae87 
Dealt to cfe70ef2 
Dealt to 59307d25 
Dealt to 24c2159e 
Dealt to Hero [Qd Ts]
Dealt to 9a52083d 
24c2159e: folds
Hero: folds
9a52083d: raises $0.15 to $0.25
f383ae87: folds
cfe70ef2: folds
59307d25: folds
Uncalled bet ($0.15) returned to 9a52083d
*** SHOWDOWN ***
9a52083d collected $0.25 from pot
*** SUMMARY ***
Total pot $0.25 | Rake $0 | Jackpot $0 | Bingo $0 | Fortune $0 | Tax $0
Seat 1: f383ae87 (button) folded before Flop (didn't bet)
Seat 2: cfe70ef2 (small blind) folded before Flop
Seat 3: 59307d25 (big blind) folded before Flop
Seat 4: 24c2159e folded before Flop (didn't bet)
Seat 5: Hero folded before Flop (didn't bet)
Seat 6: 9a52083d collected ($0.25)


Poker Hand #RC3141671071: Hold'em No Limit ($0.05/$0.1) - 2024/12/12 12:49:46
Table 'RushAndCash22316331' 6-max Seat #1 is the button
Seat 1: 5346f1e0 ($10 in chips)
Seat 2: ca49e84c ($10 in chips)
Seat 3: 8fc49c26 ($42.91 in chips)
Seat 4: d9ccf407 ($12.39 in chips)
Seat 5: a5f5a77f ($11.82 in chips)
Seat 6: Hero ($11.12 in chips)
ca49e84c: posts small blind $0.05
8fc49c26: posts big blind $0.1
*** HOLE CARDS ***
Dealt to 5346f1e0 
Dealt to ca49e84c 
Dealt to 8fc49c26 
Dealt to d9ccf407 
Dealt to a5f5a77f 
Dealt to Hero [8s Qd]
d9ccf407: folds
a5f5a77f: folds
Hero: folds
5346f1e0: raises $0.15 to $0.25
ca49e84c: raises $0.6 to $0.85
8fc49c26: folds
5346f1e0: raises $1.15 to $2
ca49e84c: calls $1.15
*** FLOP *** [6s 9c 8h]
ca49e84c: checks
5346f1e0: checks
*** TURN *** [6s 9c 8h] [5s]
ca49e84c: bets $2.71
5346f1e0: folds
Uncalled bet ($2.71) returned to ca49e84c
*** SHOWDOWN ***
ca49e84c collected $3.76 from pot
*** SUMMARY ***
Total pot $4.1 | Rake $0.19 | Jackpot $0.15 | Bingo $0 | Fortune $0 | Tax $0
Board [6s 9c 8h 5s]
Seat 1: 5346f1e0 (button) folded on the Turn
Seat 2: ca49e84c (small blind) won ($3.76)
Seat 3: 8fc49c26 (big blind) folded before Flop
Seat 4: d9ccf407 folded before Flop (didn't bet)
Seat 5: a5f5a77f folded before Flop (didn't bet)
Seat 6: Hero folded before Flop (didn't bet)


Poker Hand #RC3141670994: Hold'em No Limit ($0.05/$0.1) - 2024/12/12 12:49:26
Table 'RushAndCash22316254' 6-max Seat #1 is the button
Seat 1: 1dc34506 ($14.38 in chips)
Seat 2: Hero ($11.02 in chips)
Seat 3: dea1301e ($21.59 in chips)
Seat 4: 24039de0 ($10.23 in chips)
Seat 5: 6c4ba3fb ($10.06 in chips)
Seat 6: b8e03e64 ($10.88 in chips)
Hero: posts small blind $0.05
dea1301e: posts big blind $0.1
*** HOLE CARDS ***
Dealt to 1dc34506 
Dealt to Hero [Ah 6d]
Dealt to dea1301e 
Dealt to 24039de0 
Dealt to 6c4ba3fb 
Dealt to b8e03e64 
24039de0: folds
6c4ba3fb: folds
b8e03e64: folds
1dc34506: folds
Hero: raises $0.2 to $0.3
dea1301e: folds
Uncalled bet ($0.2) returned to Hero
*** SHOWDOWN ***
Hero collected $0.2 from pot
*** SUMMARY ***
Total pot $0.2 | Rake $0 | Jackpot $0 | Bingo $0 | Fortune $0 | Tax $0
Seat 1: 1dc34506 (button) folded before Flop (didn't bet)
Seat 2: Hero (small blind) collected ($0.2)
Seat 3: dea1301e (big blind) folded before Flop
Seat 4: 24039de0 folded before Flop (didn't bet)
Seat 5: 6c4ba3fb folded before Flop (didn't bet)
Seat 6: b8e03e64 folded before Flop (didn't bet)


Poker Hand #RC3141670960: Hold'em No Limit ($0.05/$0.1) - 2024/12/12 12:49:18
Table 'RushAndCash22316220' 6-max Seat #1 is the button
Seat 1: 272db4d7 ($20.19 in chips)
Seat 2: e6eec7bb ($10.1 in chips)
Seat 3: Hero ($10.97 in chips)
Seat 4: d43f1d14 ($10 in chips)
Seat 5: 4e5c7119 ($11.5 in chips)
Seat 6: 4b728c96 ($14.13 in chips)
e6eec7bb: posts small blind $0.05
Hero: posts big blind $0.1
*** HOLE CARDS ***
Dealt to 272db4d7 
Dealt to e6eec7bb 
Dealt to Hero [Ah Kc]
Dealt to d43f1d14 
Dealt to 4e5c7119 
Dealt to 4b728c96 
d43f1d14: folds
4e5c7119: folds
4b728c96: folds
272db4d7: folds
e6eec7bb: folds
Uncalled bet ($0.05) returned to Hero
*** SHOWDOWN ***
Hero collected $0.1 from pot
*** SUMMARY ***
Total pot $0.1 | Rake $0 | Jackpot $0 | Bingo $0 | Fortune $0 | Tax $0
Seat 1: 272db4d7 (button) folded before Flop (didn't bet)
Seat 2: e6eec7bb (small blind) folded before Flop
Seat 3: Hero (big blind) collected ($0.1)
Seat 4: d43f1d14 folded before Flop (didn't bet)
Seat 5: 4e5c7119 folded before Flop (didn't bet)
Seat 6: 4b728c96 folded before Flop (didn't bet)


Poker Hand #RC3141670913: Hold'em No Limit ($0.05/$0.1) - 2024/12/12 12:49:05
Table 'RushAndCash22316173' 6-max Seat #1 is the button
Seat 1: Hero ($10.97 in chips)
Seat 2: 8a55880e ($10 in chips)
Seat 3: fed024e0 ($10.64 in chips)
Seat 4: 52c6c741 ($11.09 in chips)
Seat 5: 4684e24a ($18.29 in chips)
Seat 6: b69e52ed ($11.41 in chips)
8a55880e: posts small blind $0.05
fed024e0: posts big blind $0.1
*** HOLE CARDS ***
Dealt to Hero [7d Td]
Dealt to 8a55880e 
Dealt to fed024e0 
Dealt to 52c6c741 
Dealt to 4684e24a 
Dealt to b69e52ed 
52c6c741: folds
4684e24a: folds
b69e52ed: raises $0.12 to $0.22
Hero: folds
8a55880e: folds
fed024e0: folds
Uncalled bet ($0.12) returned to b69e52ed
*** SHOWDOWN ***
b69e52ed collected $0.25 from pot
*** SUMMARY ***
Total pot $0.25 | Rake $0 | Jackpot $0 | Bingo $0 | Fortune $0 | Tax $0
Seat 1: Hero (button) folded before Flop (didn't bet)
Seat 2: 8a55880e (small blind) folded before Flop
Seat 3: fed024e0 (big blind) folded before Flop
Seat 4: 52c6c741 folded before Flop (didn't bet)
Seat 5: 4684e24a folded before Flop (didn't bet)
Seat 6: b69e52ed collected ($0.25)


Poker Hand #RC3141670892: Hold'em No Limit ($0.05/$0.1) - 2024/12/12 12:49:00
Table 'RushAndCash22316152' 6-max Seat #1 is the button
Seat 1: ec7ff353 ($10.28 in chips)
Seat 2: ff1406c1 ($10.34 in chips)
Seat 3: a730cdce ($10.27 in chips)
Seat 4: e4fc8b12 ($12.36 in chips)
Seat 5: Hero ($10.97 in chips)
Seat 6: f347a136 ($11.04 in chips)
ff1406c1: posts small blind $0.05
a730cdce: posts big blind $0.1
*** HOLE CARDS ***
Dealt to ec7ff353 
Dealt to ff1406c1 
Dealt to a730cdce 
Dealt to e4fc8b12 
Dealt to Hero [5h 5d]
Dealt to f347a136 
e4fc8b12: folds
Hero: folds
f347a136: raises $0.12 to $0.22
ec7ff353: raises $0.45 to $0.67
ff1406c1: folds
a730cdce: folds
f347a136: raises $1.33 to $2
ec7ff353: folds
Uncalled bet ($1.33) returned to f347a136
*** SHOWDOWN ***
f347a136 collected $1.42 from pot
*** SUMMARY ***
Total pot $1.49 | Rake $0.07 | Jackpot $0 | Bingo $0 | Fortune $0 | Tax $0
Seat 1: ec7ff353 (button) folded before Flop
Seat 2: ff1406c1 (small blind) folded before Flop
Seat 3: a730cdce (big blind) folded before Flop
Seat 4: e4fc8b12 folded before Flop (didn't bet)
Seat 5: Hero folded before Flop (didn't bet)
Seat 6: f347a136 collected ($1.42)


Poker Hand #RC3141670806: Hold'em No Limit ($0.05/$0.1) - 2024/12/12 12:48:36
Table 'RushAndCash22316066' 6-max Seat #1 is the button
Seat 1: Hero ($11.22 in chips)
Seat 2: 95e11761 ($12.64 in chips)
Seat 3: ec7ff353 ($10 in chips)
Seat 4: cfe70ef2 ($10.35 in chips)
Seat 5: d1122f42 ($10.33 in chips)
Seat 6: daa081a6 ($10.84 in chips)
95e11761: posts small blind $0.05
ec7ff353: posts big blind $0.1
*** HOLE CARDS ***
Dealt to Hero [Js Kd]
Dealt to 95e11761 
Dealt to ec7ff353 
Dealt to cfe70ef2 
Dealt to d1122f42 
Dealt to daa081a6 
cfe70ef2: folds
d1122f42: folds
daa081a6: folds
Hero: raises $0.15 to $0.25
95e11761: folds
ec7ff353: raises $0.85 to $1.1
Hero: folds
Uncalled bet ($0.85) returned to ec7ff353
*** SHOWDOWN ***
ec7ff353 collected $0.53 from pot
*** SUMMARY ***
Total pot $0.55 | Rake $0.02 | Jackpot $0 | Bingo $0 | Fortune $0 | Tax $0
Seat 1: Hero (button) folded before Flop
Seat 2: 95e11761 (small blind) folded before Flop
Seat 3: ec7ff353 (big blind) collected ($0.53)
Seat 4: cfe70ef2 folded before Flop (didn't bet)
Seat 5: d1122f42 folded before Flop (didn't bet)
Seat 6: daa081a6 folded before Flop (didn't bet)


Poker Hand #RC3141670793: Hold'em No Limit ($0.05/$0.1) - 2024/12/12 12:48:33
Table 'RushAndCash22316053' 6-max Seat #1 is the button
Seat 1: 874888c4 ($11.61 in chips)
Seat 2: 111c75 ($10.05 in chips)
Seat 3: e4fc8b12 ($12.51 in chips)
Seat 4: daa081a6 ($10.84 in chips)
Seat 5: Hero ($11.22 in chips)
Seat 6: cfe70ef2 ($10.35 in chips)
111c75: posts small blind $0.05
e4fc8b12: posts big blind $0.1
*** HOLE CARDS ***
Dealt to 874888c4 
Dealt to 111c75 
Dealt to e4fc8b12 
Dealt to daa081a6 
Dealt to Hero [3h 4s]
Dealt to cfe70ef2 
daa081a6: folds
Hero: folds
cfe70ef2: folds
874888c4: folds
111c75: folds
Uncalled bet ($0.05) returned to e4fc8b12
*** SHOWDOWN ***
e4fc8b12 collected $0.1 from pot
*** SUMMARY ***
Total pot $0.1 | Rake $0 | Jackpot $0 | Bingo $0 | Fortune $0 | Tax $0
Seat 1: 874888c4 (button) folded before Flop (didn't bet)
Seat 2: 111c75 (small blind) folded before Flop
Seat 3: e4fc8b12 (big blind) collected ($0.1)
Seat 4: daa081a6 folded before Flop (didn't bet)
Seat 5: Hero folded before Flop (didn't bet)
Seat 6: cfe70ef2 folded before Flop (didn't bet)


Poker Hand #RC3141670780: Hold'em No Limit ($0.05/$0.1) - 2024/12/12 12:48:30
Table 'RushAndCash22316040' 6-max Seat #1 is the button
Seat 1: 25c1f7d7 ($10 in chips)
Seat 2: cfe70ef2 ($10.4 in chips)
Seat 3: d07ab82c ($10 in chips)
Seat 4: 1cefc6e8 ($11.75 in chips)
Seat 5: f2b49ec ($12.18 in chips)
Seat 6: Hero ($11.22 in chips)
cfe70ef2: posts small blind $0.05
d07ab82c: posts big blind $0.1
*** HOLE CARDS ***
Dealt to 25c1f7d7 
Dealt to cfe70ef2 
Dealt to d07ab82c 
Dealt to 1cefc6e8 
Dealt to f2b49ec 
Dealt to Hero [7d 3c]
1cefc6e8: folds
f2b49ec: folds
Hero: folds
25c1f7d7: raises $0.15 to $0.25
cfe70ef2: folds
d07ab82c: folds
Uncalled bet ($0.15) returned to 25c1f7d7
*** SHOWDOWN ***
25c1f7d7 collected $0.25 from pot
*** SUMMARY ***
Total pot $0.25 | Rake $0 | Jackpot $0 | Bingo $0 | Fortune $0 | Tax $0
Seat 1: 25c1f7d7 (button) collected ($0.25)
Seat 2: cfe70ef2 (small blind) folded before Flop
Seat 3: d07ab82c (big blind) folded before Flop
Seat 4: 1cefc6e8 folded before Flop (didn't bet)
Seat 5: f2b49ec folded before Flop (didn't bet)
Seat 6: Hero folded before Flop (didn't bet)


Poker Hand #RC3141670734: Hold'em No Limit ($0.05/$0.1) - 2024/12/12 12:48:16
Table 'RushAndCash22315994' 6-max Seat #1 is the button
Seat 1: d19ee248 ($8.8 in chips)
Seat 2: b57eea46 ($9.05 in chips)
Seat 3: Hero ($11.17 in chips)
Seat 4: af208717 ($11.86 in chips)
Seat 5: e9fe744a ($37.12 in chips)
Seat 6: f0c37558 ($15.72 in chips)
b57eea46: posts small blind $0.05
Hero: posts big blind $0.1
*** HOLE CARDS ***
Dealt to d19ee248 
Dealt to b57eea46 
Dealt to Hero [8c Kc]
Dealt to af208717 
Dealt to e9fe744a 
Dealt to f0c37558 
af208717: folds
e9fe744a: folds
f0c37558: folds
d19ee248: folds
b57eea46: folds
Uncalled bet ($0.05) returned to Hero
*** SHOWDOWN ***
Hero collected $0.1 from pot
*** SUMMARY ***
Total pot $0.1 | Rake $0 | Jackpot $0 | Bingo $0 | Fortune $0 | Tax $0
Seat 1: d19ee248 (button) folded before Flop (didn't bet)
Seat 2: b57eea46 (small blind) folded before Flop
Seat 3: Hero (big blind) collected ($0.1)
Seat 4: af208717 folded before Flop (didn't bet)
Seat 5: e9fe744a folded before Flop (didn't bet)
Seat 6: f0c37558 folded before Flop (didn't bet)


Poker Hand #RC3141670703: Hold'em No Limit ($0.05/$0.1) - 2024/12/12 12:48:08
Table 'RushAndCash22315963' 6-max Seat #1 is the button
Seat 1: 5ddf2544 ($13.15 in chips)
Seat 2: Hero ($11.22 in chips)
Seat 3: eb12374a ($10 in chips)
Seat 4: a1394882 ($10.33 in chips)
Seat 5: 216abb36 ($10.79 in chips)
Seat 6: 1ecd1474 ($10 in chips)
Hero: posts small blind $0.05
eb12374a: posts big blind $0.1
*** HOLE CARDS ***
Dealt to 5ddf2544 
Dealt to Hero [Kd 9s]
Dealt to eb12374a 
Dealt to a1394882 
Dealt to 216abb36 
Dealt to 1ecd1474 
a1394882: folds
216abb36: folds
1ecd1474: raises $0.12 to $0.22
5ddf2544: folds
Hero: folds
eb12374a: folds
Uncalled bet ($0.12) returned to 1ecd1474
*** SHOWDOWN ***
1ecd1474 collected $0.25 from pot
*** SUMMARY ***
Total pot $0.25 | Rake $0 | Jackpot $0 | Bingo $0 | Fortune $0 | Tax $0
Seat 1: 5ddf2544 (button) folded before Flop (didn't bet)
Seat 2: Hero (small blind) folded before Flop
Seat 3: eb12374a (big blind) folded before Flop
Seat 4: a1394882 folded before Flop (didn't bet)
Seat 5: 216abb36 folded before Flop (didn't bet)
Seat 6: 1ecd1474 collected ($0.25)


Poker Hand #RC3141670581: Hold'em No Limit ($0.05/$0.1) - 2024/12/12 12:47:37
Table 'RushAndCash22315841' 6-max Seat #1 is the button
Seat 1: c8e1bfcc ($9.8 in chips)
Seat 2: c2b852ae ($11.62 in chips)
Seat 3: 7829feb5 ($10.93 in chips)
Seat 4: 23d20ac6 ($17.19 in chips)
Seat 5: Hero ($11.42 in chips)
Seat 6: a1394882 ($10 in chips)
c2b852ae: posts small blind $0.05
7829feb5: posts big blind $0.1
*** HOLE CARDS ***
Dealt to c8e1bfcc 
Dealt to c2b852ae 
Dealt to 7829feb5 
Dealt to 23d20ac6 
Dealt to Hero [Ad 6d]
Dealt to a1394882 
23d20ac6: folds
Hero: raises $0.1 to $0.2
a1394882: raises $0.42 to $0.62
c8e1bfcc: folds
c2b852ae: folds
7829feb5: folds
Hero: folds
Uncalled bet ($0.42) returned to a1394882
*** SHOWDOWN ***
a1394882 collected $0.53 from pot
*** SUMMARY ***
Total pot $0.55 | Rake $0.02 | Jackpot $0 | Bingo $0 | Fortune $0 | Tax $0
Seat 1: c8e1bfcc (button) folded before Flop (didn't bet)
Seat 2: c2b852ae (small blind) folded before Flop
Seat 3: 7829feb5 (big blind) folded before Flop
Seat 4: 23d20ac6 folded before Flop (didn't bet)
Seat 5: Hero folded before Flop
Seat 6: a1394882 collected ($0.53)


Poker Hand #RC3141670567: Hold'em No Limit ($0.05/$0.1) - 2024/12/12 12:47:34
Table 'RushAndCash22315827' 6-max Seat #1 is the button
Seat 1: 7829feb5 ($10.93 in chips)
Seat 2: a3382d82 ($21.54 in chips)
Seat 3: 208ee152 ($11.89 in chips)
Seat 4: c2b852ae ($11.62 in chips)
Seat 5: 6d89c9cc ($12.74 in chips)
Seat 6: Hero ($11.42 in chips)
a3382d82: posts small blind $0.05
208ee152: posts big blind $0.1
*** HOLE CARDS ***
Dealt to 7829feb5 
Dealt to a3382d82 
Dealt to 208ee152 
Dealt to c2b852ae 
Dealt to 6d89c9cc 
Dealt to Hero [8d 6c]
c2b852ae: folds
6d89c9cc: raises $0.1 to $0.2
Hero: folds
7829feb5: folds
a3382d82: folds
208ee152: folds
Uncalled bet ($0.1) returned to 6d89c9cc
*** SHOWDOWN ***
6d89c9cc collected $0.25 from pot
*** SUMMARY ***
Total pot $0.25 | Rake $0 | Jackpot $0 | Bingo $0 | Fortune $0 | Tax $0
Seat 1: 7829feb5 (button) folded before Flop (didn't bet)
Seat 2: a3382d82 (small blind) folded before Flop
Seat 3: 208ee152 (big blind) folded before Flop
Seat 4: c2b852ae folded before Flop (didn't bet)
Seat 5: 6d89c9cc collected ($0.25)
Seat 6: Hero folded before Flop (didn't bet)


Poker Hand #RC3141670516: Hold'em No Limit ($0.05/$0.1) - 2024/12/12 12:47:21
Table 'RushAndCash22315776' 6-max Seat #1 is the button
Seat 1: 2e3105a5 ($11.79 in chips)
Seat 2: Hero ($11.47 in chips)
Seat 3: 8ebad06f ($15.11 in chips)
Seat 4: 3a317c38 ($15.17 in chips)
Seat 5: cfe70ef2 ($10.75 in chips)
Seat 6: e4fc8b12 ($10.54 in chips)
Hero: posts small blind $0.05
8ebad06f: posts big blind $0.1
*** HOLE CARDS ***
Dealt to 2e3105a5 
Dealt to Hero [2c Jc]
Dealt to 8ebad06f 
Dealt to 3a317c38 
Dealt to cfe70ef2 
Dealt to e4fc8b12 
3a317c38: folds
cfe70ef2: folds
e4fc8b12: folds
2e3105a5: folds
Hero: folds
Uncalled bet ($0.05) returned to 8ebad06f
*** SHOWDOWN ***
8ebad06f collected $0.1 from pot
*** SUMMARY ***
Total pot $0.1 | Rake $0 | Jackpot $0 | Bingo $0 | Fortune $0 | Tax $0
Seat 1: 2e3105a5 (button) folded before Flop (didn't bet)
Seat 2: Hero (small blind) folded before Flop
Seat 3: 8ebad06f (big blind) collected ($0.1)
Seat 4: 3a317c38 folded before Flop (didn't bet)
Seat 5: cfe70ef2 folded before Flop (didn't bet)
Seat 6: e4fc8b12 folded before Flop (didn't bet)


Poker Hand #RC3141670433: Hold'em No Limit ($0.05/$0.1) - 2024/12/12 12:46:57
Table 'RushAndCash22315693' 6-max Seat #1 is the button
Seat 1: Hero ($11.14 in chips)
Seat 2: b0559006 ($9.33 in chips)
Seat 3: 38fd477d ($10.2 in chips)
Seat 4: 3954586d ($10.65 in chips)
Seat 5: 26077f2f ($10.86 in chips)
Seat 6: e4fc8b12 ($10.74 in chips)
b0559006: posts small blind $0.05
38fd477d: posts big blind $0.1
*** HOLE CARDS ***
Dealt to Hero [Qc Qs]
Dealt to b0559006 
Dealt to 38fd477d 
Dealt to 3954586d 
Dealt to 26077f2f 
Dealt to e4fc8b12 
3954586d: folds
26077f2f: folds
e4fc8b12: raises $0.1 to $0.2
Hero: raises $0.42 to $0.62
b0559006: folds
38fd477d: folds
e4fc8b12: folds
Uncalled bet ($0.42) returned to Hero
*** SHOWDOWN ***
Hero collected $0.53 from pot
*** SUMMARY ***
Total pot $0.55 | Rake $0.02 | Jackpot $0 | Bingo $0 | Fortune $0 | Tax $0
Seat 1: Hero (button) collected ($0.53)
Seat 2: b0559006 (small blind) folded before Flop
Seat 3: 38fd477d (big blind) folded before Flop
Seat 4: 3954586d folded before Flop (didn't bet)
Seat 5: 26077f2f folded before Flop (didn't bet)
Seat 6: e4fc8b12 folded before Flop


Poker Hand #RC3141670384: Hold'em No Limit ($0.05/$0.1) - 2024/12/12 12:46:45
Table 'RushAndCash22315644' 6-max Seat #1 is the button
Seat 1: 647dd971 ($10.43 in chips)
Seat 2: 1f54611 ($18.03 in chips)
Seat 3: Hero ($11.24 in chips)
Seat 4: c2b852ae ($11.43 in chips)
Seat 5: 4db3d050 ($8.9 in chips)
Seat 6: a9eb45fc ($10.15 in chips)
1f54611: posts small blind $0.05
Hero: posts big blind $0.1
*** HOLE CARDS ***
Dealt to 647dd971 
Dealt to 1f54611 
Dealt to Hero [7h 2c]
Dealt to c2b852ae 
Dealt to 4db3d050 
Dealt to a9eb45fc 
c2b852ae: raises $0.12 to $0.22
4db3d050: folds
a9eb45fc: folds
647dd971: calls $0.22
1f54611: folds
Hero: folds
*** FLOP *** [As Qc 2h]
c2b852ae: checks
647dd971: checks
*** TURN *** [As Qc 2h] [Js]
c2b852ae: bets $0.2
647dd971: folds
Uncalled bet ($0.2) returned to c2b852ae
647dd971: shows [8s] (Ace-High)
*** SHOWDOWN ***
c2b852ae collected $0.56 from pot
*** SUMMARY ***
Total pot $0.59 | Rake $0.03 | Jackpot $0 | Bingo $0 | Fortune $0 | Tax $0
Board [As Qc 2h Js]
Seat 1: 647dd971 (button) folded on the Turn
Seat 2: 1f54611 (small blind) folded before Flop
Seat 3: Hero (big blind) folded before Flop
Seat 4: c2b852ae won ($0.56)
Seat 5: 4db3d050 folded before Flop (didn't bet)
Seat 6: a9eb45fc folded before Flop (didn't bet)


Poker Hand #RC3141670372: Hold'em No Limit ($0.05/$0.1) - 2024/12/12 12:46:41
Table 'RushAndCash22315632' 6-max Seat #1 is the button
Seat 1: 8e0a697 ($11.36 in chips)
Seat 2: e9fe744a ($38.37 in chips)
Seat 3: 9a52083d ($24.7 in chips)
Seat 4: 874888c4 ($11.91 in chips)
Seat 5: Hero ($11.24 in chips)
Seat 6: 38fd477d ($10.05 in chips)
e9fe744a: posts small blind $0.05
9a52083d: posts big blind $0.1
*** HOLE CARDS ***
Dealt to 8e0a697 
Dealt to e9fe744a 
Dealt to 9a52083d 
Dealt to 874888c4 
Dealt to Hero [7h 5s]
Dealt to 38fd477d 
874888c4: folds
Hero: folds
38fd477d: raises $0.1 to $0.2
8e0a697: folds
e9fe744a: folds
9a52083d: folds
Uncalled bet ($0.1) returned to 38fd477d
*** SHOWDOWN ***
38fd477d collected $0.25 from pot
*** SUMMARY ***
Total pot $0.25 | Rake $0 | Jackpot $0 | Bingo $0 | Fortune $0 | Tax $0
Seat 1: 8e0a697 (button) folded before Flop (didn't bet)
Seat 2: e9fe744a (small blind) folded before Flop
Seat 3: 9a52083d (big blind) folded before Flop
Seat 4: 874888c4 folded before Flop (didn't bet)
Seat 5: Hero folded before Flop (didn't bet)
Seat 6: 38fd477d collected ($0.25)


Poker Hand #RC3141670358: Hold'em No Limit ($0.05/$0.1) - 2024/12/12 12:46:38
Table 'RushAndCash22315618' 6-max Seat #1 is the button
Seat 1: 895d916a ($36.43 in chips)
Seat 2: 3c1b4ee8 ($11.04 in chips)
Seat 3: c6786b68 ($19.49 in chips)
Seat 4: Hero ($11.24 in chips)
Seat 5: c2b852ae ($11.43 in chips)
Seat 6: ed5538ab ($13.77 in chips)
3c1b4ee8: posts small blind $0.05
c6786b68: posts big blind $0.1
*** HOLE CARDS ***
Dealt to 895d916a 
Dealt to 3c1b4ee8 
Dealt to c6786b68 
Dealt to Hero [Ah 2s]
Dealt to c2b852ae 
Dealt to ed5538ab 
Hero: folds
c2b852ae: folds
ed5538ab: folds
895d916a: folds
3c1b4ee8: folds
Uncalled bet ($0.05) returned to c6786b68
*** SHOWDOWN ***
c6786b68 collected $0.1 from pot
*** SUMMARY ***
Total pot $0.1 | Rake $0 | Jackpot $0 | Bingo $0 | Fortune $0 | Tax $0
Seat 1: 895d916a (button) folded before Flop (didn't bet)
Seat 2: 3c1b4ee8 (small blind) folded before Flop
Seat 3: c6786b68 (big blind) collected ($0.1)
Seat 4: Hero folded before Flop (didn't bet)
Seat 5: c2b852ae folded before Flop (didn't bet)
Seat 6: ed5538ab folded before Flop (didn't bet)


Poker Hand #RC3141670344: Hold'em No Limit ($0.05/$0.1) - 2024/12/12 12:46:35
Table 'RushAndCash22315604' 6-max Seat #1 is the button
Seat 1: 6c4ba3fb ($8.75 in chips)
Seat 2: b82279c3 ($40.96 in chips)
Seat 3: 8e0a697 ($11.46 in chips)
Seat 4: Hero ($11.24 in chips)
Seat 5: d9ccf407 ($18.79 in chips)
Seat 6: d75a3941 ($12.12 in chips)
b82279c3: posts small blind $0.05
8e0a697: posts big blind $0.1
*** HOLE CARDS ***
Dealt to 6c4ba3fb 
Dealt to b82279c3 
Dealt to 8e0a697 
Dealt to Hero [4c 2c]
Dealt to d9ccf407 
Dealt to d75a3941 
Hero: folds
d9ccf407: raises $0.1 to $0.2
d75a3941: folds
6c4ba3fb: folds
b82279c3: folds
8e0a697: folds
Uncalled bet ($0.1) returned to d9ccf407
*** SHOWDOWN ***
d9ccf407 collected $0.25 from pot
*** SUMMARY ***
Total pot $0.25 | Rake $0 | Jackpot $0 | Bingo $0 | Fortune $0 | Tax $0
Seat 1: 6c4ba3fb (button) folded before Flop (didn't bet)
Seat 2: b82279c3 (small blind) folded before Flop
Seat 3: 8e0a697 (big blind) folded before Flop
Seat 4: Hero folded before Flop (didn't bet)
Seat 5: d9ccf407 collected ($0.25)
Seat 6: d75a3941 folded before Flop (didn't bet)


Poker Hand #RC3141670333: Hold'em No Limit ($0.05/$0.1) - 2024/12/12 12:46:31
Table 'RushAndCash22315593' 6-max Seat #1 is the button
Seat 1: 3f7822ab ($20 in chips)
Seat 2: 6c4ba3fb ($8.8 in chips)
Seat 3: e3914f0b ($25.81 in chips)
Seat 4: 558d330b ($10 in chips)
Seat 5: b2132e5f ($10 in chips)
Seat 6: Hero ($11.24 in chips)
6c4ba3fb: posts small blind $0.05
e3914f0b: posts big blind $0.1
*** HOLE CARDS ***
Dealt to 3f7822ab 
Dealt to 6c4ba3fb 
Dealt to e3914f0b 
Dealt to 558d330b 
Dealt to b2132e5f 
Dealt to Hero [8s 9d]
558d330b: folds
b2132e5f: folds
Hero: folds
3f7822ab: raises $0.12 to $0.22
6c4ba3fb: folds
e3914f0b: calls $0.12
*** FLOP *** [4h Ks Jh]
e3914f0b: checks
3f7822ab: checks
*** TURN *** [4h Ks Jh] [7c]
e3914f0b: bets $0.25
3f7822ab: folds
Uncalled bet ($0.25) returned to e3914f0b
*** SHOWDOWN ***
e3914f0b collected $0.47 from pot
*** SUMMARY ***
Total pot $0.49 | Rake $0.02 | Jackpot $0 | Bingo $0 | Fortune $0 | Tax $0
Board [4h Ks Jh 7c]
Seat 1: 3f7822ab (button) folded on the Turn
Seat 2: 6c4ba3fb (small blind) folded before Flop
Seat 3: e3914f0b (big blind) won ($0.47)
Seat 4: 558d330b folded before Flop (didn't bet)
Seat 5: b2132e5f folded before Flop (didn't bet)
Seat 6: Hero folded before Flop (didn't bet)


Poker Hand #RC3141670292: Hold'em No Limit ($0.05/$0.1) - 2024/12/12 12:46:19
Table 'RushAndCash22315552' 6-max Seat #1 is the button
Seat 1: Hero ($11.24 in chips)
Seat 2: a3382d82 ($22.36 in chips)
Seat 3: 80ebdd41 ($11.8 in chips)
Seat 4: 8e0a697 ($11.31 in chips)
Seat 5: b9463896 ($10.6 in chips)
Seat 6: 2fb13304 ($10 in chips)
a3382d82: posts small blind $0.05
80ebdd41: posts big blind $0.1
*** HOLE CARDS ***
Dealt to Hero [7d Ad]
Dealt to a3382d82 
Dealt to 80ebdd41 
Dealt to 8e0a697 
Dealt to b9463896 
Dealt to 2fb13304 
8e0a697: raises $0.1 to $0.2
b9463896: folds
2fb13304: folds
Hero: folds
a3382d82: folds
80ebdd41: folds
Uncalled bet ($0.1) returned to 8e0a697
*** SHOWDOWN ***
8e0a697 collected $0.25 from pot
*** SUMMARY ***
Total pot $0.25 | Rake $0 | Jackpot $0 | Bingo $0 | Fortune $0 | Tax $0
Seat 1: Hero (button) folded before Flop (didn't bet)
Seat 2: a3382d82 (small blind) folded before Flop
Seat 3: 80ebdd41 (big blind) folded before Flop
Seat 4: 8e0a697 collected ($0.25)
Seat 5: b9463896 folded before Flop (didn't bet)
Seat 6: 2fb13304 folded before Flop (didn't bet)


Poker Hand #RC3141670277: Hold'em No Limit ($0.05/$0.1) - 2024/12/12 12:46:14
Table 'RushAndCash22315537' 6-max Seat #1 is the button
Seat 1: f209060b ($10.22 in chips)
Seat 2: Hero ($11.29 in chips)
Seat 3: c5141ec9 ($10.58 in chips)
Seat 4: 40c5a5bd ($10 in chips)
Seat 5: 8ebad06f ($15.06 in chips)
Seat 6: f4a0e033 ($10.25 in chips)
Hero: posts small blind $0.05
c5141ec9: posts big blind $0.1
*** HOLE CARDS ***
Dealt to f209060b 
Dealt to Hero [2d 8c]
Dealt to c5141ec9 
Dealt to 40c5a5bd 
Dealt to 8ebad06f 
Dealt to f4a0e033 
40c5a5bd: folds
8ebad06f: folds
f4a0e033: raises $0.1 to $0.2
f209060b: folds
Hero: folds
c5141ec9: folds
Uncalled bet ($0.1) returned to f4a0e033
*** SHOWDOWN ***
f4a0e033 collected $0.25 from pot
*** SUMMARY ***
Total pot $0.25 | Rake $0 | Jackpot $0 | Bingo $0 | Fortune $0 | Tax $0
Seat 1: f209060b (button) folded before Flop (didn't bet)
Seat 2: Hero (small blind) folded before Flop
Seat 3: c5141ec9 (big blind) folded before Flop
Seat 4: 40c5a5bd folded before Flop (didn't bet)
Seat 5: 8ebad06f folded before Flop (didn't bet)
Seat 6: f4a0e033 collected ($0.25)


Poker Hand #RC3141670254: Hold'em No Limit ($0.05/$0.1) - 2024/12/12 12:46:08
Table 'RushAndCash22315514' 6-max Seat #1 is the button
Seat 1: 727f0a35 ($10 in chips)
Seat 2: e18303a2 ($13.56 in chips)
Seat 3: Hero ($11.39 in chips)
Seat 4: b37e3efe ($14.06 in chips)
Seat 5: fc90d2af ($9.96 in chips)
Seat 6: edb28086 ($12.41 in chips)
e18303a2: posts small blind $0.05
Hero: posts big blind $0.1
*** HOLE CARDS ***
Dealt to 727f0a35 
Dealt to e18303a2 
Dealt to Hero [9c 7d]
Dealt to b37e3efe 
Dealt to fc90d2af 
Dealt to edb28086 
b37e3efe: folds
fc90d2af: folds
edb28086: folds
727f0a35: raises $0.2 to $0.3
e18303a2: folds
Hero: folds
Uncalled bet ($0.2) returned to 727f0a35
*** SHOWDOWN ***
727f0a35 collected $0.25 from pot
*** SUMMARY ***
Total pot $0.25 | Rake $0 | Jackpot $0 | Bingo $0 | Fortune $0 | Tax $0
Seat 1: 727f0a35 (button) collected ($0.25)
Seat 2: e18303a2 (small blind) folded before Flop
Seat 3: Hero (big blind) folded before Flop
Seat 4: b37e3efe folded before Flop (didn't bet)
Seat 5: fc90d2af folded before Flop (didn't bet)
Seat 6: edb28086 folded before Flop (didn't bet)


Poker Hand #RC3141670237: Hold'em No Limit ($0.05/$0.1) - 2024/12/12 12:46:04
Table 'RushAndCash22315497' 6-max Seat #1 is the button
Seat 1: bc092e13 ($8.78 in chips)
Seat 2: 6d89c9cc ($12.07 in chips)
Seat 3: c92ccc19 ($7.48 in chips)
Seat 4: 73e84fa ($26.58 in chips)
Seat 5: Hero ($11.39 in chips)
Seat 6: 1e25b5bb ($14.89 in chips)
6d89c9cc: posts small blind $0.05
c92ccc19: posts big blind $0.1
*** HOLE CARDS ***
Dealt to bc092e13 
Dealt to 6d89c9cc 
Dealt to c92ccc19 
Dealt to 73e84fa 
Dealt to Hero [4h Ad]
Dealt to 1e25b5bb 
73e84fa: folds
Hero: folds
1e25b5bb: raises $0.1 to $0.2
bc092e13: folds
6d89c9cc: folds
c92ccc19: calls $0.1
*** FLOP *** [6s 8s 6d]
c92ccc19: checks
1e25b5bb: bets $0.34
c92ccc19: folds
Uncalled bet ($0.34) returned to 1e25b5bb
*** SHOWDOWN ***
1e25b5bb collected $0.43 from pot
*** SUMMARY ***
Total pot $0.45 | Rake $0.02 | Jackpot $0 | Bingo $0 | Fortune $0 | Tax $0
Board [6s 8s 6d]
Seat 1: bc092e13 (button) folded before Flop (didn't bet)
Seat 2: 6d89c9cc (small blind) folded before Flop
Seat 3: c92ccc19 (big blind) folded on the Flop
Seat 4: 73e84fa folded before Flop (didn't bet)
Seat 5: Hero folded before Flop (didn't bet)
Seat 6: 1e25b5bb won ($0.43)


Poker Hand #RC3141670224: Hold'em No Limit ($0.05/$0.1) - 2024/12/12 12:46:00
Table 'RushAndCash22315484' 6-max Seat #1 is the button
Seat 1: 4f76bae1 ($10 in chips)
Seat 2: af208717 ($13.03 in chips)
Seat 3: 218d031b ($8.9 in chips)
Seat 4: 4bddf600 ($9.46 in chips)
Seat 5: Hero ($11.39 in chips)
Seat 6: 9c716b19 ($25.41 in chips)
af208717: posts small blind $0.05
218d031b: posts big blind $0.1
*** HOLE CARDS ***
Dealt to 4f76bae1 
Dealt to af208717 
Dealt to 218d031b 
Dealt to 4bddf600 
Dealt to Hero [6s Jh]
Dealt to 9c716b19 
4bddf600: raises $0.12 to $0.22
Hero: folds
9c716b19: folds
4f76bae1: folds
af208717: folds
218d031b: raises $0.42 to $0.64
4bddf600: calls $0.42
*** FLOP *** [5h 5d Qd]
218d031b: bets $0.56
4bddf600: calls $0.56
*** TURN *** [5h 5d Qd] [Jd]
218d031b: checks
4bddf600: checks
*** RIVER *** [5h 5d Qd Jd] [Td]
218d031b: checks
4bddf600: checks
218d031b: shows [Qc Ah] (Pair of Queens and Pair of Fives)
4bddf600: shows [3d 3c] (Queen High Flush)
*** SHOWDOWN ***
4bddf600 collected $2.33 from pot
*** SUMMARY ***
Total pot $2.45 | Rake $0.12 | Jackpot $0 | Bingo $0 | Fortune $0 | Tax $0
Board [5h 5d Qd Jd Td]
Seat 1: 4f76bae1 (button) folded before Flop (didn't bet)
Seat 2: af208717 (small blind) folded before Flop
Seat 3: 218d031b (big blind) showed [Qc Ah] and lost with Pair of Queens and Pair of Fives
Seat 4: 4bddf600 showed [3d 3c] and won ($2.33) with Queen High Flush
Seat 5: Hero folded before Flop (didn't bet)
Seat 6: 9c716b19 folded before Flop (didn't bet)


Poker Hand #RC3141670148: Hold'em No Limit ($0.05/$0.1) - 2024/12/12 12:45:40
Table 'RushAndCash22315408' 6-max Seat #1 is the button
Seat 1: ee992e7e ($10 in chips)
Seat 2: f0c37558 ($15.36 in chips)
Seat 3: 9dd125fd ($25.18 in chips)
Seat 4: Hero ($11.24 in chips)
Seat 5: 481b7ef8 ($10 in chips)
Seat 6: e4fc8b12 ($12.22 in chips)
f0c37558: posts small blind $0.05
9dd125fd: posts big blind $0.1
*** HOLE CARDS ***
Dealt to ee992e7e 
Dealt to f0c37558 
Dealt to 9dd125fd 
Dealt to Hero [Kd Ac]
Dealt to 481b7ef8 
Dealt to e4fc8b12 
Hero: raises $0.1 to $0.2
481b7ef8: folds
e4fc8b12: folds
ee992e7e: folds
f0c37558: folds
9dd125fd: folds
Uncalled bet ($0.1) returned to Hero
*** SHOWDOWN ***
Hero collected $0.25 from pot
*** SUMMARY ***
Total pot $0.25 | Rake $0 | Jackpot $0 | Bingo $0 | Fortune $0 | Tax $0
Seat 1: ee992e7e (button) folded before Flop (didn't bet)
Seat 2: f0c37558 (small blind) folded before Flop
Seat 3: 9dd125fd (big blind) folded before Flop
Seat 4: Hero collected ($0.25)
Seat 5: 481b7ef8 folded before Flop (didn't bet)
Seat 6: e4fc8b12 folded before Flop (didn't bet)


Poker Hand #RC3141670136: Hold'em No Limit ($0.05/$0.1) - 2024/12/12 12:45:37
Table 'RushAndCash22315396' 6-max Seat #1 is the button
Seat 1: Hero ($11.24 in chips)
Seat 2: cc63da9c ($14.01 in chips)
Seat 3: 2e735933 ($12.28 in chips)
Seat 4: e4fc8b12 ($12.22 in chips)
Seat 5: 1f54611 ($18.4 in chips)
Seat 6: 481b7ef8 ($10 in chips)
cc63da9c: posts small blind $0.05
2e735933: posts big blind $0.1
*** HOLE CARDS ***
Dealt to Hero [8d 2h]
Dealt to cc63da9c 
Dealt to 2e735933 
Dealt to e4fc8b12 
Dealt to 1f54611 
Dealt to 481b7ef8 
e4fc8b12: folds
1f54611: folds
481b7ef8: folds
Hero: folds
cc63da9c: folds
Uncalled bet ($0.05) returned to 2e735933
*** SHOWDOWN ***
2e735933 collected $0.1 from pot
*** SUMMARY ***
Total pot $0.1 | Rake $0 | Jackpot $0 | Bingo $0 | Fortune $0 | Tax $0
Seat 1: Hero (button) folded before Flop (didn't bet)
Seat 2: cc63da9c (small blind) folded before Flop
Seat 3: 2e735933 (big blind) collected ($0.1)
Seat 4: e4fc8b12 folded before Flop (didn't bet)
Seat 5: 1f54611 folded before Flop (didn't bet)
Seat 6: 481b7ef8 folded before Flop (didn't bet)


Poker Hand #RC3141670113: Hold'em No Limit ($0.05/$0.1) - 2024/12/12 12:45:30
Table 'RushAndCash22315373' 6-max Seat #1 is the button
Seat 1: f4a0e033 ($10 in chips)
Seat 2: Hero ($11.29 in chips)
Seat 3: deec756a ($10.15 in chips)
Seat 4: 5d654b2c ($10.99 in chips)
Seat 5: 9c5748d ($20.6 in chips)
Seat 6: 59307d25 ($13.49 in chips)
Hero: posts small blind $0.05
deec756a: posts big blind $0.1
*** HOLE CARDS ***
Dealt to f4a0e033 
Dealt to Hero [6c Qs]
Dealt to deec756a 
Dealt to 5d654b2c 
Dealt to 9c5748d 
Dealt to 59307d25 
5d654b2c: raises $0.1 to $0.2
9c5748d: folds
59307d25: folds
f4a0e033: folds
Hero: folds
deec756a: folds
Uncalled bet ($0.1) returned to 5d654b2c
*** SHOWDOWN ***
5d654b2c collected $0.25 from pot
*** SUMMARY ***
Total pot $0.25 | Rake $0 | Jackpot $0 | Bingo $0 | Fortune $0 | Tax $0
Seat 1: f4a0e033 (button) folded before Flop (didn't bet)
Seat 2: Hero (small blind) folded before Flop
Seat 3: deec756a (big blind) folded before Flop
Seat 4: 5d654b2c collected ($0.25)
Seat 5: 9c5748d folded before Flop (didn't bet)
Seat 6: 59307d25 folded before Flop (didn't bet)


Poker Hand #RC3141670102: Hold'em No Limit ($0.05/$0.1) - 2024/12/12 12:45:26
Table 'RushAndCash22315362' 6-max Seat #1 is the button
Seat 1: e9fe744a ($39.34 in chips)
Seat 2: 671b32fd ($11.67 in chips)
Seat 3: Hero ($11.39 in chips)
Seat 4: 54d53a50 ($18.53 in chips)
Seat 5: b2132e5f ($10 in chips)
Seat 6: a35a0951 ($8.81 in chips)
671b32fd: posts small blind $0.05
Hero: posts big blind $0.1
*** HOLE CARDS ***
Dealt to e9fe744a 
Dealt to 671b32fd 
Dealt to Hero [7d Kc]
Dealt to 54d53a50 
Dealt to b2132e5f 
Dealt to a35a0951 
54d53a50: folds
b2132e5f: folds
a35a0951: folds
e9fe744a: raises $0.1 to $0.2
671b32fd: folds
Hero: folds
Uncalled bet ($0.1) returned to e9fe744a
*** SHOWDOWN ***
e9fe744a collected $0.25 from pot
*** SUMMARY ***
Total pot $0.25 | Rake $0 | Jackpot $0 | Bingo $0 | Fortune $0 | Tax $0
Seat 1: e9fe744a (button) collected ($0.25)
Seat 2: 671b32fd (small blind) folded before Flop
Seat 3: Hero (big blind) folded before Flop
Seat 4: 54d53a50 folded before Flop (didn't bet)
Seat 5: b2132e5f folded before Flop (didn't bet)
Seat 6: a35a0951 folded before Flop (didn't bet)


Poker Hand #RC3141670091: Hold'em No Limit ($0.05/$0.1) - 2024/12/12 12:45:23
Table 'RushAndCash22315351' 6-max Seat #1 is the button
Seat 1: 101c026b ($25.25 in chips)
Seat 2: 17b381d5 ($25.18 in chips)
Seat 3: f5628a04 ($12.37 in chips)
Seat 4: Hero ($11.39 in chips)
Seat 5: 66a73913 ($16.14 in chips)
Seat 6: 3c1b4ee8 ($10.99 in chips)
17b381d5: posts small blind $0.05
f5628a04: posts big blind $0.1
*** HOLE CARDS ***
Dealt to 101c026b 
Dealt to 17b381d5 
Dealt to f5628a04 
Dealt to Hero [Tc 7s]
Dealt to 66a73913 
Dealt to 3c1b4ee8 
Hero: folds
66a73913: folds
3c1b4ee8: folds
101c026b: folds
17b381d5: folds
Uncalled bet ($0.05) returned to f5628a04
*** SHOWDOWN ***
f5628a04 collected $0.1 from pot
*** SUMMARY ***
Total pot $0.1 | Rake $0 | Jackpot $0 | Bingo $0 | Fortune $0 | Tax $0
Seat 1: 101c026b (button) folded before Flop (didn't bet)
Seat 2: 17b381d5 (small blind) folded before Flop
Seat 3: f5628a04 (big blind) collected ($0.1)
Seat 4: Hero folded before Flop (didn't bet)
Seat 5: 66a73913 folded before Flop (didn't bet)
Seat 6: 3c1b4ee8 folded before Flop (didn't bet)


Poker Hand #RC3141670077: Hold'em No Limit ($0.05/$0.1) - 2024/12/12 12:45:19
Table 'RushAndCash22315337' 6-max Seat #1 is the button
Seat 1: 9ef3daf1 ($10 in chips)
Seat 2: d1764387 ($16.55 in chips)
Seat 3: 5304ad76 ($10 in chips)
Seat 4: 101c026b ($25.25 in chips)
Seat 5: 755092ba ($17.77 in chips)
Seat 6: Hero ($11.39 in chips)
d1764387: posts small blind $0.05
5304ad76: posts big blind $0.1
*** HOLE CARDS ***
Dealt to 9ef3daf1 
Dealt to d1764387 
Dealt to 5304ad76 
Dealt to 101c026b 
Dealt to 755092ba 
Dealt to Hero [6c 2s]
101c026b: folds
755092ba: folds
Hero: folds
9ef3daf1: raises $0.1 to $0.2
d1764387: calls $0.15
5304ad76: folds
*** FLOP *** [2d As Ad]
d1764387: checks
9ef3daf1: checks
*** TURN *** [2d As Ad] [Th]
d1764387: checks
9ef3daf1: checks
*** RIVER *** [2d As Ad Th] [6s]
d1764387: bets $0.1
9ef3daf1: calls $0.1
d1764387: shows [6d 7d] (Pair of Aces and Pair of Sixes)
9ef3daf1: shows [3h 2h] (Pair of Aces and Pair of Twos)
*** SHOWDOWN ***
d1764387 collected $0.67 from pot
*** SUMMARY ***
Total pot $0.7 | Rake $0.03 | Jackpot $0 | Bingo $0 | Fortune $0 | Tax $0
Board [2d As Ad Th 6s]
Seat 1: 9ef3daf1 (button) showed [3h 2h] and lost with Pair of Aces and Pair of Twos
Seat 2: d1764387 (small blind) showed [6d 7d] and won ($0.67) with Pair of Aces and Pair of Sixes
Seat 3: 5304ad76 (big blind) folded before Flop
Seat 4: 101c026b folded before Flop (didn't bet)
Seat 5: 755092ba folded before Flop (didn't bet)
Seat 6: Hero folded before Flop (didn't bet)


Poker Hand #RC3141670063: Hold'em No Limit ($0.05/$0.1) - 2024/12/12 12:45:16
Table 'RushAndCash22315323' 6-max Seat #1 is the button
Seat 1: Hero ($11.39 in chips)
Seat 2: f2b49ec ($11.34 in chips)
Seat 3: 3cdac696 ($10.05 in chips)
Seat 4: 2fb13304 ($10 in chips)
Seat 5: b17f5bfe ($5.78 in chips)
Seat 6: 356c8abd ($11.21 in chips)
f2b49ec: posts small blind $0.05
3cdac696: posts big blind $0.1
*** HOLE CARDS ***
Dealt to Hero [5h 2h]
Dealt to f2b49ec 
Dealt to 3cdac696 
Dealt to 2fb13304 
Dealt to b17f5bfe 
Dealt to 356c8abd 
2fb13304: folds
b17f5bfe: folds
356c8abd: folds
Hero: folds
f2b49ec: raises $0.15 to $0.25
3cdac696: folds
Uncalled bet ($0.15) returned to f2b49ec
*** SHOWDOWN ***
f2b49ec collected $0.2 from pot
*** SUMMARY ***
Total pot $0.2 | Rake $0 | Jackpot $0 | Bingo $0 | Fortune $0 | Tax $0
Seat 1: Hero (button) folded before Flop (didn't bet)
Seat 2: f2b49ec (small blind) collected ($0.2)
Seat 3: 3cdac696 (big blind) folded before Flop
Seat 4: 2fb13304 folded before Flop (didn't bet)
Seat 5: b17f5bfe folded before Flop (didn't bet)
Seat 6: 356c8abd folded before Flop (didn't bet)


Poker Hand #RC3141670050: Hold'em No Limit ($0.05/$0.1) - 2024/12/12 12:45:13
Table 'RushAndCash22315310' 6-max Seat #1 is the button
Seat 1: c8eea62e ($7.7 in chips)
Seat 2: 59307d25 ($13.49 in chips)
Seat 3: d19ee248 ($10.15 in chips)
Seat 4: 6053096e ($10.56 in chips)
Seat 5: Hero ($11.39 in chips)
Seat 6: d75a3941 ($10.96 in chips)
59307d25: posts small blind $0.05
d19ee248: posts big blind $0.1
*** HOLE CARDS ***
Dealt to c8eea62e 
Dealt to 59307d25 
Dealt to d19ee248 
Dealt to 6053096e 
Dealt to Hero [Td 3h]
Dealt to d75a3941 
6053096e: raises $0.15 to $0.25
Hero: folds
d75a3941: folds
c8eea62e: raises $0.65 to $0.9
59307d25: folds
d19ee248: folds
6053096e: folds
Uncalled bet ($0.65) returned to c8eea62e
*** SHOWDOWN ***
c8eea62e collected $0.62 from pot
*** SUMMARY ***
Total pot $0.65 | Rake $0.03 | Jackpot $0 | Bingo $0 | Fortune $0 | Tax $0
Seat 1: c8eea62e (button) collected ($0.62)
Seat 2: 59307d25 (small blind) folded before Flop
Seat 3: d19ee248 (big blind) folded before Flop
Seat 4: 6053096e folded before Flop
Seat 5: Hero folded before Flop (didn't bet)
Seat 6: d75a3941 folded before Flop (didn't bet)


Poker Hand #RC3141670001: Hold'em No Limit ($0.05/$0.1) - 2024/12/12 12:45:00
Table 'RushAndCash22315261' 6-max Seat #1 is the button
Seat 1: a1394882 ($13.4 in chips)
Seat 2: e0c4f56b ($5.37 in chips)
Seat 3: Hero ($11.49 in chips)
Seat 4: 77162ce3 ($10 in chips)
Seat 5: 3e399c74 ($10.05 in chips)
Seat 6: e3244dc0 ($12 in chips)
e0c4f56b: posts small blind $0.05
Hero: posts big blind $0.1
*** HOLE CARDS ***
Dealt to a1394882 
Dealt to e0c4f56b 
Dealt to Hero [7d 7c]
Dealt to 77162ce3 
Dealt to 3e399c74 
Dealt to e3244dc0 
77162ce3: folds
3e399c74: raises $0.1 to $0.2
e3244dc0: folds
a1394882: raises $0.42 to $0.62
e0c4f56b: raises $1.16 to $1.78
Hero: folds
3e399c74: folds
a1394882: calls $1.16
*** FLOP *** [7s 8d 9c]
e0c4f56b: bets $3.59 and is all-in
a1394882: calls $3.59
e0c4f56b: shows [Ac As] (Pair of Aces)
a1394882: shows [Qd Qc] (Pair of Queens)
*** TURN *** [7s 8d 9c] [8h]
*** RIVER *** [7s 8d 9c 8h] [2c]
*** SHOWDOWN ***
e0c4f56b collected $10.59 from pot
*** SUMMARY ***
Total pot $11.04 | Rake $0.3 | Jackpot $0.15 | Bingo $0 | Fortune $0 | Tax $0
Board [7s 8d 9c 8h 2c]
Seat 1: a1394882 (button) showed [Qd Qc] and lost with Pair of Queens and Pair of Eights
Seat 2: e0c4f56b (small blind) showed [Ac As] and won ($10.59) with Pair of Aces and Pair of Eights
Seat 3: Hero (big blind) folded before Flop
Seat 4: 77162ce3 folded before Flop (didn't bet)
Seat 5: 3e399c74 folded before Flop
Seat 6: e3244dc0 folded before Flop (didn't bet)


Poker Hand #RC3141669958: Hold'em No Limit ($0.05/$0.1) - 2024/12/12 12:44:49
Table 'RushAndCash22315218' 6-max Seat #1 is the button
Seat 1: 7d40d863 ($4.24 in chips)
Seat 2: Hero ($11.54 in chips)
Seat 3: 218d031b ($10 in chips)
Seat 4: f347a136 ($10.02 in chips)
Seat 5: 24039de0 ($10.97 in chips)
Seat 6: c8e1bfcc ($10.08 in chips)
Hero: posts small blind $0.05
218d031b: posts big blind $0.1
*** HOLE CARDS ***
Dealt to 7d40d863 
Dealt to Hero [5d 7d]
Dealt to 218d031b 
Dealt to f347a136 
Dealt to 24039de0 
Dealt to c8e1bfcc 
f347a136: folds
24039de0: folds
c8e1bfcc: raises $0.1 to $0.2
7d40d863: calls $0.2
Hero: folds
218d031b: folds
*** FLOP *** [Qs 3h 3s]
c8e1bfcc: checks
7d40d863: bets $0.28
c8e1bfcc: calls $0.28
*** TURN *** [Qs 3h 3s] [8c]
c8e1bfcc: checks
7d40d863: checks
*** RIVER *** [Qs 3h 3s 8c] [Jh]
c8e1bfcc: checks
7d40d863: bets $0.56
c8e1bfcc: calls $0.56
7d40d863: shows [Qc 5c] (Pair of Queens and Pair of Treys)
c8e1bfcc: shows [Js 4s] (Pair of Jacks and Pair of Treys)
*** SHOWDOWN ***
7d40d863 collected $2.12 from pot
*** SUMMARY ***
Total pot $2.23 | Rake $0.11 | Jackpot $0 | Bingo $0 | Fortune $0 | Tax $0
Board [Qs 3h 3s 8c Jh]
Seat 1: 7d40d863 (button) showed [Qc 5c] and won ($2.12) with Pair of Queens and Pair of Treys
Seat 2: Hero (small blind) folded before Flop
Seat 3: 218d031b (big blind) folded before Flop
Seat 4: f347a136 folded before Flop (didn't bet)
Seat 5: 24039de0 folded before Flop (didn't bet)
Seat 6: c8e1bfcc showed [Js 4s] and lost with Pair of Jacks and Pair of Treys


Poker Hand #RC3141669944: Hold'em No Limit ($0.05/$0.1) - 2024/12/12 12:44:46
Table 'RushAndCash22315204' 6-max Seat #1 is the button
Seat 1: dbcd9107 ($17.04 in chips)
Seat 2: bf0e2e95 ($11.14 in chips)
Seat 3: 895d916a ($37.34 in chips)
Seat 4: ae47099b ($18.13 in chips)
Seat 5: Hero ($11.54 in chips)
Seat 6: e0c4f56b ($5.47 in chips)
bf0e2e95: posts small blind $0.05
895d916a: posts big blind $0.1
*** HOLE CARDS ***
Dealt to dbcd9107 
Dealt to bf0e2e95 
Dealt to 895d916a 
Dealt to ae47099b 
Dealt to Hero [5h 8s]
Dealt to e0c4f56b 
ae47099b: raises $0.12 to $0.22
Hero: folds
e0c4f56b: folds
dbcd9107: raises $0.45 to $0.67
bf0e2e95: folds
895d916a: folds
ae47099b: calls $0.45
*** FLOP *** [Td Jc 9s]
ae47099b: checks
dbcd9107: checks
*** TURN *** [Td Jc 9s] [Th]
ae47099b: checks
dbcd9107: checks
*** RIVER *** [Td Jc 9s Th] [4s]
ae47099b: checks
dbcd9107: checks
ae47099b: shows [2d Ad] (Pair of Tens)
dbcd9107: shows [Ks Ac] (Pair of Tens)
*** SHOWDOWN ***
dbcd9107 collected $1.42 from pot
*** SUMMARY ***
Total pot $1.49 | Rake $0.07 | Jackpot $0 | Bingo $0 | Fortune $0 | Tax $0
Board [Td Jc 9s Th 4s]
Seat 1: dbcd9107 (button) showed [Ks Ac] and won ($1.42) with Pair of Tens
Seat 2: bf0e2e95 (small blind) folded before Flop
Seat 3: 895d916a (big blind) folded before Flop
Seat 4: ae47099b showed [2d Ad] and lost with Pair of Tens
Seat 5: Hero folded before Flop (didn't bet)
Seat 6: e0c4f56b folded before Flop (didn't bet)


Poker Hand #RC3141669929: Hold'em No Limit ($0.05/$0.1) - 2024/12/12 12:44:42
Table 'RushAndCash22315189' 6-max Seat #1 is the button
Seat 1: e12528c0 ($33.44 in chips)
Seat 2: 1d2dacdf ($10 in chips)
Seat 3: 5d654b2c ($11.39 in chips)
Seat 4: Hero ($11.54 in chips)
Seat 5: dbcd9107 ($16.89 in chips)
Seat 6: be2bfc8f ($10 in chips)
1d2dacdf: posts small blind $0.05
5d654b2c: posts big blind $0.1
*** HOLE CARDS ***
Dealt to e12528c0 
Dealt to 1d2dacdf 
Dealt to 5d654b2c 
Dealt to Hero [Js 7c]
Dealt to dbcd9107 
Dealt to be2bfc8f 
Hero: folds
dbcd9107: folds
be2bfc8f: folds
e12528c0: raises $0.1 to $0.2
1d2dacdf: folds
5d654b2c: folds
Uncalled bet ($0.1) returned to e12528c0
*** SHOWDOWN ***
e12528c0 collected $0.25 from pot
*** SUMMARY ***
Total pot $0.25 | Rake $0 | Jackpot $0 | Bingo $0 | Fortune $0 | Tax $0
Seat 1: e12528c0 (button) collected ($0.25)
Seat 2: 1d2dacdf (small blind) folded before Flop
Seat 3: 5d654b2c (big blind) folded before Flop
Seat 4: Hero folded before Flop (didn't bet)
Seat 5: dbcd9107 folded before Flop (didn't bet)
Seat 6: be2bfc8f folded before Flop (didn't bet)


Poker Hand #RC3141669915: Hold'em No Limit ($0.05/$0.1) - 2024/12/12 12:44:39
Table 'RushAndCash22315175' 6-max Seat #1 is the button
Seat 1: Hero ($11.54 in chips)
Seat 2: 84c34548 ($10.42 in chips)
Seat 3: dbcd9107 ($16.99 in chips)
Seat 4: 5c3b7f20 ($10.33 in chips)
Seat 5: 204f692c ($10 in chips)
Seat 6: e0a6d1b8 ($10.63 in chips)
84c34548: posts small blind $0.05
dbcd9107: posts big blind $0.1
*** HOLE CARDS ***
Dealt to Hero [3s Qc]
Dealt to 84c34548 
Dealt to dbcd9107 
Dealt to 5c3b7f20 
Dealt to 204f692c 
Dealt to e0a6d1b8 
5c3b7f20: folds
204f692c: folds
e0a6d1b8: folds
Hero: folds
84c34548: folds
Uncalled bet ($0.05) returned to dbcd9107
*** SHOWDOWN ***
dbcd9107 collected $0.1 from pot
*** SUMMARY ***
Total pot $0.1 | Rake $0 | Jackpot $0 | Bingo $0 | Fortune $0 | Tax $0
Seat 1: Hero (button) folded before Flop (didn't bet)
Seat 2: 84c34548 (small blind) folded before Flop
Seat 3: dbcd9107 (big blind) collected ($0.1)
Seat 4: 5c3b7f20 folded before Flop (didn't bet)
Seat 5: 204f692c folded before Flop (didn't bet)
Seat 6: e0a6d1b8 folded before Flop (didn't bet)


Poker Hand #RC3141669899: Hold'em No Limit ($0.05/$0.1) - 2024/12/12 12:44:36
Table 'RushAndCash22315159' 6-max Seat #1 is the button
Seat 1: 5c1d4f73 ($10 in chips)
Seat 2: ce846db ($11.48 in chips)
Seat 3: 2a6446ed ($16.12 in chips)
Seat 4: 66793bbe ($6.07 in chips)
Seat 5: 2746c1f0 ($10.31 in chips)
Seat 6: Hero ($11.54 in chips)
ce846db: posts small blind $0.05
2a6446ed: posts big blind $0.1
*** HOLE CARDS ***
Dealt to 5c1d4f73 
Dealt to ce846db 
Dealt to 2a6446ed 
Dealt to 66793bbe 
Dealt to 2746c1f0 
Dealt to Hero [7h 9s]
66793bbe: folds
2746c1f0: raises $0.12 to $0.22
Hero: folds
5c1d4f73: folds
ce846db: folds
2a6446ed: folds
Uncalled bet ($0.12) returned to 2746c1f0
*** SHOWDOWN ***
2746c1f0 collected $0.25 from pot
*** SUMMARY ***
Total pot $0.25 | Rake $0 | Jackpot $0 | Bingo $0 | Fortune $0 | Tax $0
Seat 1: 5c1d4f73 (button) folded before Flop (didn't bet)
Seat 2: ce846db (small blind) folded before Flop
Seat 3: 2a6446ed (big blind) folded before Flop
Seat 4: 66793bbe folded before Flop (didn't bet)
Seat 5: 2746c1f0 collected ($0.25)
Seat 6: Hero folded before Flop (didn't bet)


Poker Hand #RC3141669885: Hold'em No Limit ($0.05/$0.1) - 2024/12/12 12:44:32
Table 'RushAndCash22315145' 6-max Seat #1 is the button
Seat 1: cacc74b2 ($10.51 in chips)
Seat 2: Hero ($11.59 in chips)
Seat 3: cc63da9c ($14.36 in chips)
Seat 4: 1039fde1 ($12.77 in chips)
Seat 5: 6c4ba3fb ($8.78 in chips)
Seat 6: ff98cbcb ($26.68 in chips)
Hero: posts small blind $0.05
cc63da9c: posts big blind $0.1
*** HOLE CARDS ***
Dealt to cacc74b2 
Dealt to Hero [7h 6c]
Dealt to cc63da9c 
Dealt to 1039fde1 
Dealt to 6c4ba3fb 
Dealt to ff98cbcb 
1039fde1: folds
6c4ba3fb: raises $0.2 to $0.3
ff98cbcb: folds
cacc74b2: folds
Hero: folds
cc63da9c: calls $0.2
*** FLOP *** [Jc 9c Kh]
cc63da9c: checks
6c4ba3fb: bets $0.33
cc63da9c: folds
Uncalled bet ($0.33) returned to 6c4ba3fb
*** SHOWDOWN ***
6c4ba3fb collected $0.62 from pot
*** SUMMARY ***
Total pot $0.65 | Rake $0.03 | Jackpot $0 | Bingo $0 | Fortune $0 | Tax $0
Board [Jc 9c Kh]
Seat 1: cacc74b2 (button) folded before Flop (didn't bet)
Seat 2: Hero (small blind) folded before Flop
Seat 3: cc63da9c (big blind) folded on the Flop
Seat 4: 1039fde1 folded before Flop (didn't bet)
Seat 5: 6c4ba3fb won ($0.62)
Seat 6: ff98cbcb folded before Flop (didn't bet)


Poker Hand #RC3141669666: Hold'em No Limit ($0.05/$0.1) - 2024/12/12 12:43:42
Table 'RushAndCash22314926' 6-max Seat #1 is the button
Seat 1: 418b0280 ($11.81 in chips)
Seat 2: a6717311 ($20.22 in chips)
Seat 3: Hero ($10.58 in chips)
Seat 4: 23d20ac6 ($16.81 in chips)
Seat 5: cc63da9c ($15.43 in chips)
Seat 6: d6b17ac7 ($12.13 in chips)
a6717311: posts small blind $0.05
Hero: posts big blind $0.1
*** HOLE CARDS ***
Dealt to 418b0280 
Dealt to a6717311 
Dealt to Hero [Jd Kd]
Dealt to 23d20ac6 
Dealt to cc63da9c 
Dealt to d6b17ac7 
23d20ac6: folds
cc63da9c: raises $0.1 to $0.2
d6b17ac7: folds
418b0280: folds
a6717311: folds
Hero: calls $0.1
*** FLOP *** [Qd 5c Kh]
Hero: checks
cc63da9c: bets $0.27
Hero: calls $0.27
*** TURN *** [Qd 5c Kh] [8d]
Hero: checks
cc63da9c: bets $0.6
Hero: calls $0.6
*** RIVER *** [Qd 5c Kh 8d] [3s]
Hero: checks
cc63da9c: checks
Hero: shows [Jd Kd] (Pair of Kings)
cc63da9c: shows [3c Ac] (Pair of Treys)
*** SHOWDOWN ***
Hero collected $2.08 from pot
*** SUMMARY ***
Total pot $2.19 | Rake $0.11 | Jackpot $0 | Bingo $0 | Fortune $0 | Tax $0
Board [Qd 5c Kh 8d 3s]
Seat 1: 418b0280 (button) folded before Flop (didn't bet)
Seat 2: a6717311 (small blind) folded before Flop
Seat 3: Hero (big blind) showed [Jd Kd] and won ($2.08) with Pair of Kings
Seat 4: 23d20ac6 folded before Flop (didn't bet)
Seat 5: cc63da9c showed [3c Ac] and lost with Pair of Treys
Seat 6: d6b17ac7 folded before Flop (didn't bet)


Poker Hand #RC3141669651: Hold'em No Limit ($0.05/$0.1) - 2024/12/12 12:43:39
Table 'RushAndCash22314911' 6-max Seat #1 is the button
Seat 1: 25c1f7d7 ($10 in chips)
Seat 2: 7ee23c5e ($12.36 in chips)
Seat 3: cc8462b1 ($13.06 in chips)
Seat 4: Hero ($10.58 in chips)
Seat 5: d6b17ac7 ($12.13 in chips)
Seat 6: cc63da9c ($15.43 in chips)
7ee23c5e: posts small blind $0.05
cc8462b1: posts big blind $0.1
*** HOLE CARDS ***
Dealt to 25c1f7d7 
Dealt to 7ee23c5e 
Dealt to cc8462b1 
Dealt to Hero [5h Qd]
Dealt to d6b17ac7 
Dealt to cc63da9c 
Hero: folds
d6b17ac7: folds
cc63da9c: folds
25c1f7d7: folds
7ee23c5e: folds
Uncalled bet ($0.05) returned to cc8462b1
*** SHOWDOWN ***
cc8462b1 collected $0.1 from pot
*** SUMMARY ***
Total pot $0.1 | Rake $0 | Jackpot $0 | Bingo $0 | Fortune $0 | Tax $0
Seat 1: 25c1f7d7 (button) folded before Flop (didn't bet)
Seat 2: 7ee23c5e (small blind) folded before Flop
Seat 3: cc8462b1 (big blind) collected ($0.1)
Seat 4: Hero folded before Flop (didn't bet)
Seat 5: d6b17ac7 folded before Flop (didn't bet)
Seat 6: cc63da9c folded before Flop (didn't bet)


Poker Hand #RC3141669629: Hold'em No Limit ($0.05/$0.1) - 2024/12/12 12:43:33
Table 'RushAndCash22314889' 6-max Seat #1 is the button
Seat 1: 579e0b5 ($11.18 in chips)
Seat 2: b1f396f4 ($29.19 in chips)
Seat 3: 4f76bae1 ($10.1 in chips)
Seat 4: Hero ($10.58 in chips)
Seat 5: 5ab2e15d ($10.33 in chips)
Seat 6: 3e399c74 ($10.15 in chips)
b1f396f4: posts small blind $0.05
4f76bae1: posts big blind $0.1
*** HOLE CARDS ***
Dealt to 579e0b5 
Dealt to b1f396f4 
Dealt to 4f76bae1 
Dealt to Hero [Jh Qd]
Dealt to 5ab2e15d 
Dealt to 3e399c74 
Hero: folds
5ab2e15d: raises $0.1 to $0.2
3e399c74: folds
579e0b5: folds
b1f396f4: folds
4f76bae1: calls $0.1
*** FLOP *** [7c As Js]
4f76bae1: checks
5ab2e15d: bets $0.15
4f76bae1: calls $0.15
*** TURN *** [7c As Js] [7h]
4f76bae1: bets $0.19
5ab2e15d: calls $0.19
*** RIVER *** [7c As Js 7h] [Qs]
4f76bae1: bets $0.95
5ab2e15d: folds
Uncalled bet ($0.95) returned to 4f76bae1
*** SHOWDOWN ***
4f76bae1 collected $1.08 from pot
*** SUMMARY ***
Total pot $1.13 | Rake $0.05 | Jackpot $0 | Bingo $0 | Fortune $0 | Tax $0
Board [7c As Js 7h Qs]
Seat 1: 579e0b5 (button) folded before Flop (didn't bet)
Seat 2: b1f396f4 (small blind) folded before Flop
Seat 3: 4f76bae1 (big blind) won ($1.08)
Seat 4: Hero folded before Flop (didn't bet)
Seat 5: 5ab2e15d folded on the River
Seat 6: 3e399c74 folded before Flop (didn't bet)


Poker Hand #RC3141669533: Hold'em No Limit ($0.05/$0.1) - 2024/12/12 12:43:12
Table 'RushAndCash22314793' 6-max Seat #1 is the button
Seat 1: Hero ($10.3 in chips)
Seat 2: 5c1d4f73 ($11.25 in chips)
Seat 3: ee992e7e ($10.05 in chips)
Seat 4: 4b728c96 ($13.12 in chips)
Seat 5: c199627b ($12.13 in chips)
Seat 6: 95e11761 ($8.7 in chips)
5c1d4f73: posts small blind $0.05
ee992e7e: posts big blind $0.1
*** HOLE CARDS ***
Dealt to Hero [Jd Jh]
Dealt to 5c1d4f73 
Dealt to ee992e7e 
Dealt to 4b728c96 
Dealt to c199627b 
Dealt to 95e11761 
4b728c96: folds
c199627b: folds
95e11761: folds
Hero: raises $0.15 to $0.25
5c1d4f73: folds
ee992e7e: calls $0.15
*** FLOP *** [3h 6d Qh]
ee992e7e: checks
Hero: bets $0.19
ee992e7e: folds
Uncalled bet ($0.19) returned to Hero
*** SHOWDOWN ***
Hero collected $0.53 from pot
*** SUMMARY ***
Total pot $0.55 | Rake $0.02 | Jackpot $0 | Bingo $0 | Fortune $0 | Tax $0
Board [3h 6d Qh]
Seat 1: Hero (button) won ($0.53)
Seat 2: 5c1d4f73 (small blind) folded before Flop
Seat 3: ee992e7e (big blind) folded on the Flop
Seat 4: 4b728c96 folded before Flop (didn't bet)
Seat 5: c199627b folded before Flop (didn't bet)
Seat 6: 95e11761 folded before Flop (didn't bet)


Poker Hand #RC3141669515: Hold'em No Limit ($0.05/$0.1) - 2024/12/12 12:43:07
Table 'RushAndCash22314775' 6-max Seat #1 is the button
Seat 1: 6a806110 ($10 in chips)
Seat 2: 3c75bc00 ($33.29 in chips)
Seat 3: 38fd477d ($10.12 in chips)
Seat 4: 745c6911 ($10 in chips)
Seat 5: 1fe7df8c ($13.5 in chips)
Seat 6: Hero ($10.3 in chips)
3c75bc00: posts small blind $0.05
38fd477d: posts big blind $0.1
*** HOLE CARDS ***
Dealt to 6a806110 
Dealt to 3c75bc00 
Dealt to 38fd477d 
Dealt to 745c6911 
Dealt to 1fe7df8c 
Dealt to Hero [2s Kh]
745c6911: folds
1fe7df8c: raises $0.1 to $0.2
Hero: folds
6a806110: folds
3c75bc00: folds
38fd477d: folds
Uncalled bet ($0.1) returned to 1fe7df8c
*** SHOWDOWN ***
1fe7df8c collected $0.25 from pot
*** SUMMARY ***
Total pot $0.25 | Rake $0 | Jackpot $0 | Bingo $0 | Fortune $0 | Tax $0
Seat 1: 6a806110 (button) folded before Flop (didn't bet)
Seat 2: 3c75bc00 (small blind) folded before Flop
Seat 3: 38fd477d (big blind) folded before Flop
Seat 4: 745c6911 folded before Flop (didn't bet)
Seat 5: 1fe7df8c collected ($0.25)
Seat 6: Hero folded before Flop (didn't bet)


Poker Hand #RC3141669500: Hold'em No Limit ($0.05/$0.1) - 2024/12/12 12:43:04
Table 'RushAndCash22314760' 6-max Seat #1 is the button
Seat 1: 643f85e7 ($9.99 in chips)
Seat 2: Hero ($10.35 in chips)
Seat 3: ee992e7e ($10 in chips)
Seat 4: a0bab1fa ($10.28 in chips)
Seat 5: 1ecd1474 ($10 in chips)
Seat 6: e0a6d1b8 ($10.15 in chips)
Hero: posts small blind $0.05
ee992e7e: posts big blind $0.1
*** HOLE CARDS ***
Dealt to 643f85e7 
Dealt to Hero [4s Qc]
Dealt to ee992e7e 
Dealt to a0bab1fa 
Dealt to 1ecd1474 
Dealt to e0a6d1b8 
a0bab1fa: folds
1ecd1474: folds
e0a6d1b8: folds
643f85e7: folds
Hero: folds
Uncalled bet ($0.05) returned to ee992e7e
*** SHOWDOWN ***
ee992e7e collected $0.1 from pot
*** SUMMARY ***
Total pot $0.1 | Rake $0 | Jackpot $0 | Bingo $0 | Fortune $0 | Tax $0
Seat 1: 643f85e7 (button) folded before Flop (didn't bet)
Seat 2: Hero (small blind) folded before Flop
Seat 3: ee992e7e (big blind) collected ($0.1)
Seat 4: a0bab1fa folded before Flop (didn't bet)
Seat 5: 1ecd1474 folded before Flop (didn't bet)
Seat 6: e0a6d1b8 folded before Flop (didn't bet)


Poker Hand #RC3141669460: Hold'em No Limit ($0.05/$0.1) - 2024/12/12 12:42:55
Table 'RushAndCash22314720' 6-max Seat #1 is the button
Seat 1: 1a8ef95a ($15.62 in chips)
Seat 2: c8091e03 ($10.05 in chips)
Seat 3: Hero ($10.45 in chips)
Seat 4: c3bbb0e7 ($11.6 in chips)
Seat 5: c92ccc19 ($6.84 in chips)
Seat 6: 8cfa2620 ($19.73 in chips)
c8091e03: posts small blind $0.05
Hero: posts big blind $0.1
*** HOLE CARDS ***
Dealt to 1a8ef95a 
Dealt to c8091e03 
Dealt to Hero [Qh Tc]
Dealt to c3bbb0e7 
Dealt to c92ccc19 
Dealt to 8cfa2620 
c3bbb0e7: raises $0.1 to $0.2
c92ccc19: calls $0.2
8cfa2620: folds
1a8ef95a: folds
c8091e03: folds
Hero: folds
*** FLOP *** [8d Ts 2s]
c3bbb0e7: checks
c92ccc19: checks
*** TURN *** [8d Ts 2s] [8c]
c3bbb0e7: bets $0.42
c92ccc19: folds
Uncalled bet ($0.42) returned to c3bbb0e7
*** SHOWDOWN ***
c3bbb0e7 collected $0.53 from pot
*** SUMMARY ***
Total pot $0.55 | Rake $0.02 | Jackpot $0 | Bingo $0 | Fortune $0 | Tax $0
Board [8d Ts 2s 8c]
Seat 1: 1a8ef95a (button) folded before Flop (didn't bet)
Seat 2: c8091e03 (small blind) folded before Flop
Seat 3: Hero (big blind) folded before Flop
Seat 4: c3bbb0e7 won ($0.53)
Seat 5: c92ccc19 folded on the Turn
Seat 6: 8cfa2620 folded before Flop (didn't bet)


Poker Hand #RC3141669445: Hold'em No Limit ($0.05/$0.1) - 2024/12/12 12:42:51
Table 'RushAndCash22314705' 6-max Seat #1 is the button
Seat 1: 24c2159e ($11.72 in chips)
Seat 2: 4684e24a ($26.97 in chips)
Seat 3: b8e03e64 ($10 in chips)
Seat 4: Hero ($10.45 in chips)
Seat 5: 12b883d0 ($28.24 in chips)
Seat 6: c92ccc19 ($6.84 in chips)
4684e24a: posts small blind $0.05
b8e03e64: posts big blind $0.1
*** HOLE CARDS ***
Dealt to 24c2159e 
Dealt to 4684e24a 
Dealt to b8e03e64 
Dealt to Hero [5c 3c]
Dealt to 12b883d0 
Dealt to c92ccc19 
Hero: folds
12b883d0: folds
c92ccc19: folds
24c2159e: raises $0.14 to $0.24
4684e24a: folds
b8e03e64: folds
Uncalled bet ($0.14) returned to 24c2159e
*** SHOWDOWN ***
24c2159e collected $0.25 from pot
*** SUMMARY ***
Total pot $0.25 | Rake $0 | Jackpot $0 | Bingo $0 | Fortune $0 | Tax $0
Seat 1: 24c2159e (button) collected ($0.25)
Seat 2: 4684e24a (small blind) folded before Flop
Seat 3: b8e03e64 (big blind) folded before Flop
Seat 4: Hero folded before Flop (didn't bet)
Seat 5: 12b883d0 folded before Flop (didn't bet)
Seat 6: c92ccc19 folded before Flop (didn't bet)


Poker Hand #RC3141669365: Hold'em No Limit ($0.05/$0.1) - 2024/12/12 12:42:31
Table 'RushAndCash22314625' 6-max Seat #1 is the button
Seat 1: 1f54611 ($16.01 in chips)
Seat 2: b37e3efe ($15.14 in chips)
Seat 3: 4684e24a ($26.6 in chips)
Seat 4: Hero ($10.65 in chips)
Seat 5: 9ef3daf1 ($10 in chips)
Seat 6: c3bbb0e7 ($11.8 in chips)
b37e3efe: posts small blind $0.05
4684e24a: posts big blind $0.1
*** HOLE CARDS ***
Dealt to 1f54611 
Dealt to b37e3efe 
Dealt to 4684e24a 
Dealt to Hero [Kd Jh]
Dealt to 9ef3daf1 
Dealt to c3bbb0e7 
Hero: raises $0.1 to $0.2
9ef3daf1: folds
c3bbb0e7: folds
1f54611: folds
b37e3efe: calls $0.15
4684e24a: raises $0.8 to $1
Hero: folds
b37e3efe: folds
Uncalled bet ($0.8) returned to 4684e24a
*** SHOWDOWN ***
4684e24a collected $0.57 from pot
*** SUMMARY ***
Total pot $0.6 | Rake $0.03 | Jackpot $0 | Bingo $0 | Fortune $0 | Tax $0
Seat 1: 1f54611 (button) folded before Flop (didn't bet)
Seat 2: b37e3efe (small blind) folded before Flop
Seat 3: 4684e24a (big blind) collected ($0.57)
Seat 4: Hero folded before Flop
Seat 5: 9ef3daf1 folded before Flop (didn't bet)
Seat 6: c3bbb0e7 folded before Flop (didn't bet)


Poker Hand #RC3141669352: Hold'em No Limit ($0.05/$0.1) - 2024/12/12 12:42:28
Table 'RushAndCash22314612' 6-max Seat #1 is the button
Seat 1: 4684e24a ($26.6 in chips)
Seat 2: 8a55880e ($10.88 in chips)
Seat 3: c05b084c ($10 in chips)
Seat 4: cc63da9c ($15.68 in chips)
Seat 5: Hero ($10.65 in chips)
Seat 6: 86ee8e36 ($12.24 in chips)
8a55880e: posts small blind $0.05
c05b084c: posts big blind $0.1
*** HOLE CARDS ***
Dealt to 4684e24a 
Dealt to 8a55880e 
Dealt to c05b084c 
Dealt to cc63da9c 
Dealt to Hero [7s 3h]
Dealt to 86ee8e36 
cc63da9c: folds
Hero: folds
86ee8e36: folds
4684e24a: folds
8a55880e: folds
Uncalled bet ($0.05) returned to c05b084c
*** SHOWDOWN ***
c05b084c collected $0.1 from pot
*** SUMMARY ***
Total pot $0.1 | Rake $0 | Jackpot $0 | Bingo $0 | Fortune $0 | Tax $0
Seat 1: 4684e24a (button) folded before Flop (didn't bet)
Seat 2: 8a55880e (small blind) folded before Flop
Seat 3: c05b084c (big blind) collected ($0.1)
Seat 4: cc63da9c folded before Flop (didn't bet)
Seat 5: Hero folded before Flop (didn't bet)
Seat 6: 86ee8e36 folded before Flop (didn't bet)


Poker Hand #RC3141669011: Hold'em No Limit ($0.05/$0.1) - 2024/12/12 12:41:07
Table 'RushAndCash22314271' 6-max Seat #1 is the button
Seat 1: Hero ($10 in chips)
Seat 2: a35a0951 ($7.86 in chips)
Seat 3: 23d20ac6 ($17.3 in chips)
Seat 4: a1394882 ($13.5 in chips)
Seat 5: eb765b8f ($11.63 in chips)
Seat 6: 8e0a697 ($10 in chips)
a35a0951: posts small blind $0.05
23d20ac6: posts big blind $0.1
*** HOLE CARDS ***
Dealt to Hero [Jh 9s]
Dealt to a35a0951 
Dealt to 23d20ac6 
Dealt to a1394882 
Dealt to eb765b8f 
Dealt to 8e0a697 
a1394882: folds
eb765b8f: folds
8e0a697: folds
Hero: raises $0.15 to $0.25
a35a0951: folds
23d20ac6: calls $0.15
*** FLOP *** [5h 9h Ah]
23d20ac6: checks
Hero: checks
*** TURN *** [5h 9h Ah] [7h]
23d20ac6: checks
Hero: checks
*** RIVER *** [5h 9h Ah 7h] [7s]
23d20ac6: checks
Hero: bets $0.42
23d20ac6: calls $0.42
Hero: shows [Jh 9s] (Ace High Flush)
23d20ac6: shows [6s 6c] (Pair of Sevens and Pair of Sixes)
*** SHOWDOWN ***
Hero collected $1.32 from pot
*** SUMMARY ***
Total pot $1.39 | Rake $0.07 | Jackpot $0 | Bingo $0 | Fortune $0 | Tax $0
Board [5h 9h Ah 7h 7s]
Seat 1: Hero (button) showed [Jh 9s] and won ($1.32) with Ace High Flush
Seat 2: a35a0951 (small blind) folded before Flop
Seat 3: 23d20ac6 (big blind) showed [6s 6c] and lost with Pair of Sevens and Pair of Sixes
Seat 4: a1394882 folded before Flop (didn't bet)
Seat 5: eb765b8f folded before Flop (didn't bet)
Seat 6: 8e0a697 folded before Flop (didn't bet)


Poker Hand #RC3141668995: Hold'em No Limit ($0.05/$0.1) - 2024/12/12 12:41:04
Table 'RushAndCash22314255' 6-max Seat #1 is the button
Seat 1: 1cefc6e8 ($4.56 in chips)
Seat 2: Hero ($10 in chips)
Seat 3: a35a0951 ($7.96 in chips)
Seat 4: 5ddf2544 ($10.17 in chips)
Seat 5: a6717311 ($18.78 in chips)
Seat 6: f4a0e033 ($10.36 in chips)
Hero: posts small blind $0.05
a35a0951: posts big blind $0.1
*** HOLE CARDS ***
Dealt to 1cefc6e8 
Dealt to Hero [4c 5h]
Dealt to a35a0951 
Dealt to 5ddf2544 
Dealt to a6717311 
Dealt to f4a0e033 
5ddf2544: folds
a6717311: folds
f4a0e033: folds
1cefc6e8: folds
Hero: folds
Uncalled bet ($0.05) returned to a35a0951
*** SHOWDOWN ***
a35a0951 collected $0.1 from pot
*** SUMMARY ***
Total pot $0.1 | Rake $0 | Jackpot $0 | Bingo $0 | Fortune $0 | Tax $0
Seat 1: 1cefc6e8 (button) folded before Flop (didn't bet)
Seat 2: Hero (small blind) folded before Flop
Seat 3: a35a0951 (big blind) collected ($0.1)
Seat 4: 5ddf2544 folded before Flop (didn't bet)
Seat 5: a6717311 folded before Flop (didn't bet)
Seat 6: f4a0e033 folded before Flop (didn't bet)


Poker Hand #RC3141668950: Hold'em No Limit ($0.05/$0.1) - 2024/12/12 12:40:54
Table 'RushAndCash22314210' 6-max Seat #1 is the button
Seat 1: c6f4a662 ($9.58 in chips)
Seat 2: 3f908364 ($20.68 in chips)
Seat 3: Hero ($10 in chips)
Seat 4: f347a136 ($11.39 in chips)
Seat 5: a699d2de ($12.05 in chips)
Seat 6: d75a3941 ($11.15 in chips)
3f908364: posts small blind $0.05
Hero: posts big blind $0.1
*** HOLE CARDS ***
Dealt to c6f4a662 
Dealt to 3f908364 
Dealt to Hero [3d 7s]
Dealt to f347a136 
Dealt to a699d2de 
Dealt to d75a3941 
f347a136: raises $0.12 to $0.22
a699d2de: folds
d75a3941: folds
c6f4a662: calls $0.22
3f908364: folds
Hero: folds
*** FLOP *** [9d Tc 6h]
f347a136: checks
c6f4a662: bets $0.3
f347a136: calls $0.3
*** TURN *** [9d Tc 6h] [Td]
f347a136: bets $0.4
c6f4a662: calls $0.4
*** RIVER *** [9d Tc 6h Td] [7c]
f347a136: checks
c6f4a662: checks
f347a136: shows [5c 6c] (Pair of Tens and Pair of Sixes)
c6f4a662: shows [9c Ks] (Pair of Tens and Pair of Nines)
*** SHOWDOWN ***
c6f4a662 collected $1.89 from pot
*** SUMMARY ***
Total pot $1.99 | Rake $0.1 | Jackpot $0 | Bingo $0 | Fortune $0 | Tax $0
Board [9d Tc 6h Td 7c]
Seat 1: c6f4a662 (button) showed [9c Ks] and won ($1.89) with Pair of Tens and Pair of Nines
Seat 2: 3f908364 (small blind) folded before Flop
Seat 3: Hero (big blind) folded before Flop
Seat 4: f347a136 showed [5c 6c] and lost with Pair of Tens and Pair of Sixes
Seat 5: a699d2de folded before Flop (didn't bet)
Seat 6: d75a3941 folded before Flop (didn't bet)


Poker Hand #RC3141668935: Hold'em No Limit ($0.05/$0.1) - 2024/12/12 12:40:50
Table 'RushAndCash22314195' 6-max Seat #1 is the button
Seat 1: f347a136 ($11.24 in chips)
Seat 2: deec756a ($10.2 in chips)
Seat 3: 84849e11 ($85.54 in chips)
Seat 4: a699d2de ($12.05 in chips)
Seat 5: Hero ($10 in chips)
Seat 6: a0bab1fa ($10 in chips)
deec756a: posts small blind $0.05
84849e11: posts big blind $0.1
*** HOLE CARDS ***
Dealt to f347a136 
Dealt to deec756a 
Dealt to 84849e11 
Dealt to a699d2de 
Dealt to Hero [3s Th]
Dealt to a0bab1fa 
a699d2de: folds
Hero: folds
a0bab1fa: folds
f347a136: folds
deec756a: folds
Uncalled bet ($0.05) returned to 84849e11
*** SHOWDOWN ***
84849e11 collected $0.1 from pot
*** SUMMARY ***
Total pot $0.1 | Rake $0 | Jackpot $0 | Bingo $0 | Fortune $0 | Tax $0
Seat 1: f347a136 (button) folded before Flop (didn't bet)
Seat 2: deec756a (small blind) folded before Flop
Seat 3: 84849e11 (big blind) collected ($0.1)
Seat 4: a699d2de folded before Flop (didn't bet)
Seat 5: Hero folded before Flop (didn't bet)
Seat 6: a0bab1fa folded before Flop (didn't bet)


Poker Hand #RC3141668922: Hold'em No Limit ($0.05/$0.1) - 2024/12/12 12:40:47
Table 'RushAndCash22314182' 6-max Seat #1 is the button
Seat 1: 32014ea4 ($9.85 in chips)
Seat 2: a3382d82 ($21.39 in chips)
Seat 3: 8e0a697 ($10 in chips)
Seat 4: b73e1c09 ($25.22 in chips)
Seat 5: Hero ($10 in chips)
Seat 6: a0bab1fa ($10 in chips)
a3382d82: posts small blind $0.05
8e0a697: posts big blind $0.1
*** HOLE CARDS ***
Dealt to 32014ea4 
Dealt to a3382d82 
Dealt to 8e0a697 
Dealt to b73e1c09 
Dealt to Hero [5s Jh]
Dealt to a0bab1fa 
b73e1c09: raises $0.1 to $0.2
Hero: folds
a0bab1fa: folds
32014ea4: folds
a3382d82: folds
8e0a697: folds
Uncalled bet ($0.1) returned to b73e1c09
*** SHOWDOWN ***
b73e1c09 collected $0.25 from pot
*** SUMMARY ***
Total pot $0.25 | Rake $0 | Jackpot $0 | Bingo $0 | Fortune $0 | Tax $0
Seat 1: 32014ea4 (button) folded before Flop (didn't bet)
Seat 2: a3382d82 (small blind) folded before Flop
Seat 3: 8e0a697 (big blind) folded before Flop
Seat 4: b73e1c09 collected ($0.25)
Seat 5: Hero folded before Flop (didn't bet)
Seat 6: a0bab1fa folded before Flop (didn't bet)


Poker Hand #RC3141668906: Hold'em No Limit ($0.05/$0.1) - 2024/12/12 12:40:43
Table 'RushAndCash22314166' 6-max Seat #1 is the button
Seat 1: 5041f166 ($5.56 in chips)
Seat 2: Hero ($10 in chips)
Seat 3: 78428b92 ($50.5 in chips)
Seat 4: 974f52 ($34.54 in chips)
Seat 5: dbcd9107 ($17.84 in chips)
Seat 6: aee2ed20 ($10.67 in chips)
Hero: posts small blind $0.05
78428b92: posts big blind $0.1
*** HOLE CARDS ***
Dealt to 5041f166 
Dealt to Hero [4s 6d]
Dealt to 78428b92 
Dealt to 974f52 
Dealt to dbcd9107 
Dealt to aee2ed20 
974f52: folds
dbcd9107: folds
aee2ed20: folds
5041f166: folds
Hero: folds
Uncalled bet ($0.05) returned to 78428b92
*** SHOWDOWN ***
78428b92 collected $0.1 from pot
*** SUMMARY ***
Total pot $0.1 | Rake $0 | Jackpot $0 | Bingo $0 | Fortune $0 | Tax $0
Seat 1: 5041f166 (button) folded before Flop (didn't bet)
Seat 2: Hero (small blind) folded before Flop
Seat 3: 78428b92 (big blind) collected ($0.1)
Seat 4: 974f52 folded before Flop (didn't bet)
Seat 5: dbcd9107 folded before Flop (didn't bet)
Seat 6: aee2ed20 folded before Flop (didn't bet)


Poker Hand #RC3141668891: Hold'em No Limit ($0.05/$0.1) - 2024/12/12 12:40:39
Table 'RushAndCash22314151' 6-max Seat #1 is the button
Seat 1: 92e8bfbd ($28.62 in chips)
Seat 2: 5c1d4f73 ($10.05 in chips)
Seat 3: 5783aa3 ($11.88 in chips)
Seat 4: 78428b92 ($50.5 in chips)
Seat 5: 974f52 ($34.54 in chips)
Seat 6: Hero ($10 in chips)
5c1d4f73: posts small blind $0.05
5783aa3: posts big blind $0.1
*** HOLE CARDS ***
Dealt to 92e8bfbd 
Dealt to 5c1d4f73 
Dealt to 5783aa3 
Dealt to 78428b92 
Dealt to 974f52 
Dealt to Hero [9c 5s]
78428b92: folds
974f52: folds
Hero: folds
92e8bfbd: raises $0.15 to $0.25
5c1d4f73: folds
5783aa3: raises $0.75 to $1
92e8bfbd: folds
Uncalled bet ($0.75) returned to 5783aa3
*** SHOWDOWN ***
5783aa3 collected $0.53 from pot
*** SUMMARY ***
Total pot $0.55 | Rake $0.02 | Jackpot $0 | Bingo $0 | Fortune $0 | Tax $0
Seat 1: 92e8bfbd (button) folded before Flop
Seat 2: 5c1d4f73 (small blind) folded before Flop
Seat 3: 5783aa3 (big blind) collected ($0.53)
Seat 4: 78428b92 folded before Flop (didn't bet)
Seat 5: 974f52 folded before Flop (didn't bet)
Seat 6: Hero folded before Flop (didn't bet)


Poker Hand #RC3141668877: Hold'em No Limit ($0.05/$0.1) - 2024/12/12 12:40:36
Table 'RushAndCash22314137' 6-max Seat #1 is the button
Seat 1: Hero ($10 in chips)
Seat 2: bb64ea0a ($15.3 in chips)
Seat 3: 4eb4d0d6 ($8.12 in chips)
Seat 4: 974f52 ($34.54 in chips)
Seat 5: 19a0d06d ($4.03 in chips)
Seat 6: f5628a04 ($10.15 in chips)
bb64ea0a: posts small blind $0.05
4eb4d0d6: posts big blind $0.1
*** HOLE CARDS ***
Dealt to Hero [4h Kd]
Dealt to bb64ea0a 
Dealt to 4eb4d0d6 
Dealt to 974f52 
Dealt to 19a0d06d 
Dealt to f5628a04 
974f52: folds
19a0d06d: folds
f5628a04: folds
Hero: folds
bb64ea0a: folds
Uncalled bet ($0.05) returned to 4eb4d0d6
*** SHOWDOWN ***
4eb4d0d6 collected $0.1 from pot
*** SUMMARY ***
Total pot $0.1 | Rake $0 | Jackpot $0 | Bingo $0 | Fortune $0 | Tax $0
Seat 1: Hero (button) folded before Flop (didn't bet)
Seat 2: bb64ea0a (small blind) folded before Flop
Seat 3: 4eb4d0d6 (big blind) collected ($0.1)
Seat 4: 974f52 folded before Flop (didn't bet)
Seat 5: 19a0d06d folded before Flop (didn't bet)
Seat 6: f5628a04 folded before Flop (didn't bet)


Poker Hand #RC3141668823: Hold'em No Limit ($0.05/$0.1) - 2024/12/12 12:40:22
Table 'RushAndCash22314083' 6-max Seat #1 is the button
Seat 1: c8e1bfcc ($10.27 in chips)
Seat 2: daa081a6 ($13.4 in chips)
Seat 3: Hero ($10 in chips)
Seat 4: f95a58d4 ($23.75 in chips)
Seat 5: 4e5c7119 ($11.12 in chips)
Seat 6: c6786b68 ($21.01 in chips)
daa081a6: posts small blind $0.05
Hero: posts big blind $0.1
*** HOLE CARDS ***
Dealt to c8e1bfcc 
Dealt to daa081a6 
Dealt to Hero [2s 7h]
Dealt to f95a58d4 
Dealt to 4e5c7119 
Dealt to c6786b68 
f95a58d4: folds
4e5c7119: folds
c6786b68: raises $0.1 to $0.2
c8e1bfcc: folds
daa081a6: folds
Hero: folds
Uncalled bet ($0.1) returned to c6786b68
*** SHOWDOWN ***
c6786b68 collected $0.25 from pot
*** SUMMARY ***
Total pot $0.25 | Rake $0 | Jackpot $0 | Bingo $0 | Fortune $0 | Tax $0
Seat 1: c8e1bfcc (button) folded before Flop (didn't bet)
Seat 2: daa081a6 (small blind) folded before Flop
Seat 3: Hero (big blind) folded before Flop
Seat 4: f95a58d4 folded before Flop (didn't bet)
Seat 5: 4e5c7119 folded before Flop (didn't bet)
Seat 6: c6786b68 collected ($0.25)


Poker Hand #RC3141668808: Hold'em No Limit ($0.05/$0.1) - 2024/12/12 12:40:19
Table 'RushAndCash22314068' 6-max Seat #1 is the button
Seat 1: 12b883d0 ($26.24 in chips)
Seat 2: 1fe7df8c ($13.16 in chips)
Seat 3: 97a1e12e ($12.06 in chips)
Seat 4: Hero ($10 in chips)
Seat 5: daa081a6 ($13.4 in chips)
Seat 6: ee394d0a ($10 in chips)
1fe7df8c: posts small blind $0.05
97a1e12e: posts big blind $0.1
*** HOLE CARDS ***
Dealt to 12b883d0 
Dealt to 1fe7df8c 
Dealt to 97a1e12e 
Dealt to Hero [6c 3h]
Dealt to daa081a6 
Dealt to ee394d0a 
Hero: folds
daa081a6: folds
ee394d0a: raises $0.1 to $0.2
12b883d0: folds
1fe7df8c: folds
97a1e12e: calls $0.1
*** FLOP *** [8s Ks 5s]
97a1e12e: checks
ee394d0a: checks
*** TURN *** [8s Ks 5s] [8c]
97a1e12e: bets $1.5
ee394d0a: folds
Uncalled bet ($1.5) returned to 97a1e12e
*** SHOWDOWN ***
97a1e12e collected $0.43 from pot
*** SUMMARY ***
Total pot $0.45 | Rake $0.02 | Jackpot $0 | Bingo $0 | Fortune $0 | Tax $0
Board [8s Ks 5s 8c]
Seat 1: 12b883d0 (button) folded before Flop (didn't bet)
Seat 2: 1fe7df8c (small blind) folded before Flop
Seat 3: 97a1e12e (big blind) won ($0.43)
Seat 4: Hero folded before Flop (didn't bet)
Seat 5: daa081a6 folded before Flop (didn't bet)
Seat 6: ee394d0a folded on the Turn


Poker Hand #RC3141668792: Hold'em No Limit ($0.05/$0.1) - 2024/12/12 12:40:15
Table 'RushAndCash22314052' 6-max Seat #1 is the button
Seat 1: 895d916a ($34.48 in chips)
Seat 2: 755092ba ($16.99 in chips)
Seat 3: cc8462b1 ($10.74 in chips)
Seat 4: 101c026b ($25.05 in chips)
Seat 5: 3954586d ($10.1 in chips)
Seat 6: Hero ($10 in chips)
755092ba: posts small blind $0.05
cc8462b1: posts big blind $0.1
*** HOLE CARDS ***
Dealt to 895d916a 
Dealt to 755092ba 
Dealt to cc8462b1 
Dealt to 101c026b 
Dealt to 3954586d 
Dealt to Hero [Td 9h]
101c026b: raises $0.11 to $0.21
3954586d: folds
Hero: folds
895d916a: folds
755092ba: calls $0.16
cc8462b1: folds
*** FLOP *** [3d Ac 6h]
755092ba: checks
101c026b: checks
*** TURN *** [3d Ac 6h] [3c]
755092ba: checks
101c026b: checks
*** RIVER *** [3d Ac 6h 3c] [2s]
755092ba: bets $0.18
101c026b: folds
Uncalled bet ($0.18) returned to 755092ba
*** SHOWDOWN ***
755092ba collected $0.5 from pot
*** SUMMARY ***
Total pot $0.52 | Rake $0.02 | Jackpot $0 | Bingo $0 | Fortune $0 | Tax $0
Board [3d Ac 6h 3c 2s]
Seat 1: 895d916a (button) folded before Flop (didn't bet)
Seat 2: 755092ba (small blind) won ($0.5)
Seat 3: cc8462b1 (big blind) folded before Flop
Seat 4: 101c026b folded on the River
Seat 5: 3954586d folded before Flop (didn't bet)
Seat 6: Hero folded before Flop (didn't bet)


Poker Hand #RC3141668777: Hold'em No Limit ($0.05/$0.1) - 2024/12/12 12:40:11
Table 'RushAndCash22314037' 6-max Seat #1 is the button
Seat 1: 54d53a50 ($19.38 in chips)
Seat 2: 75ae83f ($10.05 in chips)
Seat 3: f2b49ec ($8.98 in chips)
Seat 4: c86d72c6 ($12.22 in chips)
Seat 5: 2db5d1cb ($12.95 in chips)
Seat 6: Hero ($10 in chips)
75ae83f: posts small blind $0.05
f2b49ec: posts big blind $0.1
*** HOLE CARDS ***
Dealt to 54d53a50 
Dealt to 75ae83f 
Dealt to f2b49ec 
Dealt to c86d72c6 
Dealt to 2db5d1cb 
Dealt to Hero [Tc 6s]
c86d72c6: calls $0.1
2db5d1cb: folds
Hero: folds
54d53a50: folds
75ae83f: folds
f2b49ec: checks
*** FLOP *** [4s As 3h]
f2b49ec: checks
c86d72c6: checks
*** TURN *** [4s As 3h] [3s]
f2b49ec: checks
c86d72c6: checks
*** RIVER *** [4s As 3h 3s] [Jc]
f2b49ec: checks
c86d72c6: bets $0.13
f2b49ec: folds
Uncalled bet ($0.13) returned to c86d72c6
*** SHOWDOWN ***
c86d72c6 collected $0.24 from pot
*** SUMMARY ***
Total pot $0.25 | Rake $0.01 | Jackpot $0 | Bingo $0 | Fortune $0 | Tax $0
Board [4s As 3h 3s Jc]
Seat 1: 54d53a50 (button) folded before Flop (didn't bet)
Seat 2: 75ae83f (small blind) folded before Flop
Seat 3: f2b49ec (big blind) folded on the River
Seat 4: c86d72c6 won ($0.24)
Seat 5: 2db5d1cb folded before Flop (didn't bet)
Seat 6: Hero folded before Flop (didn't bet)


Poker Hand #RC3141668761: Hold'em No Limit ($0.05/$0.1) - 2024/12/12 12:40:08
Table 'RushAndCash22314021' 6-max Seat #1 is the button
Seat 1: cc63da9c ($10.08 in chips)
Seat 2: f7ecedd7 ($11.93 in chips)
Seat 3: 7ee23c5e ($15.12 in chips)
Seat 4: 8ebad06f ($14.9 in chips)
Seat 5: Hero ($10 in chips)
Seat 6: 6c4ba3fb ($9.68 in chips)
f7ecedd7: posts small blind $0.05
7ee23c5e: posts big blind $0.1
*** HOLE CARDS ***
Dealt to cc63da9c 
Dealt to f7ecedd7 
Dealt to 7ee23c5e 
Dealt to 8ebad06f 
Dealt to Hero [4c Kd]
Dealt to 6c4ba3fb 
8ebad06f: raises $0.1 to $0.2
Hero: folds
6c4ba3fb: folds
cc63da9c: folds
f7ecedd7: raises $0.8 to $1
7ee23c5e: folds
8ebad06f: folds
Uncalled bet ($0.8) returned to f7ecedd7
*** SHOWDOWN ***
f7ecedd7 collected $0.48 from pot
*** SUMMARY ***
Total pot $0.5 | Rake $0.02 | Jackpot $0 | Bingo $0 | Fortune $0 | Tax $0
Seat 1: cc63da9c (button) folded before Flop (didn't bet)
Seat 2: f7ecedd7 (small blind) collected ($0.48)
Seat 3: 7ee23c5e (big blind) folded before Flop
Seat 4: 8ebad06f folded before Flop
Seat 5: Hero folded before Flop (didn't bet)
Seat 6: 6c4ba3fb folded before Flop (didn't bet)


Poker Hand #RC3141668732: Hold'em No Limit ($0.05/$0.1) - 2024/12/12 12:40:00
Table 'RushAndCash22313992' 6-max Seat #1 is the button
Seat 1: b17f5bfe ($6.58 in chips)
Seat 2: Hero ($10.05 in chips)
Seat 3: b69e52ed ($10.17 in chips)
Seat 4: b8e03e64 ($10.23 in chips)
Seat 5: 4e5c7119 ($11.17 in chips)
Seat 6: bb64ea0a ($15.45 in chips)
Hero: posts small blind $0.05
b69e52ed: posts big blind $0.1
*** HOLE CARDS ***
Dealt to b17f5bfe 
Dealt to Hero [8c 4c]
Dealt to b69e52ed 
Dealt to b8e03e64 
Dealt to 4e5c7119 
Dealt to bb64ea0a 
b8e03e64: folds
4e5c7119: folds
bb64ea0a: raises $0.1 to $0.2
b17f5bfe: folds
Hero: folds
b69e52ed: folds
Uncalled bet ($0.1) returned to bb64ea0a
*** SHOWDOWN ***
bb64ea0a collected $0.25 from pot
*** SUMMARY ***
Total pot $0.25 | Rake $0 | Jackpot $0 | Bingo $0 | Fortune $0 | Tax $0
Seat 1: b17f5bfe (button) folded before Flop (didn't bet)
Seat 2: Hero (small blind) folded before Flop
Seat 3: b69e52ed (big blind) folded before Flop
Seat 4: b8e03e64 folded before Flop (didn't bet)
Seat 5: 4e5c7119 folded before Flop (didn't bet)
Seat 6: bb64ea0a collected ($0.25)


Poker Hand #RC3141668719: Hold'em No Limit ($0.05/$0.1) - 2024/12/12 12:39:57
Table 'RushAndCash22313979' 6-max Seat #1 is the button
Seat 1: Hero ($10.05 in chips)
Seat 2: be2bfc8f ($10.05 in chips)
Seat 3: b17f5bfe ($6.68 in chips)
Seat 4: 22c85f0b ($4.95 in chips)
Seat 5: bb64ea0a ($15.45 in chips)
Seat 6: 24c2159e ($10 in chips)
be2bfc8f: posts small blind $0.05
b17f5bfe: posts big blind $0.1
*** HOLE CARDS ***
Dealt to Hero [3h Qc]
Dealt to be2bfc8f 
Dealt to b17f5bfe 
Dealt to 22c85f0b 
Dealt to bb64ea0a 
Dealt to 24c2159e 
22c85f0b: raises $0.2 to $0.3
bb64ea0a: folds
24c2159e: folds
Hero: folds
be2bfc8f: folds
b17f5bfe: folds
Uncalled bet ($0.2) returned to 22c85f0b
*** SHOWDOWN ***
22c85f0b collected $0.25 from pot
*** SUMMARY ***
Total pot $0.25 | Rake $0 | Jackpot $0 | Bingo $0 | Fortune $0 | Tax $0
Seat 1: Hero (button) folded before Flop (didn't bet)
Seat 2: be2bfc8f (small blind) folded before Flop
Seat 3: b17f5bfe (big blind) folded before Flop
Seat 4: 22c85f0b collected ($0.25)
Seat 5: bb64ea0a folded before Flop (didn't bet)
Seat 6: 24c2159e folded before Flop (didn't bet)


Poker Hand #RC3141668618: Hold'em No Limit ($0.05/$0.1) - 2024/12/12 12:39:34
Table 'RushAndCash22313878' 6-max Seat #1 is the button
Seat 1: 4b1c7e7e ($11.47 in chips)
Seat 2: 17b381d5 ($25.68 in chips)
Seat 3: Hero ($10.25 in chips)
Seat 4: bb835227 ($10.43 in chips)
Seat 5: d19ee248 ($10.45 in chips)
Seat 6: 22c85f0b ($4.72 in chips)
17b381d5: posts small blind $0.05
Hero: posts big blind $0.1
*** HOLE CARDS ***
Dealt to 4b1c7e7e 
Dealt to 17b381d5 
Dealt to Hero [6s 8s]
Dealt to bb835227 
Dealt to d19ee248 
Dealt to 22c85f0b 
bb835227: folds
d19ee248: folds
22c85f0b: raises $0.1 to $0.2
4b1c7e7e: folds
17b381d5: folds
Hero: calls $0.1
*** FLOP *** [4h 2h Td]
Hero: checks
22c85f0b: bets $0.23
Hero: folds
Uncalled bet ($0.23) returned to 22c85f0b
*** SHOWDOWN ***
22c85f0b collected $0.43 from pot
*** SUMMARY ***
Total pot $0.45 | Rake $0.02 | Jackpot $0 | Bingo $0 | Fortune $0 | Tax $0
Board [4h 2h Td]
Seat 1: 4b1c7e7e (button) folded before Flop (didn't bet)
Seat 2: 17b381d5 (small blind) folded before Flop
Seat 3: Hero (big blind) folded on the Flop
Seat 4: bb835227 folded before Flop (didn't bet)
Seat 5: d19ee248 folded before Flop (didn't bet)
Seat 6: 22c85f0b won ($0.43)


Poker Hand #RC3141668603: Hold'em No Limit ($0.05/$0.1) - 2024/12/12 12:39:31
Table 'RushAndCash22313863' 6-max Seat #1 is the button
Seat 1: a6717311 ($19.88 in chips)
Seat 2: dbcd9107 ($18.34 in chips)
Seat 3: 9e17ad05 ($10.33 in chips)
Seat 4: Hero ($10.25 in chips)
Seat 5: 647dd971 ($3.39 in chips)
Seat 6: 1f54611 ($16.26 in chips)
dbcd9107: posts small blind $0.05
9e17ad05: posts big blind $0.1
*** HOLE CARDS ***
Dealt to a6717311 
Dealt to dbcd9107 
Dealt to 9e17ad05 
Dealt to Hero [5s 6h]
Dealt to 647dd971 
Dealt to 1f54611 
Hero: folds
647dd971: raises $0.1 to $0.2
1f54611: folds
a6717311: folds
dbcd9107: folds
9e17ad05: folds
Uncalled bet ($0.1) returned to 647dd971
*** SHOWDOWN ***
647dd971 collected $0.25 from pot
*** SUMMARY ***
Total pot $0.25 | Rake $0 | Jackpot $0 | Bingo $0 | Fortune $0 | Tax $0
Seat 1: a6717311 (button) folded before Flop (didn't bet)
Seat 2: dbcd9107 (small blind) folded before Flop
Seat 3: 9e17ad05 (big blind) folded before Flop
Seat 4: Hero folded before Flop (didn't bet)
Seat 5: 647dd971 collected ($0.25)
Seat 6: 1f54611 folded before Flop (didn't bet)


Poker Hand #RC3141668591: Hold'em No Limit ($0.05/$0.1) - 2024/12/12 12:39:27
Table 'RushAndCash22313851' 6-max Seat #1 is the button
Seat 1: 46e6c699 ($7.53 in chips)
Seat 2: f95a58d4 ($24.25 in chips)
Seat 3: 22c85f0b ($4.82 in chips)
Seat 4: 8cfa2620 ($20.93 in chips)
Seat 5: b51a8683 ($10 in chips)
Seat 6: Hero ($10.25 in chips)
f95a58d4: posts small blind $0.05
22c85f0b: posts big blind $0.1
*** HOLE CARDS ***
Dealt to 46e6c699 
Dealt to f95a58d4 
Dealt to 22c85f0b 
Dealt to 8cfa2620 
Dealt to b51a8683 
Dealt to Hero [4d 5h]
8cfa2620: raises $0.1 to $0.2
b51a8683: folds
Hero: folds
46e6c699: folds
f95a58d4: folds
22c85f0b: folds
Uncalled bet ($0.1) returned to 8cfa2620
*** SHOWDOWN ***
8cfa2620 collected $0.25 from pot
*** SUMMARY ***
Total pot $0.25 | Rake $0 | Jackpot $0 | Bingo $0 | Fortune $0 | Tax $0
Seat 1: 46e6c699 (button) folded before Flop (didn't bet)
Seat 2: f95a58d4 (small blind) folded before Flop
Seat 3: 22c85f0b (big blind) folded before Flop
Seat 4: 8cfa2620 collected ($0.25)
Seat 5: b51a8683 folded before Flop (didn't bet)
Seat 6: Hero folded before Flop (didn't bet)


Poker Hand #RC3141668579: Hold'em No Limit ($0.05/$0.1) - 2024/12/12 12:39:24
Table 'RushAndCash22313839' 6-max Seat #1 is the button
Seat 1: Hero ($10.25 in chips)
Seat 2: cfe70ef2 ($10.32 in chips)
Seat 3: c3531128 ($28.32 in chips)
Seat 4: 22c85f0b ($4.82 in chips)
Seat 5: 226dbbb0 ($10.37 in chips)
Seat 6: aee2ed20 ($10.82 in chips)
cfe70ef2: posts small blind $0.05
c3531128: posts big blind $0.1
*** HOLE CARDS ***
Dealt to Hero [3d Tc]
Dealt to cfe70ef2 
Dealt to c3531128 
Dealt to 22c85f0b 
Dealt to 226dbbb0 
Dealt to aee2ed20 
22c85f0b: folds
226dbbb0: folds
aee2ed20: folds
Hero: folds
cfe70ef2: folds
Uncalled bet ($0.05) returned to c3531128
*** SHOWDOWN ***
c3531128 collected $0.1 from pot
*** SUMMARY ***
Total pot $0.1 | Rake $0 | Jackpot $0 | Bingo $0 | Fortune $0 | Tax $0
Seat 1: Hero (button) folded before Flop (didn't bet)
Seat 2: cfe70ef2 (small blind) folded before Flop
Seat 3: c3531128 (big blind) collected ($0.1)
Seat 4: 22c85f0b folded before Flop (didn't bet)
Seat 5: 226dbbb0 folded before Flop (didn't bet)
Seat 6: aee2ed20 folded before Flop (didn't bet)


Poker Hand #RC3141668542: Hold'em No Limit ($0.05/$0.1) - 2024/12/12 12:39:15
Table 'RushAndCash22313802' 6-max Seat #1 is the button
Seat 1: c6f4a662 ($6.98 in chips)
Seat 2: Hero ($10 in chips)
Seat 3: a5121f52 ($8.54 in chips)
Seat 4: c05b084c ($10 in chips)
Seat 5: 8ebad06f ($14.9 in chips)
Seat 6: f2b49ec ($9.23 in chips)
Hero: posts small blind $0.05
a5121f52: posts big blind $0.1
*** HOLE CARDS ***
Dealt to c6f4a662 
Dealt to Hero [Td Qs]
Dealt to a5121f52 
Dealt to c05b084c 
Dealt to 8ebad06f 
Dealt to f2b49ec 
c05b084c: folds
8ebad06f: folds
f2b49ec: folds
c6f4a662: folds
Hero: raises $0.2 to $0.3
a5121f52: folds
Uncalled bet ($0.2) returned to Hero
*** SHOWDOWN ***
Hero collected $0.2 from pot
*** SUMMARY ***
Total pot $0.2 | Rake $0 | Jackpot $0 | Bingo $0 | Fortune $0 | Tax $0
Seat 1: c6f4a662 (button) folded before Flop (didn't bet)
Seat 2: Hero (small blind) collected ($0.2)
Seat 3: a5121f52 (big blind) folded before Flop
Seat 4: c05b084c folded before Flop (didn't bet)
Seat 5: 8ebad06f folded before Flop (didn't bet)
Seat 6: f2b49ec folded before Flop (didn't bet)


Poker Hand #RC3141668523: Hold'em No Limit ($0.05/$0.1) - 2024/12/12 12:39:10
Table 'RushAndCash22313783' 6-max Seat #1 is the button
Seat 1: da482069 ($14.32 in chips)
Seat 2: cc8462b1 ($10 in chips)
Seat 3: Hero ($10.1 in chips)
Seat 4: 6ea7e0fb ($6.67 in chips)
Seat 5: 5b14e7af ($20.88 in chips)
Seat 6: 4eb4d0d6 ($8.72 in chips)
cc8462b1: posts small blind $0.05
Hero: posts big blind $0.1
*** HOLE CARDS ***
Dealt to da482069 
Dealt to cc8462b1 
Dealt to Hero [Ks 3d]
Dealt to 6ea7e0fb 
Dealt to 5b14e7af 
Dealt to 4eb4d0d6 
6ea7e0fb: folds
5b14e7af: folds
4eb4d0d6: folds
da482069: folds
cc8462b1: folds
Uncalled bet ($0.05) returned to Hero
*** SHOWDOWN ***
Hero collected $0.1 from pot
*** SUMMARY ***
Total pot $0.1 | Rake $0 | Jackpot $0 | Bingo $0 | Fortune $0 | Tax $0
Seat 1: da482069 (button) folded before Flop (didn't bet)
Seat 2: cc8462b1 (small blind) folded before Flop
Seat 3: Hero (big blind) collected ($0.1)
Seat 4: 6ea7e0fb folded before Flop (didn't bet)
Seat 5: 5b14e7af folded before Flop (didn't bet)
Seat 6: 4eb4d0d6 folded before Flop (didn't bet)


Poker Hand #RC3141668511: Hold'em No Limit ($0.05/$0.1) - 2024/12/12 12:39:07
Table 'RushAndCash22313771' 6-max Seat #1 is the button
Seat 1: 4c96024a ($10.22 in chips)
Seat 2: 66a73913 ($18.35 in chips)
Seat 3: 844091a0 ($10.8 in chips)
Seat 4: 4eb4d0d6 ($8.72 in chips)
Seat 5: Hero ($10.1 in chips)
Seat 6: c92ccc19 ($8.19 in chips)
66a73913: posts small blind $0.05
844091a0: posts big blind $0.1
*** HOLE CARDS ***
Dealt to 4c96024a 
Dealt to 66a73913 
Dealt to 844091a0 
Dealt to 4eb4d0d6 
Dealt to Hero [7h Kd]
Dealt to c92ccc19 
4eb4d0d6: folds
Hero: folds
c92ccc19: folds
4c96024a: folds
66a73913: calls $0.05
844091a0: checks
*** FLOP *** [3h 8d Js]
66a73913: checks
844091a0: checks
*** TURN *** [3h 8d Js] [5d]
66a73913: checks
844091a0: checks
*** RIVER *** [3h 8d Js 5d] [As]
66a73913: checks
844091a0: checks
66a73913: shows [2s Tc] (Ace-High)
844091a0: shows [9c 3s] (Pair of Treys)
*** SHOWDOWN ***
844091a0 collected $0.19 from pot
*** SUMMARY ***
Total pot $0.2 | Rake $0.01 | Jackpot $0 | Bingo $0 | Fortune $0 | Tax $0
Board [3h 8d Js 5d As]
Seat 1: 4c96024a (button) folded before Flop (didn't bet)
Seat 2: 66a73913 (small blind) showed [2s Tc] and lost with Ace-High
Seat 3: 844091a0 (big blind) showed [9c 3s] and won ($0.19) with Pair of Treys
Seat 4: 4eb4d0d6 folded before Flop (didn't bet)
Seat 5: Hero folded before Flop (didn't bet)
Seat 6: c92ccc19 folded before Flop (didn't bet)


Poker Hand #RC3141668497: Hold'em No Limit ($0.05/$0.1) - 2024/12/12 12:39:03
Table 'RushAndCash22313757' 6-max Seat #1 is the button
Seat 1: 59307d25 ($14.13 in chips)
Seat 2: f2b49ec ($9.28 in chips)
Seat 3: 80ebdd41 ($11.2 in chips)
Seat 4: f347a136 ($10 in chips)
Seat 5: Hero ($10.1 in chips)
Seat 6: 1f54611 ($16.41 in chips)
f2b49ec: posts small blind $0.05
80ebdd41: posts big blind $0.1
*** HOLE CARDS ***
Dealt to 59307d25 
Dealt to f2b49ec 
Dealt to 80ebdd41 
Dealt to f347a136 
Dealt to Hero [9h 3c]
Dealt to 1f54611 
f347a136: folds
Hero: folds
1f54611: folds
59307d25: raises $0.15 to $0.25
f2b49ec: folds
80ebdd41: folds
Uncalled bet ($0.15) returned to 59307d25
*** SHOWDOWN ***
59307d25 collected $0.25 from pot
*** SUMMARY ***
Total pot $0.25 | Rake $0 | Jackpot $0 | Bingo $0 | Fortune $0 | Tax $0
Seat 1: 59307d25 (button) collected ($0.25)
Seat 2: f2b49ec (small blind) folded before Flop
Seat 3: 80ebdd41 (big blind) folded before Flop
Seat 4: f347a136 folded before Flop (didn't bet)
Seat 5: Hero folded before Flop (didn't bet)
Seat 6: 1f54611 folded before Flop (didn't bet)


Poker Hand #RC3141668482: Hold'em No Limit ($0.05/$0.1) - 2024/12/12 12:39:00
Table 'RushAndCash22313742' 6-max Seat #1 is the button
Seat 1: 671b32fd ($13.05 in chips)
Seat 2: 755092ba ($15.73 in chips)
Seat 3: a699d2de ($11.72 in chips)
Seat 4: Hero ($10.1 in chips)
Seat 5: f2ece23 ($13.66 in chips)
Seat 6: 673ecd77 ($22.7 in chips)
755092ba: posts small blind $0.05
a699d2de: posts big blind $0.1
*** HOLE CARDS ***
Dealt to 671b32fd 
Dealt to 755092ba 
Dealt to a699d2de 
Dealt to Hero [Qs 5c]
Dealt to f2ece23 
Dealt to 673ecd77 
Hero: folds
f2ece23: folds
673ecd77: folds
671b32fd: folds
755092ba: folds
Uncalled bet ($0.05) returned to a699d2de
*** SHOWDOWN ***
a699d2de collected $0.1 from pot
*** SUMMARY ***
Total pot $0.1 | Rake $0 | Jackpot $0 | Bingo $0 | Fortune $0 | Tax $0
Seat 1: 671b32fd (button) folded before Flop (didn't bet)
Seat 2: 755092ba (small blind) folded before Flop
Seat 3: a699d2de (big blind) collected ($0.1)
Seat 4: Hero folded before Flop (didn't bet)
Seat 5: f2ece23 folded before Flop (didn't bet)
Seat 6: 673ecd77 folded before Flop (didn't bet)


Poker Hand #RC3141668468: Hold'em No Limit ($0.05/$0.1) - 2024/12/12 12:38:56
Table 'RushAndCash22313728' 6-max Seat #1 is the button
Seat 1: Hero ($10.1 in chips)
Seat 2: 1e41d97e ($8.29 in chips)
Seat 3: 86ee8e36 ($12.16 in chips)
Seat 4: f2ece23 ($13.66 in chips)
Seat 5: f08fe70 ($19.91 in chips)
Seat 6: e6eec7bb ($11.86 in chips)
1e41d97e: posts small blind $0.05
86ee8e36: posts big blind $0.1
*** HOLE CARDS ***
Dealt to Hero [8h 4d]
Dealt to 1e41d97e 
Dealt to 86ee8e36 
Dealt to f2ece23 
Dealt to f08fe70 
Dealt to e6eec7bb 
f2ece23: folds
f08fe70: folds
e6eec7bb: raises $0.1 to $0.2
Hero: folds
1e41d97e: folds
86ee8e36: calls $0.1
*** FLOP *** [As 8c 8d]
86ee8e36: checks
e6eec7bb: bets $0.1
86ee8e36: folds
Uncalled bet ($0.1) returned to e6eec7bb
*** SHOWDOWN ***
e6eec7bb collected $0.43 from pot
*** SUMMARY ***
Total pot $0.45 | Rake $0.02 | Jackpot $0 | Bingo $0 | Fortune $0 | Tax $0
Board [As 8c 8d]
Seat 1: Hero (button) folded before Flop (didn't bet)
Seat 2: 1e41d97e (small blind) folded before Flop
Seat 3: 86ee8e36 (big blind) folded on the Flop
Seat 4: f2ece23 folded before Flop (didn't bet)
Seat 5: f08fe70 folded before Flop (didn't bet)
Seat 6: e6eec7bb won ($0.43)


Poker Hand #RC3141668420: Hold'em No Limit ($0.05/$0.1) - 2024/12/12 12:38:45
Table 'RushAndCash22313680' 6-max Seat #1 is the button
Seat 1: cfe70ef2 ($10 in chips)
Seat 2: Hero ($10 in chips)
Seat 3: 46e6c699 ($7.68 in chips)
Seat 4: 895d916a ($34.63 in chips)
Seat 5: 1e25b5bb ($15.7 in chips)
Seat 6: 2e735933 ($10 in chips)
Hero: posts small blind $0.05
46e6c699: posts big blind $0.1
*** HOLE CARDS ***
Dealt to cfe70ef2 
Dealt to Hero [Kc Qs]
Dealt to 46e6c699 
Dealt to 895d916a 
Dealt to 1e25b5bb 
Dealt to 2e735933 
895d916a: folds
1e25b5bb: folds
2e735933: folds
cfe70ef2: folds
Hero: raises $0.2 to $0.3
46e6c699: folds
Uncalled bet ($0.2) returned to Hero
*** SHOWDOWN ***
Hero collected $0.2 from pot
*** SUMMARY ***
Total pot $0.2 | Rake $0 | Jackpot $0 | Bingo $0 | Fortune $0 | Tax $0
Seat 1: cfe70ef2 (button) folded before Flop (didn't bet)
Seat 2: Hero (small blind) collected ($0.2)
Seat 3: 46e6c699 (big blind) folded before Flop
Seat 4: 895d916a folded before Flop (didn't bet)
Seat 5: 1e25b5bb folded before Flop (didn't bet)
Seat 6: 2e735933 folded before Flop (didn't bet)


Poker Hand #RC3141668377: Hold'em No Limit ($0.05/$0.1) - 2024/12/12 12:38:32
Table 'RushAndCash22313637' 6-max Seat #1 is the button
Seat 1: 2a6446ed ($13.15 in chips)
Seat 2: 24039de0 ($10.86 in chips)
Seat 3: Hero ($10 in chips)
Seat 4: edb28086 ($12.41 in chips)
Seat 5: ae47099b ($18.69 in chips)
Seat 6: 579e0b5 ($7.91 in chips)
24039de0: posts small blind $0.05
Hero: posts big blind $0.1
*** HOLE CARDS ***
Dealt to 2a6446ed 
Dealt to 24039de0 
Dealt to Hero [4h 5d]
Dealt to edb28086 
Dealt to ae47099b 
Dealt to 579e0b5 
edb28086: folds
ae47099b: folds
579e0b5: folds
2a6446ed: raises $0.15 to $0.25
24039de0: folds
Hero: folds
Uncalled bet ($0.15) returned to 2a6446ed
*** SHOWDOWN ***
2a6446ed collected $0.25 from pot
*** SUMMARY ***
Total pot $0.25 | Rake $0 | Jackpot $0 | Bingo $0 | Fortune $0 | Tax $0
Seat 1: 2a6446ed (button) collected ($0.25)
Seat 2: 24039de0 (small blind) folded before Flop
Seat 3: Hero (big blind) folded before Flop
Seat 4: edb28086 folded before Flop (didn't bet)
Seat 5: ae47099b folded before Flop (didn't bet)
Seat 6: 579e0b5 folded before Flop (didn't bet)


Poker Hand #RC3141668328: Hold'em No Limit ($0.05/$0.1) - 2024/12/12 12:38:20
Table 'RushAndCash22313588' 6-max Seat #1 is the button
Seat 1: 3d7948d ($10 in chips)
Seat 2: c8e1bfcc ($10.37 in chips)
Seat 3: e7a93172 ($10 in chips)
Seat 4: bb64ea0a ($8.1 in chips)
Seat 5: Hero ($10 in chips)
Seat 6: 5fd159a6 ($16.34 in chips)
c8e1bfcc: posts small blind $0.05
e7a93172: posts big blind $0.1
*** HOLE CARDS ***
Dealt to 3d7948d 
Dealt to c8e1bfcc 
Dealt to e7a93172 
Dealt to bb64ea0a 
Dealt to Hero [Tc 2c]
Dealt to 5fd159a6 
bb64ea0a: folds
Hero: folds
5fd159a6: folds
3d7948d: folds
c8e1bfcc: folds
Uncalled bet ($0.05) returned to e7a93172
*** SHOWDOWN ***
e7a93172 collected $0.1 from pot
*** SUMMARY ***
Total pot $0.1 | Rake $0 | Jackpot $0 | Bingo $0 | Fortune $0 | Tax $0
Seat 1: 3d7948d (button) folded before Flop (didn't bet)
Seat 2: c8e1bfcc (small blind) folded before Flop
Seat 3: e7a93172 (big blind) collected ($0.1)
Seat 4: bb64ea0a folded before Flop (didn't bet)
Seat 5: Hero folded before Flop (didn't bet)
Seat 6: 5fd159a6 folded before Flop (didn't bet)


Poker Hand #RC3141668315: Hold'em No Limit ($0.05/$0.1) - 2024/12/12 12:38:17
Table 'RushAndCash22313575' 6-max Seat #1 is the button
Seat 1: 23d20ac6 ($16.42 in chips)
Seat 2: 3d7948d ($10.05 in chips)
Seat 3: b4bc8071 ($12.77 in chips)
Seat 4: Hero ($10 in chips)
Seat 5: e7a93172 ($10 in chips)
Seat 6: bb64ea0a ($8.1 in chips)
3d7948d: posts small blind $0.05
b4bc8071: posts big blind $0.1
*** HOLE CARDS ***
Dealt to 23d20ac6 
Dealt to 3d7948d 
Dealt to b4bc8071 
Dealt to Hero [2s Qc]
Dealt to e7a93172 
Dealt to bb64ea0a 
Hero: folds
e7a93172: folds
bb64ea0a: folds
23d20ac6: folds
3d7948d: folds
Uncalled bet ($0.05) returned to b4bc8071
*** SHOWDOWN ***
b4bc8071 collected $0.1 from pot
*** SUMMARY ***
Total pot $0.1 | Rake $0 | Jackpot $0 | Bingo $0 | Fortune $0 | Tax $0
Seat 1: 23d20ac6 (button) folded before Flop (didn't bet)
Seat 2: 3d7948d (small blind) folded before Flop
Seat 3: b4bc8071 (big blind) collected ($0.1)
Seat 4: Hero folded before Flop (didn't bet)
Seat 5: e7a93172 folded before Flop (didn't bet)
Seat 6: bb64ea0a folded before Flop (didn't bet)


Poker Hand #RC3141668202: Hold'em No Limit ($0.05/$0.1) - 2024/12/12 12:37:45
Table 'RushAndCash22313462' 6-max Seat #1 is the button
Seat 1: 4898aa10 ($18.45 in chips)
Seat 2: 671b32fd ($13.45 in chips)
Seat 3: 5ab2e15d ($10.1 in chips)
Seat 4: 5b982aa5 ($15.19 in chips)
Seat 5: 22e8274e ($16.11 in chips)
Seat 6: Hero ($10 in chips)
671b32fd: posts small blind $0.05
5ab2e15d: posts big blind $0.1
*** HOLE CARDS ***
Dealt to 4898aa10 
Dealt to 671b32fd 
Dealt to 5ab2e15d 
Dealt to 5b982aa5 
Dealt to 22e8274e 
Dealt to Hero [7h 8d]
5b982aa5: folds
22e8274e: folds
Hero: folds
4898aa10: folds
671b32fd: folds
Uncalled bet ($0.05) returned to 5ab2e15d
*** SHOWDOWN ***
5ab2e15d collected $0.1 from pot
*** SUMMARY ***
Total pot $0.1 | Rake $0 | Jackpot $0 | Bingo $0 | Fortune $0 | Tax $0
Seat 1: 4898aa10 (button) folded before Flop (didn't bet)
Seat 2: 671b32fd (small blind) folded before Flop
Seat 3: 5ab2e15d (big blind) collected ($0.1)
Seat 4: 5b982aa5 folded before Flop (didn't bet)
Seat 5: 22e8274e folded before Flop (didn't bet)
Seat 6: Hero folded before Flop (didn't bet)


Poker Hand #RC3141668185: Hold'em No Limit ($0.05/$0.1) - 2024/12/12 12:37:40
Table 'RushAndCash22313445' 6-max Seat #1 is the button
Seat 1: Hero ($10 in chips)
Seat 2: e4fc8b12 ($11.14 in chips)
Seat 3: b8ef2786 ($11.04 in chips)
Seat 4: 844091a0 ($10.52 in chips)
Seat 5: 66793bbe ($5.75 in chips)
Seat 6: 84c34548 ($11.54 in chips)
e4fc8b12: posts small blind $0.05
b8ef2786: posts big blind $0.1
*** HOLE CARDS ***
Dealt to Hero [8c 3h]
Dealt to e4fc8b12 
Dealt to b8ef2786 
Dealt to 844091a0 
Dealt to 66793bbe 
Dealt to 84c34548 
844091a0: folds
66793bbe: folds
84c34548: folds
Hero: folds
e4fc8b12: folds
Uncalled bet ($0.05) returned to b8ef2786
*** SHOWDOWN ***
b8ef2786 collected $0.1 from pot
*** SUMMARY ***
Total pot $0.1 | Rake $0 | Jackpot $0 | Bingo $0 | Fortune $0 | Tax $0
Seat 1: Hero (button) folded before Flop (didn't bet)
Seat 2: e4fc8b12 (small blind) folded before Flop
Seat 3: b8ef2786 (big blind) collected ($0.1)
Seat 4: 844091a0 folded before Flop (didn't bet)
Seat 5: 66793bbe folded before Flop (didn't bet)
Seat 6: 84c34548 folded before Flop (didn't bet)


Poker Hand #RC3141668151: Hold'em No Limit ($0.05/$0.1) - 2024/12/12 12:37:31
Table 'RushAndCash22313411' 6-max Seat #1 is the button
Seat 1: 5b14e7af ($21.65 in chips)
Seat 2: Hero ($10 in chips)
Seat 3: 3b9132dc ($10.45 in chips)
Seat 4: e9510edc ($12 in chips)
Seat 5: 214c8b65 ($13.32 in chips)
Seat 6: b9a180bb ($10.49 in chips)
Hero: posts small blind $0.05
3b9132dc: posts big blind $0.1
*** HOLE CARDS ***
Dealt to 5b14e7af 
Dealt to Hero [Td 5d]
Dealt to 3b9132dc 
Dealt to e9510edc 
Dealt to 214c8b65 
Dealt to b9a180bb 
e9510edc: folds
214c8b65: folds
b9a180bb: folds
5b14e7af: folds
Hero: folds
Uncalled bet ($0.05) returned to 3b9132dc
*** SHOWDOWN ***
3b9132dc collected $0.1 from pot
*** SUMMARY ***
Total pot $0.1 | Rake $0 | Jackpot $0 | Bingo $0 | Fortune $0 | Tax $0
Seat 1: 5b14e7af (button) folded before Flop (didn't bet)
Seat 2: Hero (small blind) folded before Flop
Seat 3: 3b9132dc (big blind) collected ($0.1)
Seat 4: e9510edc folded before Flop (didn't bet)
Seat 5: 214c8b65 folded before Flop (didn't bet)
Seat 6: b9a180bb folded before Flop (didn't bet)


Poker Hand #RC3141668096: Hold'em No Limit ($0.05/$0.1) - 2024/12/12 12:37:18
Table 'RushAndCash22313356' 6-max Seat #1 is the button
Seat 1: 3e399c74 ($10 in chips)
Seat 2: 84c13d8 ($27.78 in chips)
Seat 3: Hero ($10 in chips)
Seat 4: ea8b094 ($7 in chips)
Seat 5: 6053096e ($10 in chips)
Seat 6: 8cfa2620 ($10.64 in chips)
84c13d8: posts small blind $0.05
Hero: posts big blind $0.1
*** HOLE CARDS ***
Dealt to 3e399c74 
Dealt to 84c13d8 
Dealt to Hero [3c Jc]
Dealt to ea8b094 
Dealt to 6053096e 
Dealt to 8cfa2620 
ea8b094: folds
6053096e: raises $0.15 to $0.25
8cfa2620: folds
3e399c74: folds
84c13d8: raises $0.6 to $0.85
Hero: folds
6053096e: folds
Uncalled bet ($0.6) returned to 84c13d8
*** SHOWDOWN ***
84c13d8 collected $0.57 from pot
*** SUMMARY ***
Total pot $0.6 | Rake $0.03 | Jackpot $0 | Bingo $0 | Fortune $0 | Tax $0
Seat 1: 3e399c74 (button) folded before Flop (didn't bet)
Seat 2: 84c13d8 (small blind) collected ($0.57)
Seat 3: Hero (big blind) folded before Flop
Seat 4: ea8b094 folded before Flop (didn't bet)
Seat 5: 6053096e folded before Flop
Seat 6: 8cfa2620 folded before Flop (didn't bet)


Poker Hand #RC3141668083: Hold'em No Limit ($0.05/$0.1) - 2024/12/12 12:37:15
Table 'RushAndCash22313343' 6-max Seat #1 is the button
Seat 1: e9510edc ($12 in chips)
Seat 2: a8e8a7b5 ($12.1 in chips)
Seat 3: bb6bf3e8 ($8.17 in chips)
Seat 4: ca2bcc9f ($7 in chips)
Seat 5: 2e735933 ($10 in chips)
Seat 6: Hero ($10 in chips)
a8e8a7b5: posts small blind $0.05
bb6bf3e8: posts big blind $0.1
*** HOLE CARDS ***
Dealt to e9510edc 
Dealt to a8e8a7b5 
Dealt to bb6bf3e8 
Dealt to ca2bcc9f 
Dealt to 2e735933 
Dealt to Hero [8c 4h]
ca2bcc9f: folds
2e735933: folds
Hero: folds
e9510edc: folds
a8e8a7b5: raises $0.15 to $0.25
bb6bf3e8: folds
Uncalled bet ($0.15) returned to a8e8a7b5
*** SHOWDOWN ***
a8e8a7b5 collected $0.2 from pot
*** SUMMARY ***
Total pot $0.2 | Rake $0 | Jackpot $0 | Bingo $0 | Fortune $0 | Tax $0
Seat 1: e9510edc (button) folded before Flop (didn't bet)
Seat 2: a8e8a7b5 (small blind) collected ($0.2)
Seat 3: bb6bf3e8 (big blind) folded before Flop
Seat 4: ca2bcc9f folded before Flop (didn't bet)
Seat 5: 2e735933 folded before Flop (didn't bet)
Seat 6: Hero folded before Flop (didn't bet)


Poker Hand #RC3141668056: Hold'em No Limit ($0.05/$0.1) - 2024/12/12 12:37:08
Table 'RushAndCash22313316' 6-max Seat #1 is the button
Seat 1: 378a5790 ($15.61 in chips)
Seat 2: 1d37642 ($8.85 in chips)
Seat 3: f0c37558 ($12.04 in chips)
Seat 4: Hero ($10 in chips)
Seat 5: 7829feb5 ($10.24 in chips)
Seat 6: be885022 ($11.27 in chips)
1d37642: posts small blind $0.05
f0c37558: posts big blind $0.1
*** HOLE CARDS ***
Dealt to 378a5790 
Dealt to 1d37642 
Dealt to f0c37558 
Dealt to Hero [7c 5c]
Dealt to 7829feb5 
Dealt to be885022 
Hero: folds
7829feb5: folds
be885022: raises $0.13 to $0.23
378a5790: calls $0.23
1d37642: raises $0.79 to $1.02
f0c37558: folds
be885022: folds
378a5790: folds
Uncalled bet ($0.79) returned to 1d37642
*** SHOWDOWN ***
1d37642 collected $0.75 from pot
*** SUMMARY ***
Total pot $0.79 | Rake $0.04 | Jackpot $0 | Bingo $0 | Fortune $0 | Tax $0
Seat 1: 378a5790 (button) folded before Flop
Seat 2: 1d37642 (small blind) collected ($0.75)
Seat 3: f0c37558 (big blind) folded before Flop
Seat 4: Hero folded before Flop (didn't bet)
Seat 5: 7829feb5 folded before Flop (didn't bet)
Seat 6: be885022 folded before Flop


Poker Hand #RC3141668042: Hold'em No Limit ($0.05/$0.1) - 2024/12/12 12:37:05
Table 'RushAndCash22313302' 6-max Seat #1 is the button
Seat 1: d9ccf407 ($21.13 in chips)
Seat 2: e0a6d1b8 ($10.87 in chips)
Seat 3: 79af8002 ($10.08 in chips)
Seat 4: Hero ($10 in chips)
Seat 5: d8e077e9 ($34.56 in chips)
Seat 6: f500aed7 ($10.57 in chips)
e0a6d1b8: posts small blind $0.05
79af8002: posts big blind $0.1
*** HOLE CARDS ***
Dealt to d9ccf407 
Dealt to e0a6d1b8 
Dealt to 79af8002 
Dealt to Hero [Qh Tc]
Dealt to d8e077e9 
Dealt to f500aed7 
Hero: folds
d8e077e9: folds
f500aed7: folds
d9ccf407: raises $0.1 to $0.2
e0a6d1b8: raises $0.5 to $0.7
79af8002: folds
d9ccf407: raises $1.7 to $2.4
e0a6d1b8: folds
Uncalled bet ($1.7) returned to d9ccf407
*** SHOWDOWN ***
d9ccf407 collected $1.43 from pot
*** SUMMARY ***
Total pot $1.5 | Rake $0.07 | Jackpot $0 | Bingo $0 | Fortune $0 | Tax $0
Seat 1: d9ccf407 (button) collected ($1.43)
Seat 2: e0a6d1b8 (small blind) folded before Flop
Seat 3: 79af8002 (big blind) folded before Flop
Seat 4: Hero folded before Flop (didn't bet)
Seat 5: d8e077e9 folded before Flop (didn't bet)
Seat 6: f500aed7 folded before Flop (didn't bet)


Poker Hand #RC3141668030: Hold'em No Limit ($0.05/$0.1) - 2024/12/12 12:37:02
Table 'RushAndCash22313290' 6-max Seat #1 is the button
Seat 1: f5628a04 ($10.15 in chips)
Seat 2: c46a27c1 ($10 in chips)
Seat 3: 9b7e8bd3 ($15.27 in chips)
Seat 4: f7ecedd7 ($12.42 in chips)
Seat 5: b4bc8071 ($10.33 in chips)
Seat 6: Hero ($10 in chips)
c46a27c1: posts small blind $0.05
9b7e8bd3: posts big blind $0.1
*** HOLE CARDS ***
Dealt to f5628a04 
Dealt to c46a27c1 
Dealt to 9b7e8bd3 
Dealt to f7ecedd7 
Dealt to b4bc8071 
Dealt to Hero [3s Th]
f7ecedd7: folds
b4bc8071: raises $0.1 to $0.2
Hero: folds
f5628a04: folds
c46a27c1: folds
9b7e8bd3: raises $0.34 to $0.54
b4bc8071: calls $0.34
*** FLOP *** [8d 7c 2s]
9b7e8bd3: bets $0.85
b4bc8071: calls $0.85
*** TURN *** [8d 7c 2s] [Kd]
9b7e8bd3: bets $1.42
b4bc8071: calls $1.42
*** RIVER *** [8d 7c 2s Kd] [Kh]
9b7e8bd3: checks
b4bc8071: bets $7.52 and is all-in
9b7e8bd3: folds
Uncalled bet ($7.52) returned to b4bc8071
*** SHOWDOWN ***
b4bc8071 collected $5.25 from pot
*** SUMMARY ***
Total pot $5.67 | Rake $0.27 | Jackpot $0.15 | Bingo $0 | Fortune $0 | Tax $0
Board [8d 7c 2s Kd Kh]
Seat 1: f5628a04 (button) folded before Flop (didn't bet)
Seat 2: c46a27c1 (small blind) folded before Flop
Seat 3: 9b7e8bd3 (big blind) folded on the River
Seat 4: f7ecedd7 folded before Flop (didn't bet)
Seat 5: b4bc8071 won ($5.25)
Seat 6: Hero folded before Flop (didn't bet)


Poker Hand #RC3141667845: Hold'em No Limit ($0.05/$0.1) - 2024/12/12 12:36:18
Table 'RushAndCash22313105' 6-max Seat #1 is the button
Seat 1: Hero ($10 in chips)
Seat 2: 73e84fa ($26.02 in chips)
Seat 3: 1fe7df8c ($11.04 in chips)
Seat 4: f2b49ec ($8.63 in chips)
Seat 5: e1069f5c ($9.3 in chips)
Seat 6: 1d37642 ($8.95 in chips)
73e84fa: posts small blind $0.05
1fe7df8c: posts big blind $0.1
*** HOLE CARDS ***
Dealt to Hero [Td Qs]
Dealt to 73e84fa 
Dealt to 1fe7df8c 
Dealt to f2b49ec 
Dealt to e1069f5c 
Dealt to 1d37642 
f2b49ec: folds
e1069f5c: folds
1d37642: folds
Hero: raises $0.15 to $0.25
73e84fa: folds
1fe7df8c: calls $0.15
*** FLOP *** [Jh Ac 5h]
1fe7df8c: checks
Hero: bets $0.14
1fe7df8c: calls $0.14
*** TURN *** [Jh Ac 5h] [5d]
1fe7df8c: checks
Hero: checks
*** RIVER *** [Jh Ac 5h 5d] [7s]
1fe7df8c: bets $0.63
Hero: folds
Uncalled bet ($0.63) returned to 1fe7df8c
*** SHOWDOWN ***
1fe7df8c collected $0.79 from pot
*** SUMMARY ***
Total pot $0.83 | Rake $0.04 | Jackpot $0 | Bingo $0 | Fortune $0 | Tax $0
Board [Jh Ac 5h 5d 7s]
Seat 1: Hero (button) folded on the River
Seat 2: 73e84fa (small blind) folded before Flop
Seat 3: 1fe7df8c (big blind) won ($0.79)
Seat 4: f2b49ec folded before Flop (didn't bet)
Seat 5: e1069f5c folded before Flop (didn't bet)
Seat 6: 1d37642 folded before Flop (didn't bet)


Poker Hand #RC3141667823: Hold'em No Limit ($0.05/$0.1) - 2024/12/12 12:36:13
Table 'RushAndCash22313083' 6-max Seat #1 is the button
Seat 1: c2b852ae ($11.6 in chips)
Seat 2: Hero ($10 in chips)
Seat 3: c6f4a662 ($10.62 in chips)
Seat 4: 2db5d1cb ($10.25 in chips)
Seat 5: b37e3efe ($15.91 in chips)
Seat 6: c86d72c6 ($10.9 in chips)
Hero: posts small blind $0.05
c6f4a662: posts big blind $0.1
*** HOLE CARDS ***
Dealt to c2b852ae 
Dealt to Hero [6d 3s]
Dealt to c6f4a662 
Dealt to 2db5d1cb 
Dealt to b37e3efe 
Dealt to c86d72c6 
2db5d1cb: raises $0.1 to $0.2
b37e3efe: folds
c86d72c6: calls $0.2
c2b852ae: folds
Hero: folds
c6f4a662: calls $0.1
*** FLOP *** [Kd 9h 8h]
c6f4a662: bets $0.22
2db5d1cb: folds
c86d72c6: calls $0.22
*** TURN *** [Kd 9h 8h] [Ks]
c6f4a662: checks
c86d72c6: checks
*** RIVER *** [Kd 9h 8h Ks] [Qs]
c6f4a662: checks
c86d72c6: checks
c6f4a662: shows [Kc 9s] (Kings Full over Nines)
c86d72c6: shows [8s Tc] (Pair of Kings and Pair of Eights)
*** SHOWDOWN ***
c6f4a662 collected $1.04 from pot
*** SUMMARY ***
Total pot $1.09 | Rake $0.05 | Jackpot $0 | Bingo $0 | Fortune $0 | Tax $0
Board [Kd 9h 8h Ks Qs]
Seat 1: c2b852ae (button) folded before Flop (didn't bet)
Seat 2: Hero (small blind) folded before Flop
Seat 3: c6f4a662 (big blind) showed [Kc 9s] and won ($1.04) with Kings Full over Nines
Seat 4: 2db5d1cb folded on the Flop
Seat 5: b37e3efe folded before Flop (didn't bet)
Seat 6: c86d72c6 showed [8s Tc] and lost with Pair of Kings and Pair of Eights


Poker Hand #RC3141667780: Hold'em No Limit ($0.05/$0.1) - 2024/12/12 12:36:04
Table 'RushAndCash22313040' 6-max Seat #1 is the button
Seat 1: c4d674fe ($10.11 in chips)
Seat 2: 3f7822ab ($15.21 in chips)
Seat 3: Hero ($10 in chips)
Seat 4: 6416ac56 ($20.32 in chips)
Seat 5: 48f3df37 ($22.78 in chips)
Seat 6: c8e1bfcc ($9.9 in chips)
3f7822ab: posts small blind $0.05
Hero: posts big blind $0.1
*** HOLE CARDS ***
Dealt to c4d674fe 
Dealt to 3f7822ab 
Dealt to Hero [2c 4s]
Dealt to 6416ac56 
Dealt to 48f3df37 
Dealt to c8e1bfcc 
6416ac56: folds
48f3df37: folds
c8e1bfcc: folds
c4d674fe: raises $0.12 to $0.22
3f7822ab: folds
Hero: folds
Uncalled bet ($0.12) returned to c4d674fe
*** SHOWDOWN ***
c4d674fe collected $0.25 from pot
*** SUMMARY ***
Total pot $0.25 | Rake $0 | Jackpot $0 | Bingo $0 | Fortune $0 | Tax $0
Seat 1: c4d674fe (button) collected ($0.25)
Seat 2: 3f7822ab (small blind) folded before Flop
Seat 3: Hero (big blind) folded before Flop
Seat 4: 6416ac56 folded before Flop (didn't bet)
Seat 5: 48f3df37 folded before Flop (didn't bet)
Seat 6: c8e1bfcc folded before Flop (didn't bet)


