Poker Hand #RC3141728597: Hold'em No Limit ($0.05/$0.1) - 2024/12/12 13:20:18
Table 'RushAndCash22323857' 6-max Seat #1 is the button
Seat 1: 48f3df37 ($19.63 in chips)
Seat 2: 558d330b ($10.12 in chips)
Seat 3: Hero ($18.73 in chips)
Seat 4: f2b49ec ($8.19 in chips)
Seat 5: 2e3105a5 ($15.09 in chips)
Seat 6: 727f0a35 ($13.75 in chips)
558d330b: posts small blind $0.05
Hero: posts big blind $0.1
*** HOLE CARDS ***
Dealt to 48f3df37 
Dealt to 558d330b 
Dealt to Hero [4s 9c]
Dealt to f2b49ec 
Dealt to 2e3105a5 
Dealt to 727f0a35 
f2b49ec: folds
2e3105a5: folds
727f0a35: folds
48f3df37: folds
558d330b: folds
Uncalled bet ($0.05) returned to Hero
*** SHOWDOWN ***
Hero collected $0.1 from pot
*** SUMMARY ***
Total pot $0.1 | Rake $0 | Jackpot $0 | Bingo $0 | Fortune $0 | Tax $0
Seat 1: 48f3df37 (button) folded before Flop (didn't bet)
Seat 2: 558d330b (small blind) folded before Flop
Seat 3: Hero (big blind) collected ($0.1)
Seat 4: f2b49ec folded before Flop (didn't bet)
Seat 5: 2e3105a5 folded before Flop (didn't bet)
Seat 6: 727f0a35 folded before Flop (didn't bet)


Poker Hand #RC3141728582: Hold'em No Limit ($0.05/$0.1) - 2024/12/12 13:20:15
Table 'RushAndCash22323842' 6-max Seat #1 is the button
Seat 1: 464eebcb ($10.21 in chips)
Seat 2: Hero ($18.78 in chips)
Seat 3: 4859226e ($8.89 in chips)
Seat 4: f2b49ec ($8.19 in chips)
Seat 5: cc8462b1 ($14.47 in chips)
Seat 6: d6b17ac7 ($10 in chips)
Hero: posts small blind $0.05
4859226e: posts big blind $0.1
*** HOLE CARDS ***
Dealt to 464eebcb 
Dealt to Hero [Ad 4s]
Dealt to 4859226e 
Dealt to f2b49ec 
Dealt to cc8462b1 
Dealt to d6b17ac7 
f2b49ec: folds
cc8462b1: folds
d6b17ac7: folds
464eebcb: folds
Hero: folds
Uncalled bet ($0.05) returned to 4859226e
*** SHOWDOWN ***
4859226e collected $0.1 from pot
*** SUMMARY ***
Total pot $0.1 | Rake $0 | Jackpot $0 | Bingo $0 | Fortune $0 | Tax $0
Seat 1: 464eebcb (button) folded before Flop (didn't bet)
Seat 2: Hero (small blind) folded before Flop
Seat 3: 4859226e (big blind) collected ($0.1)
Seat 4: f2b49ec folded before Flop (didn't bet)
Seat 5: cc8462b1 folded before Flop (didn't bet)
Seat 6: d6b17ac7 folded before Flop (didn't bet)


Poker Hand #RC3141728567: Hold'em No Limit ($0.05/$0.1) - 2024/12/12 13:20:11
Table 'RushAndCash22323827' 6-max Seat #1 is the button
Seat 1: b8e03e64 ($10.25 in chips)
Seat 2: 48f3df37 ($19.68 in chips)
Seat 3: 2a6446ed ($14.68 in chips)
Seat 4: fa56d9ad ($8.14 in chips)
Seat 5: a3d9ddb9 ($10 in chips)
Seat 6: Hero ($18.78 in chips)
48f3df37: posts small blind $0.05
2a6446ed: posts big blind $0.1
*** HOLE CARDS ***
Dealt to b8e03e64 
Dealt to 48f3df37 
Dealt to 2a6446ed 
Dealt to fa56d9ad 
Dealt to a3d9ddb9 
Dealt to Hero [8s Kc]
fa56d9ad: raises $0.2 to $0.3
a3d9ddb9: folds
Hero: folds
b8e03e64: folds
48f3df37: folds
2a6446ed: folds
Uncalled bet ($0.2) returned to fa56d9ad
*** SHOWDOWN ***
fa56d9ad collected $0.25 from pot
*** SUMMARY ***
Total pot $0.25 | Rake $0 | Jackpot $0 | Bingo $0 | Fortune $0 | Tax $0
Seat 1: b8e03e64 (button) folded before Flop (didn't bet)
Seat 2: 48f3df37 (small blind) folded before Flop
Seat 3: 2a6446ed (big blind) folded before Flop
Seat 4: fa56d9ad collected ($0.25)
Seat 5: a3d9ddb9 folded before Flop (didn't bet)
Seat 6: Hero folded before Flop (didn't bet)


Poker Hand #RC3141728542: Hold'em No Limit ($0.05/$0.1) - 2024/12/12 13:20:06
Table 'RushAndCash22323802' 6-max Seat #1 is the button
Seat 1: 85c2770a ($10 in chips)
Seat 2: 83a198b3 ($10 in chips)
Seat 3: 8fc49c26 ($45.54 in chips)
Seat 4: 6ca1d23f ($10 in chips)
Seat 5: Hero ($18.78 in chips)
Seat 6: 78a7e3b4 ($10.51 in chips)
83a198b3: posts small blind $0.05
8fc49c26: posts big blind $0.1
*** HOLE CARDS ***
Dealt to 85c2770a 
Dealt to 83a198b3 
Dealt to 8fc49c26 
Dealt to 6ca1d23f 
Dealt to Hero [4h 4d]
Dealt to 78a7e3b4 
6ca1d23f: folds
Hero: folds
78a7e3b4: raises $0.14 to $0.24
85c2770a: folds
83a198b3: folds
8fc49c26: folds
Uncalled bet ($0.14) returned to 78a7e3b4
*** SHOWDOWN ***
78a7e3b4 collected $0.25 from pot
*** SUMMARY ***
Total pot $0.25 | Rake $0 | Jackpot $0 | Bingo $0 | Fortune $0 | Tax $0
Seat 1: 85c2770a (button) folded before Flop (didn't bet)
Seat 2: 83a198b3 (small blind) folded before Flop
Seat 3: 8fc49c26 (big blind) folded before Flop
Seat 4: 6ca1d23f folded before Flop (didn't bet)
Seat 5: Hero folded before Flop (didn't bet)
Seat 6: 78a7e3b4 collected ($0.25)


Poker Hand #RC3141728526: Hold'em No Limit ($0.05/$0.1) - 2024/12/12 13:20:02
Table 'RushAndCash22323786' 6-max Seat #1 is the button
Seat 1: Hero ($18.78 in chips)
Seat 2: af0fe6b0 ($12.26 in chips)
Seat 3: fe38852f ($14.81 in chips)
Seat 4: 78a7e3b4 ($10.51 in chips)
Seat 5: 40e145e5 ($6.21 in chips)
Seat 6: 316b7313 ($11.65 in chips)
af0fe6b0: posts small blind $0.05
fe38852f: posts big blind $0.1
*** HOLE CARDS ***
Dealt to Hero [4s 7c]
Dealt to af0fe6b0 
Dealt to fe38852f 
Dealt to 78a7e3b4 
Dealt to 40e145e5 
Dealt to 316b7313 
78a7e3b4: folds
40e145e5: folds
316b7313: folds
Hero: folds
af0fe6b0: raises $0.2 to $0.3
fe38852f: folds
Uncalled bet ($0.2) returned to af0fe6b0
*** SHOWDOWN ***
af0fe6b0 collected $0.2 from pot
*** SUMMARY ***
Total pot $0.2 | Rake $0 | Jackpot $0 | Bingo $0 | Fortune $0 | Tax $0
Seat 1: Hero (button) folded before Flop (didn't bet)
Seat 2: af0fe6b0 (small blind) collected ($0.2)
Seat 3: fe38852f (big blind) folded before Flop
Seat 4: 78a7e3b4 folded before Flop (didn't bet)
Seat 5: 40e145e5 folded before Flop (didn't bet)
Seat 6: 316b7313 folded before Flop (didn't bet)


Poker Hand #RC3141728508: Hold'em No Limit ($0.05/$0.1) - 2024/12/12 13:19:59
Table 'RushAndCash22323768' 6-max Seat #1 is the button
Seat 1: 1a8ef95a ($10.41 in chips)
Seat 2: c1314f29 ($10 in chips)
Seat 3: 639a9874 ($18.54 in chips)
Seat 4: 48f3df37 ($19.63 in chips)
Seat 5: Hero ($18.78 in chips)
Seat 6: fe38852f ($14.81 in chips)
c1314f29: posts small blind $0.05
639a9874: posts big blind $0.1
*** HOLE CARDS ***
Dealt to 1a8ef95a 
Dealt to c1314f29 
Dealt to 639a9874 
Dealt to 48f3df37 
Dealt to Hero [5h 8s]
Dealt to fe38852f 
48f3df37: folds
Hero: folds
fe38852f: folds
1a8ef95a: folds
c1314f29: raises $0.1 to $0.2
639a9874: raises $0.8 to $1
c1314f29: folds
Uncalled bet ($0.8) returned to 639a9874
*** SHOWDOWN ***
639a9874 collected $0.38 from pot
*** SUMMARY ***
Total pot $0.4 | Rake $0.02 | Jackpot $0 | Bingo $0 | Fortune $0 | Tax $0
Seat 1: 1a8ef95a (button) folded before Flop (didn't bet)
Seat 2: c1314f29 (small blind) folded before Flop
Seat 3: 639a9874 (big blind) collected ($0.38)
Seat 4: 48f3df37 folded before Flop (didn't bet)
Seat 5: Hero folded before Flop (didn't bet)
Seat 6: fe38852f folded before Flop (didn't bet)


Poker Hand #RC3141728480: Hold'em No Limit ($0.05/$0.1) - 2024/12/12 13:19:54
Table 'RushAndCash22323740' 6-max Seat #1 is the button
Seat 1: 73df44d1 ($10 in chips)
Seat 2: Hero ($18.83 in chips)
Seat 3: 6c4ba3fb ($14.49 in chips)
Seat 4: 393dfd41 ($9 in chips)
Seat 5: 44a078c0 ($19.39 in chips)
Seat 6: f564c212 ($11.11 in chips)
Hero: posts small blind $0.05
6c4ba3fb: posts big blind $0.1
*** HOLE CARDS ***
Dealt to 73df44d1 
Dealt to Hero [6c As]
Dealt to 6c4ba3fb 
Dealt to 393dfd41 
Dealt to 44a078c0 
Dealt to f564c212 
393dfd41: folds
44a078c0: folds
f564c212: folds
73df44d1: folds
Hero: folds
Uncalled bet ($0.05) returned to 6c4ba3fb
*** SHOWDOWN ***
6c4ba3fb collected $0.1 from pot
*** SUMMARY ***
Total pot $0.1 | Rake $0 | Jackpot $0 | Bingo $0 | Fortune $0 | Tax $0
Seat 1: 73df44d1 (button) folded before Flop (didn't bet)
Seat 2: Hero (small blind) folded before Flop
Seat 3: 6c4ba3fb (big blind) collected ($0.1)
Seat 4: 393dfd41 folded before Flop (didn't bet)
Seat 5: 44a078c0 folded before Flop (didn't bet)
Seat 6: f564c212 folded before Flop (didn't bet)


Poker Hand #RC3141728462: Hold'em No Limit ($0.05/$0.1) - 2024/12/12 13:19:50
Table 'RushAndCash22323722' 6-max Seat #1 is the button
Seat 1: Hero ($18.83 in chips)
Seat 2: 58381e93 ($10 in chips)
Seat 3: b614d7f1 ($12.11 in chips)
Seat 4: af2d4efe ($9.64 in chips)
Seat 5: 1a8330b3 ($10.18 in chips)
Seat 6: f564c212 ($11.11 in chips)
58381e93: posts small blind $0.05
b614d7f1: posts big blind $0.1
*** HOLE CARDS ***
Dealt to Hero [Th 6d]
Dealt to 58381e93 
Dealt to b614d7f1 
Dealt to af2d4efe 
Dealt to 1a8330b3 
Dealt to f564c212 
af2d4efe: folds
1a8330b3: folds
f564c212: folds
Hero: folds
58381e93: folds
Uncalled bet ($0.05) returned to b614d7f1
*** SHOWDOWN ***
b614d7f1 collected $0.1 from pot
*** SUMMARY ***
Total pot $0.1 | Rake $0 | Jackpot $0 | Bingo $0 | Fortune $0 | Tax $0
Seat 1: Hero (button) folded before Flop (didn't bet)
Seat 2: 58381e93 (small blind) folded before Flop
Seat 3: b614d7f1 (big blind) collected ($0.1)
Seat 4: af2d4efe folded before Flop (didn't bet)
Seat 5: 1a8330b3 folded before Flop (didn't bet)
Seat 6: f564c212 folded before Flop (didn't bet)


Poker Hand #RC3141728394: Hold'em No Limit ($0.05/$0.1) - 2024/12/12 13:19:36
Table 'RushAndCash22323654' 6-max Seat #1 is the button
Seat 1: cdee25d4 ($11.09 in chips)
Seat 2: 7f65d70 ($10.75 in chips)
Seat 3: Hero ($18.93 in chips)
Seat 4: 2a5608d3 ($4.6 in chips)
Seat 5: 538ab077 ($11.08 in chips)
Seat 6: c6999b53 ($4.15 in chips)
7f65d70: posts small blind $0.05
Hero: posts big blind $0.1
*** HOLE CARDS ***
Dealt to cdee25d4 
Dealt to 7f65d70 
Dealt to Hero [5s Qh]
Dealt to 2a5608d3 
Dealt to 538ab077 
Dealt to c6999b53 
2a5608d3: folds
538ab077: folds
c6999b53: folds
cdee25d4: folds
7f65d70: raises $0.18 to $0.28
Hero: folds
Uncalled bet ($0.18) returned to 7f65d70
*** SHOWDOWN ***
7f65d70 collected $0.2 from pot
*** SUMMARY ***
Total pot $0.2 | Rake $0 | Jackpot $0 | Bingo $0 | Fortune $0 | Tax $0
Seat 1: cdee25d4 (button) folded before Flop (didn't bet)
Seat 2: 7f65d70 (small blind) collected ($0.2)
Seat 3: Hero (big blind) folded before Flop
Seat 4: 2a5608d3 folded before Flop (didn't bet)
Seat 5: 538ab077 folded before Flop (didn't bet)
Seat 6: c6999b53 folded before Flop (didn't bet)


Poker Hand #RC3141728378: Hold'em No Limit ($0.05/$0.1) - 2024/12/12 13:19:33
Table 'RushAndCash22323638' 6-max Seat #1 is the button
Seat 1: 2a5608d3 ($4.6 in chips)
Seat 2: 7ec40c0d ($20.18 in chips)
Seat 3: 175b201a ($4.11 in chips)
Seat 4: ffd84756 ($11.24 in chips)
Seat 5: c1314f29 ($10 in chips)
Seat 6: Hero ($18.93 in chips)
7ec40c0d: posts small blind $0.05
175b201a: posts big blind $0.1
*** HOLE CARDS ***
Dealt to 2a5608d3 
Dealt to 7ec40c0d 
Dealt to 175b201a 
Dealt to ffd84756 
Dealt to c1314f29 
Dealt to Hero [Kh 2s]
ffd84756: folds
c1314f29: folds
Hero: folds
2a5608d3: folds
7ec40c0d: folds
Uncalled bet ($0.05) returned to 175b201a
*** SHOWDOWN ***
175b201a collected $0.1 from pot
*** SUMMARY ***
Total pot $0.1 | Rake $0 | Jackpot $0 | Bingo $0 | Fortune $0 | Tax $0
Seat 1: 2a5608d3 (button) folded before Flop (didn't bet)
Seat 2: 7ec40c0d (small blind) folded before Flop
Seat 3: 175b201a (big blind) collected ($0.1)
Seat 4: ffd84756 folded before Flop (didn't bet)
Seat 5: c1314f29 folded before Flop (didn't bet)
Seat 6: Hero folded before Flop (didn't bet)


Poker Hand #RC3141728361: Hold'em No Limit ($0.05/$0.1) - 2024/12/12 13:19:29
Table 'RushAndCash22323621' 6-max Seat #1 is the button
Seat 1: a212e67a ($12.64 in chips)
Seat 2: 35c03ff2 ($13.89 in chips)
Seat 3: 6dcb955a ($11.6 in chips)
Seat 4: 65bfb346 ($36.59 in chips)
Seat 5: 6b0057b1 ($10.73 in chips)
Seat 6: Hero ($18.93 in chips)
35c03ff2: posts small blind $0.05
6dcb955a: posts big blind $0.1
*** HOLE CARDS ***
Dealt to a212e67a 
Dealt to 35c03ff2 
Dealt to 6dcb955a 
Dealt to 65bfb346 
Dealt to 6b0057b1 
Dealt to Hero [Ah 3d]
65bfb346: folds
6b0057b1: folds
Hero: folds
a212e67a: folds
35c03ff2: folds
Uncalled bet ($0.05) returned to 6dcb955a
*** SHOWDOWN ***
6dcb955a collected $0.1 from pot
*** SUMMARY ***
Total pot $0.1 | Rake $0 | Jackpot $0 | Bingo $0 | Fortune $0 | Tax $0
Seat 1: a212e67a (button) folded before Flop (didn't bet)
Seat 2: 35c03ff2 (small blind) folded before Flop
Seat 3: 6dcb955a (big blind) collected ($0.1)
Seat 4: 65bfb346 folded before Flop (didn't bet)
Seat 5: 6b0057b1 folded before Flop (didn't bet)
Seat 6: Hero folded before Flop (didn't bet)


Poker Hand #RC3141728269: Hold'em No Limit ($0.05/$0.1) - 2024/12/12 13:19:12
Table 'RushAndCash22323529' 6-max Seat #1 is the button
Seat 1: b8e03e64 ($10.05 in chips)
Seat 2: cb8dca6d ($11.51 in chips)
Seat 3: 44a078c0 ($19.54 in chips)
Seat 4: 506e90c1 ($10.28 in chips)
Seat 5: d09451f5 ($14.35 in chips)
Seat 6: Hero ($18.78 in chips)
cb8dca6d: posts small blind $0.05
44a078c0: posts big blind $0.1
*** HOLE CARDS ***
Dealt to b8e03e64 
Dealt to cb8dca6d 
Dealt to 44a078c0 
Dealt to 506e90c1 
Dealt to d09451f5 
Dealt to Hero [Qh Kd]
506e90c1: folds
d09451f5: folds
Hero: raises $0.15 to $0.25
b8e03e64: folds
cb8dca6d: folds
44a078c0: folds
Uncalled bet ($0.15) returned to Hero
*** SHOWDOWN ***
Hero collected $0.25 from pot
*** SUMMARY ***
Total pot $0.25 | Rake $0 | Jackpot $0 | Bingo $0 | Fortune $0 | Tax $0
Seat 1: b8e03e64 (button) folded before Flop (didn't bet)
Seat 2: cb8dca6d (small blind) folded before Flop
Seat 3: 44a078c0 (big blind) folded before Flop
Seat 4: 506e90c1 folded before Flop (didn't bet)
Seat 5: d09451f5 folded before Flop (didn't bet)
Seat 6: Hero collected ($0.25)


Poker Hand #RC3141728213: Hold'em No Limit ($0.05/$0.1) - 2024/12/12 13:18:57
Table 'RushAndCash22323473' 6-max Seat #1 is the button
Seat 1: 84c13d8 ($27.61 in chips)
Seat 2: Hero ($18.83 in chips)
Seat 3: ae2a34aa ($10.19 in chips)
Seat 4: e0a099ae ($12.96 in chips)
Seat 5: c6352e1c ($10 in chips)
Seat 6: 643f85e7 ($9.05 in chips)
Hero: posts small blind $0.05
ae2a34aa: posts big blind $0.1
*** HOLE CARDS ***
Dealt to 84c13d8 
Dealt to Hero [Tc Jc]
Dealt to ae2a34aa 
Dealt to e0a099ae 
Dealt to c6352e1c 
Dealt to 643f85e7 
e0a099ae: raises $0.1 to $0.2
c6352e1c: folds
643f85e7: folds
84c13d8: folds
Hero: folds
ae2a34aa: folds
Uncalled bet ($0.1) returned to e0a099ae
*** SHOWDOWN ***
e0a099ae collected $0.25 from pot
*** SUMMARY ***
Total pot $0.25 | Rake $0 | Jackpot $0 | Bingo $0 | Fortune $0 | Tax $0
Seat 1: 84c13d8 (button) folded before Flop (didn't bet)
Seat 2: Hero (small blind) folded before Flop
Seat 3: ae2a34aa (big blind) folded before Flop
Seat 4: e0a099ae collected ($0.25)
Seat 5: c6352e1c folded before Flop (didn't bet)
Seat 6: 643f85e7 folded before Flop (didn't bet)


Poker Hand #RC3141728194: Hold'em No Limit ($0.05/$0.1) - 2024/12/12 13:18:53
Table 'RushAndCash22323454' 6-max Seat #1 is the button
Seat 1: 149da8e2 ($11.17 in chips)
Seat 2: aa6f9192 ($10.15 in chips)
Seat 3: f3072dab ($4.84 in chips)
Seat 4: 838a6109 ($10.43 in chips)
Seat 5: Hero ($18.83 in chips)
Seat 6: fe1a2d61 ($10.28 in chips)
aa6f9192: posts small blind $0.05
f3072dab: posts big blind $0.1
*** HOLE CARDS ***
Dealt to 149da8e2 
Dealt to aa6f9192 
Dealt to f3072dab 
Dealt to 838a6109 
Dealt to Hero [Jd 7c]
Dealt to fe1a2d61 
838a6109: folds
Hero: folds
fe1a2d61: folds
149da8e2: raises $0.15 to $0.25
aa6f9192: raises $0.8 to $1.05
f3072dab: folds
149da8e2: folds
Uncalled bet ($0.8) returned to aa6f9192
*** SHOWDOWN ***
aa6f9192 collected $0.57 from pot
*** SUMMARY ***
Total pot $0.6 | Rake $0.03 | Jackpot $0 | Bingo $0 | Fortune $0 | Tax $0
Seat 1: 149da8e2 (button) folded before Flop
Seat 2: aa6f9192 (small blind) collected ($0.57)
Seat 3: f3072dab (big blind) folded before Flop
Seat 4: 838a6109 folded before Flop (didn't bet)
Seat 5: Hero folded before Flop (didn't bet)
Seat 6: fe1a2d61 folded before Flop (didn't bet)


Poker Hand #RC3141727901: Hold'em No Limit ($0.05/$0.1) - 2024/12/12 13:17:48
Table 'RushAndCash22323161' 6-max Seat #1 is the button
Seat 1: Hero ($19.27 in chips)
Seat 2: 4eb4d0d6 ($18.87 in chips)
Seat 3: 149da8e2 ($10.72 in chips)
Seat 4: f3e09586 ($10.15 in chips)
Seat 5: f564c212 ($11.72 in chips)
Seat 6: 88a9583f ($48.01 in chips)
4eb4d0d6: posts small blind $0.05
149da8e2: posts big blind $0.1
*** HOLE CARDS ***
Dealt to Hero [8h Kh]
Dealt to 4eb4d0d6 
Dealt to 149da8e2 
Dealt to f3e09586 
Dealt to f564c212 
Dealt to 88a9583f 
f3e09586: folds
f564c212: folds
88a9583f: folds
Hero: raises $0.15 to $0.25
4eb4d0d6: folds
149da8e2: calls $0.15
*** FLOP *** [As 4s 4d]
149da8e2: checks
Hero: checks
*** TURN *** [As 4s 4d] [3c]
149da8e2: checks
Hero: bets $0.19
149da8e2: calls $0.19
*** RIVER *** [As 4s 4d 3c] [8d]
149da8e2: checks
Hero: checks
149da8e2: shows [9d Ah] (Pair of Aces and Pair of Fours)
Hero: shows [8h Kh] (Pair of Eights and Pair of Fours)
*** SHOWDOWN ***
149da8e2 collected $0.89 from pot
*** SUMMARY ***
Total pot $0.93 | Rake $0.04 | Jackpot $0 | Bingo $0 | Fortune $0 | Tax $0
Board [As 4s 4d 3c 8d]
Seat 1: Hero (button) showed [8h Kh] and lost with Pair of Eights and Pair of Fours
Seat 2: 4eb4d0d6 (small blind) folded before Flop
Seat 3: 149da8e2 (big blind) showed [9d Ah] and won ($0.89) with Pair of Aces and Pair of Fours
Seat 4: f3e09586 folded before Flop (didn't bet)
Seat 5: f564c212 folded before Flop (didn't bet)
Seat 6: 88a9583f folded before Flop (didn't bet)


Poker Hand #RC3141727885: Hold'em No Limit ($0.05/$0.1) - 2024/12/12 13:17:44
Table 'RushAndCash22323145' 6-max Seat #1 is the button
Seat 1: 4eb4d0d6 ($18.87 in chips)
Seat 2: f564c212 ($11.77 in chips)
Seat 3: 51c5666 ($28.29 in chips)
Seat 4: Hero ($19.27 in chips)
Seat 5: 11a00985 ($19.94 in chips)
Seat 6: 2441c176 ($12.04 in chips)
f564c212: posts small blind $0.05
51c5666: posts big blind $0.1
*** HOLE CARDS ***
Dealt to 4eb4d0d6 
Dealt to f564c212 
Dealt to 51c5666 
Dealt to Hero [2h Qd]
Dealt to 11a00985 
Dealt to 2441c176 
Hero: folds
11a00985: folds
2441c176: folds
4eb4d0d6: folds
f564c212: folds
Uncalled bet ($0.05) returned to 51c5666
*** SHOWDOWN ***
51c5666 collected $0.1 from pot
*** SUMMARY ***
Total pot $0.1 | Rake $0 | Jackpot $0 | Bingo $0 | Fortune $0 | Tax $0
Seat 1: 4eb4d0d6 (button) folded before Flop (didn't bet)
Seat 2: f564c212 (small blind) folded before Flop
Seat 3: 51c5666 (big blind) collected ($0.1)
Seat 4: Hero folded before Flop (didn't bet)
Seat 5: 11a00985 folded before Flop (didn't bet)
Seat 6: 2441c176 folded before Flop (didn't bet)


Poker Hand #RC3141727844: Hold'em No Limit ($0.05/$0.1) - 2024/12/12 13:17:35
Table 'RushAndCash22323104' 6-max Seat #1 is the button
Seat 1: 3fb0fb21 ($20.6 in chips)
Seat 2: 88133657 ($10.52 in chips)
Seat 3: Hero ($19.22 in chips)
Seat 4: 1d094c87 ($10 in chips)
Seat 5: c113e767 ($5.98 in chips)
Seat 6: 316b7313 ($12.58 in chips)
88133657: posts small blind $0.05
Hero: posts big blind $0.1
*** HOLE CARDS ***
Dealt to 3fb0fb21 
Dealt to 88133657 
Dealt to Hero [8d 5d]
Dealt to 1d094c87 
Dealt to c113e767 
Dealt to 316b7313 
1d094c87: folds
c113e767: folds
316b7313: folds
3fb0fb21: folds
88133657: folds
Uncalled bet ($0.05) returned to Hero
*** SHOWDOWN ***
Hero collected $0.1 from pot
*** SUMMARY ***
Total pot $0.1 | Rake $0 | Jackpot $0 | Bingo $0 | Fortune $0 | Tax $0
Seat 1: 3fb0fb21 (button) folded before Flop (didn't bet)
Seat 2: 88133657 (small blind) folded before Flop
Seat 3: Hero (big blind) collected ($0.1)
Seat 4: 1d094c87 folded before Flop (didn't bet)
Seat 5: c113e767 folded before Flop (didn't bet)
Seat 6: 316b7313 folded before Flop (didn't bet)


Poker Hand #RC3141727829: Hold'em No Limit ($0.05/$0.1) - 2024/12/12 13:17:32
Table 'RushAndCash22323089' 6-max Seat #1 is the button
Seat 1: Hero ($19.22 in chips)
Seat 2: c113e767 ($6.03 in chips)
Seat 3: d6b17ac7 ($10.48 in chips)
Seat 4: e0a099ae ($13.31 in chips)
Seat 5: 944ad87a ($10.13 in chips)
Seat 6: 4e5c7119 ($14.86 in chips)
c113e767: posts small blind $0.05
d6b17ac7: posts big blind $0.1
*** HOLE CARDS ***
Dealt to Hero [9d 8c]
Dealt to c113e767 
Dealt to d6b17ac7 
Dealt to e0a099ae 
Dealt to 944ad87a 
Dealt to 4e5c7119 
e0a099ae: folds
944ad87a: raises $0.14 to $0.24
4e5c7119: folds
Hero: folds
c113e767: folds
d6b17ac7: calls $0.14
*** FLOP *** [2s As 5c]
d6b17ac7: checks
944ad87a: checks
*** TURN *** [2s As 5c] [9s]
d6b17ac7: checks
944ad87a: bets $0.19
d6b17ac7: folds
Uncalled bet ($0.19) returned to 944ad87a
*** SHOWDOWN ***
944ad87a collected $0.51 from pot
*** SUMMARY ***
Total pot $0.53 | Rake $0.02 | Jackpot $0 | Bingo $0 | Fortune $0 | Tax $0
Board [2s As 5c 9s]
Seat 1: Hero (button) folded before Flop (didn't bet)
Seat 2: c113e767 (small blind) folded before Flop
Seat 3: d6b17ac7 (big blind) folded on the Turn
Seat 4: e0a099ae folded before Flop (didn't bet)
Seat 5: 944ad87a won ($0.51)
Seat 6: 4e5c7119 folded before Flop (didn't bet)


Poker Hand #RC3141727814: Hold'em No Limit ($0.05/$0.1) - 2024/12/12 13:17:29
Table 'RushAndCash22323074' 6-max Seat #1 is the button
Seat 1: f3e09586 ($10 in chips)
Seat 2: Hero ($19.27 in chips)
Seat 3: cdee25d4 ($10.59 in chips)
Seat 4: 55251e59 ($19.26 in chips)
Seat 5: 91c44681 ($11.49 in chips)
Seat 6: 2852ea1c ($10.12 in chips)
Hero: posts small blind $0.05
cdee25d4: posts big blind $0.1
*** HOLE CARDS ***
Dealt to f3e09586 
Dealt to Hero [7s Jh]
Dealt to cdee25d4 
Dealt to 55251e59 
Dealt to 91c44681 
Dealt to 2852ea1c 
55251e59: folds
91c44681: folds
2852ea1c: raises $0.2 to $0.3
f3e09586: folds
Hero: folds
cdee25d4: calls $0.2
*** FLOP *** [Kh 2s 9d]
cdee25d4: checks
2852ea1c: bets $0.25
cdee25d4: calls $0.25
*** TURN *** [Kh 2s 9d] [5s]
cdee25d4: checks
2852ea1c: checks
*** RIVER *** [Kh 2s 9d 5s] [4h]
cdee25d4: bets $0.35
2852ea1c: folds
Uncalled bet ($0.35) returned to cdee25d4
*** SHOWDOWN ***
cdee25d4 collected $1.1 from pot
*** SUMMARY ***
Total pot $1.15 | Rake $0.05 | Jackpot $0 | Bingo $0 | Fortune $0 | Tax $0
Board [Kh 2s 9d 5s 4h]
Seat 1: f3e09586 (button) folded before Flop (didn't bet)
Seat 2: Hero (small blind) folded before Flop
Seat 3: cdee25d4 (big blind) won ($1.1)
Seat 4: 55251e59 folded before Flop (didn't bet)
Seat 5: 91c44681 folded before Flop (didn't bet)
Seat 6: 2852ea1c folded on the River


Poker Hand #RC3141727721: Hold'em No Limit ($0.05/$0.1) - 2024/12/12 13:17:10
Table 'RushAndCash22322981' 6-max Seat #1 is the button
Seat 1: a699d2de ($17.27 in chips)
Seat 2: 26077f2f ($10 in chips)
Seat 3: Hero ($19.37 in chips)
Seat 4: 4f5c5eb ($10 in chips)
Seat 5: 1dc34506 ($10.51 in chips)
Seat 6: 1677a3f4 ($13.94 in chips)
26077f2f: posts small blind $0.05
Hero: posts big blind $0.1
*** HOLE CARDS ***
Dealt to a699d2de 
Dealt to 26077f2f 
Dealt to Hero [9s Ts]
Dealt to 4f5c5eb 
Dealt to 1dc34506 
Dealt to 1677a3f4 
4f5c5eb: raises $0.14 to $0.24
1dc34506: folds
1677a3f4: calls $0.24
a699d2de: folds
26077f2f: raises $1.11 to $1.35
Hero: folds
4f5c5eb: folds
1677a3f4: folds
Uncalled bet ($1.11) returned to 26077f2f
*** SHOWDOWN ***
26077f2f collected $0.78 from pot
*** SUMMARY ***
Total pot $0.82 | Rake $0.04 | Jackpot $0 | Bingo $0 | Fortune $0 | Tax $0
Seat 1: a699d2de (button) folded before Flop (didn't bet)
Seat 2: 26077f2f (small blind) collected ($0.78)
Seat 3: Hero (big blind) folded before Flop
Seat 4: 4f5c5eb folded before Flop
Seat 5: 1dc34506 folded before Flop (didn't bet)
Seat 6: 1677a3f4 folded before Flop


Poker Hand #RC3141727704: Hold'em No Limit ($0.05/$0.1) - 2024/12/12 13:17:06
Table 'RushAndCash22322964' 6-max Seat #1 is the button
Seat 1: Hero ($19.37 in chips)
Seat 2: 2a5608d3 ($4.03 in chips)
Seat 3: 643f85e7 ($9.85 in chips)
Seat 4: a699d2de ($17.27 in chips)
Seat 5: 4f5c5eb ($10 in chips)
Seat 6: 26077f2f ($10 in chips)
2a5608d3: posts small blind $0.05
643f85e7: posts big blind $0.1
*** HOLE CARDS ***
Dealt to Hero [2s Kh]
Dealt to 2a5608d3 
Dealt to 643f85e7 
Dealt to a699d2de 
Dealt to 4f5c5eb 
Dealt to 26077f2f 
a699d2de: folds
4f5c5eb: folds
26077f2f: folds
Hero: folds
2a5608d3: raises $0.1 to $0.2
643f85e7: calls $0.1
*** FLOP *** [Qc 6c 8s]
2a5608d3: bets $0.2
643f85e7: calls $0.2
*** TURN *** [Qc 6c 8s] [Ah]
2a5608d3: checks
643f85e7: checks
*** RIVER *** [Qc 6c 8s Ah] [4h]
2a5608d3: checks
643f85e7: checks
2a5608d3: shows [Qh 3h] (Pair of Queens)
643f85e7: shows [7c 7s] (Pair of Sevens)
*** SHOWDOWN ***
2a5608d3 collected $0.76 from pot
*** SUMMARY ***
Total pot $0.8 | Rake $0.04 | Jackpot $0 | Bingo $0 | Fortune $0 | Tax $0
Board [Qc 6c 8s Ah 4h]
Seat 1: Hero (button) folded before Flop (didn't bet)
Seat 2: 2a5608d3 (small blind) showed [Qh 3h] and won ($0.76) with Pair of Queens
Seat 3: 643f85e7 (big blind) showed [7c 7s] and lost with Pair of Sevens
Seat 4: a699d2de folded before Flop (didn't bet)
Seat 5: 4f5c5eb folded before Flop (didn't bet)
Seat 6: 26077f2f folded before Flop (didn't bet)


Poker Hand #RC3141727688: Hold'em No Limit ($0.05/$0.1) - 2024/12/12 13:17:03
Table 'RushAndCash22322948' 6-max Seat #1 is the button
Seat 1: f44841fc ($12.31 in chips)
Seat 2: 40e145e5 ($9.9 in chips)
Seat 3: 1a8ef95a ($10.34 in chips)
Seat 4: 17b5b10 ($10 in chips)
Seat 5: Hero ($19.37 in chips)
Seat 6: 1d2dacdf ($10.19 in chips)
40e145e5: posts small blind $0.05
1a8ef95a: posts big blind $0.1
*** HOLE CARDS ***
Dealt to f44841fc 
Dealt to 40e145e5 
Dealt to 1a8ef95a 
Dealt to 17b5b10 
Dealt to Hero [Qd 7c]
Dealt to 1d2dacdf 
17b5b10: folds
Hero: folds
1d2dacdf: raises $0.15 to $0.25
f44841fc: folds
40e145e5: folds
1a8ef95a: folds
Uncalled bet ($0.15) returned to 1d2dacdf
*** SHOWDOWN ***
1d2dacdf collected $0.25 from pot
*** SUMMARY ***
Total pot $0.25 | Rake $0 | Jackpot $0 | Bingo $0 | Fortune $0 | Tax $0
Seat 1: f44841fc (button) folded before Flop (didn't bet)
Seat 2: 40e145e5 (small blind) folded before Flop
Seat 3: 1a8ef95a (big blind) folded before Flop
Seat 4: 17b5b10 folded before Flop (didn't bet)
Seat 5: Hero folded before Flop (didn't bet)
Seat 6: 1d2dacdf collected ($0.25)


Poker Hand #RC3141727655: Hold'em No Limit ($0.05/$0.1) - 2024/12/12 13:16:56
Table 'RushAndCash22322915' 6-max Seat #1 is the button
Seat 1: 6d63b808 ($10 in chips)
Seat 2: 88133657 ($10.52 in chips)
Seat 3: 593f64c7 ($7.45 in chips)
Seat 4: 22ee6f58 ($10 in chips)
Seat 5: ee394d0a ($11.33 in chips)
Seat 6: Hero ($19.37 in chips)
88133657: posts small blind $0.05
593f64c7: posts big blind $0.1
*** HOLE CARDS ***
Dealt to 6d63b808 
Dealt to 88133657 
Dealt to 593f64c7 
Dealt to 22ee6f58 
Dealt to ee394d0a 
Dealt to Hero [6s 4s]
22ee6f58: folds
ee394d0a: folds
Hero: folds
6d63b808: folds
88133657: raises $0.2 to $0.3
593f64c7: folds
Uncalled bet ($0.2) returned to 88133657
*** SHOWDOWN ***
88133657 collected $0.2 from pot
*** SUMMARY ***
Total pot $0.2 | Rake $0 | Jackpot $0 | Bingo $0 | Fortune $0 | Tax $0
Seat 1: 6d63b808 (button) folded before Flop (didn't bet)
Seat 2: 88133657 (small blind) collected ($0.2)
Seat 3: 593f64c7 (big blind) folded before Flop
Seat 4: 22ee6f58 folded before Flop (didn't bet)
Seat 5: ee394d0a folded before Flop (didn't bet)
Seat 6: Hero folded before Flop (didn't bet)


Poker Hand #RC3141727638: Hold'em No Limit ($0.05/$0.1) - 2024/12/12 13:16:53
Table 'RushAndCash22322898' 6-max Seat #1 is the button
Seat 1: cfe70ef2 ($11.85 in chips)
Seat 2: Hero ($19.42 in chips)
Seat 3: 2edfec7c ($9.65 in chips)
Seat 4: df82aa12 ($10.82 in chips)
Seat 5: ebfcde93 ($11.63 in chips)
Seat 6: 4de3c51 ($11.82 in chips)
Hero: posts small blind $0.05
2edfec7c: posts big blind $0.1
*** HOLE CARDS ***
Dealt to cfe70ef2 
Dealt to Hero [9s 2h]
Dealt to 2edfec7c 
Dealt to df82aa12 
Dealt to ebfcde93 
Dealt to 4de3c51 
df82aa12: folds
ebfcde93: folds
4de3c51: raises $0.1 to $0.2
cfe70ef2: folds
Hero: folds
2edfec7c: calls $0.1
*** FLOP *** [2d Td 7c]
2edfec7c: checks
4de3c51: checks
*** TURN *** [2d Td 7c] [3h]
2edfec7c: bets $0.35
4de3c51: folds
Uncalled bet ($0.35) returned to 2edfec7c
*** SHOWDOWN ***
2edfec7c collected $0.43 from pot
*** SUMMARY ***
Total pot $0.45 | Rake $0.02 | Jackpot $0 | Bingo $0 | Fortune $0 | Tax $0
Board [2d Td 7c 3h]
Seat 1: cfe70ef2 (button) folded before Flop (didn't bet)
Seat 2: Hero (small blind) folded before Flop
Seat 3: 2edfec7c (big blind) won ($0.43)
Seat 4: df82aa12 folded before Flop (didn't bet)
Seat 5: ebfcde93 folded before Flop (didn't bet)
Seat 6: 4de3c51 folded on the Turn


Poker Hand #RC3141727567: Hold'em No Limit ($0.05/$0.1) - 2024/12/12 13:16:37
Table 'RushAndCash22322827' 6-max Seat #1 is the button
Seat 1: fed024e0 ($11.63 in chips)
Seat 2: 24c2159e ($14.45 in chips)
Seat 3: Hero ($19.52 in chips)
Seat 4: 28704252 ($11.35 in chips)
Seat 5: b828e7ee ($11.4 in chips)
Seat 6: 21e4a637 ($10 in chips)
24c2159e: posts small blind $0.05
Hero: posts big blind $0.1
*** HOLE CARDS ***
Dealt to fed024e0 
Dealt to 24c2159e 
Dealt to Hero [Qs 5c]
Dealt to 28704252 
Dealt to b828e7ee 
Dealt to 21e4a637 
28704252: folds
b828e7ee: folds
21e4a637: raises $0.2 to $0.3
fed024e0: folds
24c2159e: folds
Hero: folds
Uncalled bet ($0.2) returned to 21e4a637
*** SHOWDOWN ***
21e4a637 collected $0.25 from pot
*** SUMMARY ***
Total pot $0.25 | Rake $0 | Jackpot $0 | Bingo $0 | Fortune $0 | Tax $0
Seat 1: fed024e0 (button) folded before Flop (didn't bet)
Seat 2: 24c2159e (small blind) folded before Flop
Seat 3: Hero (big blind) folded before Flop
Seat 4: 28704252 folded before Flop (didn't bet)
Seat 5: b828e7ee folded before Flop (didn't bet)
Seat 6: 21e4a637 collected ($0.25)


Poker Hand #RC3141727551: Hold'em No Limit ($0.05/$0.1) - 2024/12/12 13:16:34
Table 'RushAndCash22322811' 6-max Seat #1 is the button
Seat 1: 3b391f8e ($10 in chips)
Seat 2: ed5370bd ($10.7 in chips)
Seat 3: afe85e9d ($10 in chips)
Seat 4: Hero ($19.52 in chips)
Seat 5: 21e4a637 ($10 in chips)
Seat 6: d037fd58 ($11.53 in chips)
ed5370bd: posts small blind $0.05
afe85e9d: posts big blind $0.1
*** HOLE CARDS ***
Dealt to 3b391f8e 
Dealt to ed5370bd 
Dealt to afe85e9d 
Dealt to Hero [3h Jd]
Dealt to 21e4a637 
Dealt to d037fd58 
Hero: folds
21e4a637: folds
d037fd58: folds
3b391f8e: folds
ed5370bd: raises $0.2 to $0.3
afe85e9d: folds
Uncalled bet ($0.2) returned to ed5370bd
*** SHOWDOWN ***
ed5370bd collected $0.2 from pot
*** SUMMARY ***
Total pot $0.2 | Rake $0 | Jackpot $0 | Bingo $0 | Fortune $0 | Tax $0
Seat 1: 3b391f8e (button) folded before Flop (didn't bet)
Seat 2: ed5370bd (small blind) collected ($0.2)
Seat 3: afe85e9d (big blind) folded before Flop
Seat 4: Hero folded before Flop (didn't bet)
Seat 5: 21e4a637 folded before Flop (didn't bet)
Seat 6: d037fd58 folded before Flop (didn't bet)


Poker Hand #RC3141727539: Hold'em No Limit ($0.05/$0.1) - 2024/12/12 13:16:31
Table 'RushAndCash22322799' 6-max Seat #1 is the button
Seat 1: cf64da1a ($30.42 in chips)
Seat 2: bb2b7f75 ($10 in chips)
Seat 3: 37fb9df ($10 in chips)
Seat 4: Hero ($19.52 in chips)
Seat 5: 3b391f8e ($10 in chips)
Seat 6: b8e03e64 ($10.15 in chips)
bb2b7f75: posts small blind $0.05
37fb9df: posts big blind $0.1
*** HOLE CARDS ***
Dealt to cf64da1a 
Dealt to bb2b7f75 
Dealt to 37fb9df 
Dealt to Hero [Kc 6d]
Dealt to 3b391f8e 
Dealt to b8e03e64 
Hero: folds
3b391f8e: folds
b8e03e64: folds
cf64da1a: raises $0.1 to $0.2
bb2b7f75: raises $0.8 to $1
37fb9df: folds
cf64da1a: folds
Uncalled bet ($0.8) returned to bb2b7f75
*** SHOWDOWN ***
bb2b7f75 collected $0.48 from pot
*** SUMMARY ***
Total pot $0.5 | Rake $0.02 | Jackpot $0 | Bingo $0 | Fortune $0 | Tax $0
Seat 1: cf64da1a (button) folded before Flop
Seat 2: bb2b7f75 (small blind) collected ($0.48)
Seat 3: 37fb9df (big blind) folded before Flop
Seat 4: Hero folded before Flop (didn't bet)
Seat 5: 3b391f8e folded before Flop (didn't bet)
Seat 6: b8e03e64 folded before Flop (didn't bet)


Poker Hand #RC3141727523: Hold'em No Limit ($0.05/$0.1) - 2024/12/12 13:16:27
Table 'RushAndCash22322783' 6-max Seat #1 is the button
Seat 1: ee394d0a ($11.48 in chips)
Seat 2: bb0086cf ($11.24 in chips)
Seat 3: 11d6267a ($10 in chips)
Seat 4: Hero ($19.52 in chips)
Seat 5: 37fb9df ($10 in chips)
Seat 6: bb2b7f75 ($10 in chips)
bb0086cf: posts small blind $0.05
11d6267a: posts big blind $0.1
*** HOLE CARDS ***
Dealt to ee394d0a 
Dealt to bb0086cf 
Dealt to 11d6267a 
Dealt to Hero [2s 9c]
Dealt to 37fb9df 
Dealt to bb2b7f75 
Hero: folds
37fb9df: folds
bb2b7f75: folds
ee394d0a: folds
bb0086cf: raises $0.1 to $0.2
11d6267a: raises $0.6 to $0.8
bb0086cf: folds
Uncalled bet ($0.6) returned to 11d6267a
*** SHOWDOWN ***
11d6267a collected $0.38 from pot
*** SUMMARY ***
Total pot $0.4 | Rake $0.02 | Jackpot $0 | Bingo $0 | Fortune $0 | Tax $0
Seat 1: ee394d0a (button) folded before Flop (didn't bet)
Seat 2: bb0086cf (small blind) folded before Flop
Seat 3: 11d6267a (big blind) collected ($0.38)
Seat 4: Hero folded before Flop (didn't bet)
Seat 5: 37fb9df folded before Flop (didn't bet)
Seat 6: bb2b7f75 folded before Flop (didn't bet)


Poker Hand #RC3141727169: Hold'em No Limit ($0.05/$0.1) - 2024/12/12 13:15:11
Table 'RushAndCash22322429' 6-max Seat #1 is the button
Seat 1: 916c6bd3 ($10.01 in chips)
Seat 2: 9dfc9451 ($10.27 in chips)
Seat 3: bb0086cf ($11.01 in chips)
Seat 4: 2f1d864b ($11.44 in chips)
Seat 5: Hero ($19.72 in chips)
Seat 6: c7bc4949 ($10.43 in chips)
9dfc9451: posts small blind $0.05
bb0086cf: posts big blind $0.1
*** HOLE CARDS ***
Dealt to 916c6bd3 
Dealt to 9dfc9451 
Dealt to bb0086cf 
Dealt to 2f1d864b 
Dealt to Hero [Kh As]
Dealt to c7bc4949 
2f1d864b: folds
Hero: raises $0.1 to $0.2
c7bc4949: folds
916c6bd3: folds
9dfc9451: folds
bb0086cf: calls $0.1
*** FLOP *** [4d 9c 8d]
bb0086cf: checks
Hero: checks
*** TURN *** [4d 9c 8d] [8c]
bb0086cf: checks
Hero: checks
*** RIVER *** [4d 9c 8d 8c] [4h]
bb0086cf: checks
Hero: checks
bb0086cf: shows [5h 5d] (Pair of Eights and Pair of Fives)
Hero: shows [Kh As] (Pair of Eights and Pair of Fours)
*** SHOWDOWN ***
bb0086cf collected $0.43 from pot
*** SUMMARY ***
Total pot $0.45 | Rake $0.02 | Jackpot $0 | Bingo $0 | Fortune $0 | Tax $0
Board [4d 9c 8d 8c 4h]
Seat 1: 916c6bd3 (button) folded before Flop (didn't bet)
Seat 2: 9dfc9451 (small blind) folded before Flop
Seat 3: bb0086cf (big blind) showed [5h 5d] and won ($0.43) with Pair of Eights and Pair of Fives
Seat 4: 2f1d864b folded before Flop (didn't bet)
Seat 5: Hero showed [Kh As] and lost with Pair of Eights and Pair of Fours
Seat 6: c7bc4949 folded before Flop (didn't bet)


Poker Hand #RC3141727001: Hold'em No Limit ($0.05/$0.1) - 2024/12/12 13:14:34
Table 'RushAndCash22322261' 6-max Seat #1 is the button
Seat 1: 1dc50d10 ($10 in chips)
Seat 2: Hero ($20.02 in chips)
Seat 3: 9dfc9451 ($10 in chips)
Seat 4: 974f52 ($29.92 in chips)
Seat 5: 78854bfa ($7.65 in chips)
Seat 6: fed024e0 ($10 in chips)
Hero: posts small blind $0.05
9dfc9451: posts big blind $0.1
*** HOLE CARDS ***
Dealt to 1dc50d10 
Dealt to Hero [5h Qh]
Dealt to 9dfc9451 
Dealt to 974f52 
Dealt to 78854bfa 
Dealt to fed024e0 
974f52: folds
78854bfa: folds
fed024e0: folds
1dc50d10: folds
Hero: raises $0.2 to $0.3
9dfc9451: calls $0.2
*** FLOP *** [8s Jd 2c]
Hero: checks
9dfc9451: bets $0.18
Hero: folds
Uncalled bet ($0.18) returned to 9dfc9451
*** SHOWDOWN ***
9dfc9451 collected $0.57 from pot
*** SUMMARY ***
Total pot $0.6 | Rake $0.03 | Jackpot $0 | Bingo $0 | Fortune $0 | Tax $0
Board [8s Jd 2c]
Seat 1: 1dc50d10 (button) folded before Flop (didn't bet)
Seat 2: Hero (small blind) folded on the Flop
Seat 3: 9dfc9451 (big blind) won ($0.57)
Seat 4: 974f52 folded before Flop (didn't bet)
Seat 5: 78854bfa folded before Flop (didn't bet)
Seat 6: fed024e0 folded before Flop (didn't bet)


Poker Hand #RC3141726988: Hold'em No Limit ($0.05/$0.1) - 2024/12/12 13:14:31
Table 'RushAndCash22322248' 6-max Seat #1 is the button
Seat 1: 78854bfa ($7.65 in chips)
Seat 2: c6999b53 ($2.79 in chips)
Seat 3: 647dd971 ($3.17 in chips)
Seat 4: Hero ($20.02 in chips)
Seat 5: c4d674fe ($14.51 in chips)
Seat 6: fed024e0 ($10 in chips)
c6999b53: posts small blind $0.05
647dd971: posts big blind $0.1
*** HOLE CARDS ***
Dealt to 78854bfa 
Dealt to c6999b53 
Dealt to 647dd971 
Dealt to Hero [Qh 4s]
Dealt to c4d674fe 
Dealt to fed024e0 
Hero: folds
c4d674fe: folds
fed024e0: folds
78854bfa: folds
c6999b53: folds
Uncalled bet ($0.05) returned to 647dd971
*** SHOWDOWN ***
647dd971 collected $0.1 from pot
*** SUMMARY ***
Total pot $0.1 | Rake $0 | Jackpot $0 | Bingo $0 | Fortune $0 | Tax $0
Seat 1: 78854bfa (button) folded before Flop (didn't bet)
Seat 2: c6999b53 (small blind) folded before Flop
Seat 3: 647dd971 (big blind) collected ($0.1)
Seat 4: Hero folded before Flop (didn't bet)
Seat 5: c4d674fe folded before Flop (didn't bet)
Seat 6: fed024e0 folded before Flop (didn't bet)


Poker Hand #RC3141726904: Hold'em No Limit ($0.05/$0.1) - 2024/12/12 13:14:09
Table 'RushAndCash22322164' 6-max Seat #1 is the button
Seat 1: 701f843f ($9.35 in chips)
Seat 2: 21e4a637 ($9.9 in chips)
Seat 3: Hero ($19.97 in chips)
Seat 4: 418b0280 ($11.13 in chips)
Seat 5: 86ee8e36 ($35.53 in chips)
Seat 6: fe1a2d61 ($10 in chips)
21e4a637: posts small blind $0.05
Hero: posts big blind $0.1
*** HOLE CARDS ***
Dealt to 701f843f 
Dealt to 21e4a637 
Dealt to Hero [As 4d]
Dealt to 418b0280 
Dealt to 86ee8e36 
Dealt to fe1a2d61 
418b0280: folds
86ee8e36: folds
fe1a2d61: folds
701f843f: folds
21e4a637: folds
Uncalled bet ($0.05) returned to Hero
*** SHOWDOWN ***
Hero collected $0.1 from pot
*** SUMMARY ***
Total pot $0.1 | Rake $0 | Jackpot $0 | Bingo $0 | Fortune $0 | Tax $0
Seat 1: 701f843f (button) folded before Flop (didn't bet)
Seat 2: 21e4a637 (small blind) folded before Flop
Seat 3: Hero (big blind) collected ($0.1)
Seat 4: 418b0280 folded before Flop (didn't bet)
Seat 5: 86ee8e36 folded before Flop (didn't bet)
Seat 6: fe1a2d61 folded before Flop (didn't bet)


Poker Hand #RC3141726893: Hold'em No Limit ($0.05/$0.1) - 2024/12/12 13:14:06
Table 'RushAndCash22322153' 6-max Seat #1 is the button
Seat 1: Hero ($19.97 in chips)
Seat 2: 8f901b97 ($29.14 in chips)
Seat 3: 2897fa7f ($20.36 in chips)
Seat 4: ce410800 ($23.49 in chips)
Seat 5: 86ee8e36 ($35.53 in chips)
Seat 6: 3606b70a ($10.78 in chips)
8f901b97: posts small blind $0.05
2897fa7f: posts big blind $0.1
*** HOLE CARDS ***
Dealt to Hero [2s 8d]
Dealt to 8f901b97 
Dealt to 2897fa7f 
Dealt to ce410800 
Dealt to 86ee8e36 
Dealt to 3606b70a 
ce410800: folds
86ee8e36: folds
3606b70a: raises $0.15 to $0.25
Hero: folds
8f901b97: folds
2897fa7f: calls $0.15
*** FLOP *** [Kd 6d Th]
2897fa7f: checks
3606b70a: bets $0.28
2897fa7f: calls $0.28
*** TURN *** [Kd 6d Th] [3d]
2897fa7f: checks
3606b70a: checks
*** RIVER *** [Kd 6d Th 3d] [5h]
2897fa7f: checks
3606b70a: bets $0.56
2897fa7f: folds
Uncalled bet ($0.56) returned to 3606b70a
*** SHOWDOWN ***
3606b70a collected $1.06 from pot
*** SUMMARY ***
Total pot $1.11 | Rake $0.05 | Jackpot $0 | Bingo $0 | Fortune $0 | Tax $0
Board [Kd 6d Th 3d 5h]
Seat 1: Hero (button) folded before Flop (didn't bet)
Seat 2: 8f901b97 (small blind) folded before Flop
Seat 3: 2897fa7f (big blind) folded on the River
Seat 4: ce410800 folded before Flop (didn't bet)
Seat 5: 86ee8e36 folded before Flop (didn't bet)
Seat 6: 3606b70a won ($1.06)


Poker Hand #RC3141726880: Hold'em No Limit ($0.05/$0.1) - 2024/12/12 13:14:02
Table 'RushAndCash22322140' 6-max Seat #1 is the button
Seat 1: 6c4ba3fb ($17.6 in chips)
Seat 2: bc46bb6c ($12.1 in chips)
Seat 3: aaca7529 ($3.47 in chips)
Seat 4: Hero ($19.97 in chips)
Seat 5: f347a136 ($10.28 in chips)
Seat 6: 4859226e ($10.32 in chips)
bc46bb6c: posts small blind $0.05
aaca7529: posts big blind $0.1
*** HOLE CARDS ***
Dealt to 6c4ba3fb 
Dealt to bc46bb6c 
Dealt to aaca7529 
Dealt to Hero [7h Kh]
Dealt to f347a136 
Dealt to 4859226e 
Hero: folds
f347a136: folds
4859226e: calls $0.1
6c4ba3fb: raises $0.2 to $0.3
bc46bb6c: folds
aaca7529: calls $0.2
4859226e: calls $0.2
*** FLOP *** [7d Jh 9d]
aaca7529: checks
4859226e: checks
6c4ba3fb: bets $0.48
aaca7529: calls $0.48
4859226e: calls $0.48
*** TURN *** [7d Jh 9d] [8d]
aaca7529: checks
4859226e: checks
6c4ba3fb: checks
*** RIVER *** [7d Jh 9d 8d] [6h]
aaca7529: checks
4859226e: checks
6c4ba3fb: checks
aaca7529: shows [Ah 9h] (Pair of Nines)
4859226e: shows [2c 7s] (Pair of Sevens)
6c4ba3fb: shows [3s 3h] (Pair of Treys)
*** SHOWDOWN ***
aaca7529 collected $2.27 from pot
*** SUMMARY ***
Total pot $2.39 | Rake $0.12 | Jackpot $0 | Bingo $0 | Fortune $0 | Tax $0
Board [7d Jh 9d 8d 6h]
Seat 1: 6c4ba3fb (button) showed [3s 3h] and lost with Pair of Treys
Seat 2: bc46bb6c (small blind) folded before Flop
Seat 3: aaca7529 (big blind) showed [Ah 9h] and won ($2.27) with Pair of Nines
Seat 4: Hero folded before Flop (didn't bet)
Seat 5: f347a136 folded before Flop (didn't bet)
Seat 6: 4859226e showed [2c 7s] and lost with Pair of Sevens


Poker Hand #RC3141726742: Hold'em No Limit ($0.05/$0.1) - 2024/12/12 13:13:28
Table 'RushAndCash22322002' 6-max Seat #1 is the button
Seat 1: fd36d45d ($12.16 in chips)
Seat 2: 41e63fb1 ($5.21 in chips)
Seat 3: f347a136 ($10 in chips)
Seat 4: e0a099ae ($11.29 in chips)
Seat 5: b828e7ee ($11.95 in chips)
Seat 6: Hero ($20.22 in chips)
41e63fb1: posts small blind $0.05
f347a136: posts big blind $0.1
*** HOLE CARDS ***
Dealt to fd36d45d 
Dealt to 41e63fb1 
Dealt to f347a136 
Dealt to e0a099ae 
Dealt to b828e7ee 
Dealt to Hero [8h Kh]
e0a099ae: folds
b828e7ee: folds
Hero: raises $0.15 to $0.25
fd36d45d: folds
41e63fb1: folds
f347a136: raises $0.85 to $1.1
Hero: folds
Uncalled bet ($0.85) returned to f347a136
*** SHOWDOWN ***
f347a136 collected $0.53 from pot
*** SUMMARY ***
Total pot $0.55 | Rake $0.02 | Jackpot $0 | Bingo $0 | Fortune $0 | Tax $0
Seat 1: fd36d45d (button) folded before Flop (didn't bet)
Seat 2: 41e63fb1 (small blind) folded before Flop
Seat 3: f347a136 (big blind) collected ($0.53)
Seat 4: e0a099ae folded before Flop (didn't bet)
Seat 5: b828e7ee folded before Flop (didn't bet)
Seat 6: Hero folded before Flop


Poker Hand #RC3141726572: Hold'em No Limit ($0.05/$0.1) - 2024/12/12 13:12:49
Table 'RushAndCash22321832' 6-max Seat #1 is the button
Seat 1: Hero ($20.59 in chips)
Seat 2: 7f65d70 ($11.57 in chips)
Seat 3: 36e85ed3 ($12.6 in chips)
Seat 4: 558d330b ($10.1 in chips)
Seat 5: 3b1bb7c0 ($13.97 in chips)
Seat 6: 41e63fb1 ($4.73 in chips)
7f65d70: posts small blind $0.05
36e85ed3: posts big blind $0.1
*** HOLE CARDS ***
Dealt to Hero [Qc Qd]
Dealt to 7f65d70 
Dealt to 36e85ed3 
Dealt to 558d330b 
Dealt to 3b1bb7c0 
Dealt to 41e63fb1 
558d330b: folds
3b1bb7c0: folds
41e63fb1: calls $0.1
Hero: raises $0.27 to $0.37
7f65d70: folds
36e85ed3: folds
41e63fb1: calls $0.27
*** FLOP *** [8s 5s Ah]
41e63fb1: checks
Hero: checks
*** TURN *** [8s 5s Ah] [Js]
41e63fb1: bets $0.38
Hero: folds
Uncalled bet ($0.38) returned to 41e63fb1
*** SHOWDOWN ***
41e63fb1 collected $0.85 from pot
*** SUMMARY ***
Total pot $0.89 | Rake $0.04 | Jackpot $0 | Bingo $0 | Fortune $0 | Tax $0
Board [8s 5s Ah Js]
Seat 1: Hero (button) folded on the Turn
Seat 2: 7f65d70 (small blind) folded before Flop
Seat 3: 36e85ed3 (big blind) folded before Flop
Seat 4: 558d330b folded before Flop (didn't bet)
Seat 5: 3b1bb7c0 folded before Flop (didn't bet)
Seat 6: 41e63fb1 won ($0.85)


Poker Hand #RC3141726497: Hold'em No Limit ($0.05/$0.1) - 2024/12/12 13:12:29
Table 'RushAndCash22321757' 6-max Seat #1 is the button
Seat 1: 1e0385e8 ($10.48 in chips)
Seat 2: Hero ($20.49 in chips)
Seat 3: 47ae29b2 ($15.11 in chips)
Seat 4: 8d92b14e ($10.33 in chips)
Seat 5: af0fe6b0 ($10.05 in chips)
Seat 6: 647dd971 ($2.6 in chips)
Hero: posts small blind $0.05
47ae29b2: posts big blind $0.1
*** HOLE CARDS ***
Dealt to 1e0385e8 
Dealt to Hero [5s Ah]
Dealt to 47ae29b2 
Dealt to 8d92b14e 
Dealt to af0fe6b0 
Dealt to 647dd971 
8d92b14e: folds
af0fe6b0: folds
647dd971: folds
1e0385e8: folds
Hero: raises $0.2 to $0.3
47ae29b2: folds
Uncalled bet ($0.2) returned to Hero
*** SHOWDOWN ***
Hero collected $0.2 from pot
*** SUMMARY ***
Total pot $0.2 | Rake $0 | Jackpot $0 | Bingo $0 | Fortune $0 | Tax $0
Seat 1: 1e0385e8 (button) folded before Flop (didn't bet)
Seat 2: Hero (small blind) collected ($0.2)
Seat 3: 47ae29b2 (big blind) folded before Flop
Seat 4: 8d92b14e folded before Flop (didn't bet)
Seat 5: af0fe6b0 folded before Flop (didn't bet)
Seat 6: 647dd971 folded before Flop (didn't bet)


Poker Hand #RC3141726484: Hold'em No Limit ($0.05/$0.1) - 2024/12/12 13:12:25
Table 'RushAndCash22321744' 6-max Seat #1 is the button
Seat 1: 7576a2e9 ($12.69 in chips)
Seat 2: 1e0385e8 ($10.53 in chips)
Seat 3: 481b7ef8 ($27.94 in chips)
Seat 4: 3b12e634 ($11.67 in chips)
Seat 5: Hero ($20.49 in chips)
Seat 6: 974940e1 ($13.14 in chips)
1e0385e8: posts small blind $0.05
481b7ef8: posts big blind $0.1
*** HOLE CARDS ***
Dealt to 7576a2e9 
Dealt to 1e0385e8 
Dealt to 481b7ef8 
Dealt to 3b12e634 
Dealt to Hero [9s 3c]
Dealt to 974940e1 
3b12e634: folds
Hero: folds
974940e1: folds
7576a2e9: folds
1e0385e8: folds
Uncalled bet ($0.05) returned to 481b7ef8
*** SHOWDOWN ***
481b7ef8 collected $0.1 from pot
*** SUMMARY ***
Total pot $0.1 | Rake $0 | Jackpot $0 | Bingo $0 | Fortune $0 | Tax $0
Seat 1: 7576a2e9 (button) folded before Flop (didn't bet)
Seat 2: 1e0385e8 (small blind) folded before Flop
Seat 3: 481b7ef8 (big blind) collected ($0.1)
Seat 4: 3b12e634 folded before Flop (didn't bet)
Seat 5: Hero folded before Flop (didn't bet)
Seat 6: 974940e1 folded before Flop (didn't bet)


Poker Hand #RC3141726470: Hold'em No Limit ($0.05/$0.1) - 2024/12/12 13:12:22
Table 'RushAndCash22321730' 6-max Seat #1 is the button
Seat 1: e12528c0 ($30.2 in chips)
Seat 2: 68283690 ($18.64 in chips)
Seat 3: Hero ($20.59 in chips)
Seat 4: 73d90cc7 ($10.26 in chips)
Seat 5: 4b53eb01 ($10 in chips)
Seat 6: 36e10f27 ($12.15 in chips)
68283690: posts small blind $0.05
Hero: posts big blind $0.1
*** HOLE CARDS ***
Dealt to e12528c0 
Dealt to 68283690 
Dealt to Hero [3s Qh]
Dealt to 73d90cc7 
Dealt to 4b53eb01 
Dealt to 36e10f27 
73d90cc7: raises $0.1 to $0.2
4b53eb01: folds
36e10f27: folds
e12528c0: calls $0.2
68283690: folds
Hero: folds
*** FLOP *** [Td 9h Kh]
73d90cc7: checks
e12528c0: checks
*** TURN *** [Td 9h Kh] [6s]
73d90cc7: checks
e12528c0: checks
*** RIVER *** [Td 9h Kh 6s] [Qd]
73d90cc7: checks
e12528c0: checks
73d90cc7: shows [Qc Kc] (Pair of Kings and Pair of Queens)
e12528c0: shows [9s As] (Pair of Nines)
*** SHOWDOWN ***
73d90cc7 collected $0.53 from pot
*** SUMMARY ***
Total pot $0.55 | Rake $0.02 | Jackpot $0 | Bingo $0 | Fortune $0 | Tax $0
Board [Td 9h Kh 6s Qd]
Seat 1: e12528c0 (button) showed [9s As] and lost with Pair of Nines
Seat 2: 68283690 (small blind) folded before Flop
Seat 3: Hero (big blind) folded before Flop
Seat 4: 73d90cc7 showed [Qc Kc] and won ($0.53) with Pair of Kings and Pair of Queens
Seat 5: 4b53eb01 folded before Flop (didn't bet)
Seat 6: 36e10f27 folded before Flop (didn't bet)


Poker Hand #RC3141726457: Hold'em No Limit ($0.05/$0.1) - 2024/12/12 13:12:18
Table 'RushAndCash22321717' 6-max Seat #1 is the button
Seat 1: 264523b9 ($20.32 in chips)
Seat 2: afe10f69 ($10.15 in chips)
Seat 3: 73d90cc7 ($10.36 in chips)
Seat 4: 77907fc4 ($12.07 in chips)
Seat 5: Hero ($20.59 in chips)
Seat 6: 4b53eb01 ($10 in chips)
afe10f69: posts small blind $0.05
73d90cc7: posts big blind $0.1
*** HOLE CARDS ***
Dealt to 264523b9 
Dealt to afe10f69 
Dealt to 73d90cc7 
Dealt to 77907fc4 
Dealt to Hero [9c 2d]
Dealt to 4b53eb01 
77907fc4: folds
Hero: folds
4b53eb01: folds
264523b9: raises $0.11 to $0.21
afe10f69: folds
73d90cc7: folds
Uncalled bet ($0.11) returned to 264523b9
*** SHOWDOWN ***
264523b9 collected $0.25 from pot
*** SUMMARY ***
Total pot $0.25 | Rake $0 | Jackpot $0 | Bingo $0 | Fortune $0 | Tax $0
Seat 1: 264523b9 (button) collected ($0.25)
Seat 2: afe10f69 (small blind) folded before Flop
Seat 3: 73d90cc7 (big blind) folded before Flop
Seat 4: 77907fc4 folded before Flop (didn't bet)
Seat 5: Hero folded before Flop (didn't bet)
Seat 6: 4b53eb01 folded before Flop (didn't bet)


Poker Hand #RC3141726444: Hold'em No Limit ($0.05/$0.1) - 2024/12/12 13:12:15
Table 'RushAndCash22321704' 6-max Seat #1 is the button
Seat 1: cce00e74 ($8.96 in chips)
Seat 2: 2ad815d2 ($7.48 in chips)
Seat 3: b17913e8 ($6.55 in chips)
Seat 4: 73d90cc7 ($10.36 in chips)
Seat 5: Hero ($20.59 in chips)
Seat 6: f3cd242a ($14.84 in chips)
2ad815d2: posts small blind $0.05
b17913e8: posts big blind $0.1
*** HOLE CARDS ***
Dealt to cce00e74 
Dealt to 2ad815d2 
Dealt to b17913e8 
Dealt to 73d90cc7 
Dealt to Hero [3h 5s]
Dealt to f3cd242a 
73d90cc7: folds
Hero: folds
f3cd242a: raises $0.1 to $0.2
cce00e74: folds
2ad815d2: folds
b17913e8: folds
Uncalled bet ($0.1) returned to f3cd242a
*** SHOWDOWN ***
f3cd242a collected $0.25 from pot
*** SUMMARY ***
Total pot $0.25 | Rake $0 | Jackpot $0 | Bingo $0 | Fortune $0 | Tax $0
Seat 1: cce00e74 (button) folded before Flop (didn't bet)
Seat 2: 2ad815d2 (small blind) folded before Flop
Seat 3: b17913e8 (big blind) folded before Flop
Seat 4: 73d90cc7 folded before Flop (didn't bet)
Seat 5: Hero folded before Flop (didn't bet)
Seat 6: f3cd242a collected ($0.25)


Poker Hand #RC3141726333: Hold'em No Limit ($0.05/$0.1) - 2024/12/12 13:11:43
Table 'RushAndCash22321593' 6-max Seat #1 is the button
Seat 1: bb2b7f75 ($9.99 in chips)
Seat 2: 2583ab41 ($10.76 in chips)
Seat 3: 5ab2e15d ($10.74 in chips)
Seat 4: e896e324 ($11.38 in chips)
Seat 5: 2ad815d2 ($7.68 in chips)
Seat 6: Hero ($20.26 in chips)
2583ab41: posts small blind $0.05
5ab2e15d: posts big blind $0.1
*** HOLE CARDS ***
Dealt to bb2b7f75 
Dealt to 2583ab41 
Dealt to 5ab2e15d 
Dealt to e896e324 
Dealt to 2ad815d2 
Dealt to Hero [Ks Kd]
e896e324: folds
2ad815d2: raises $0.1 to $0.2
Hero: raises $0.5 to $0.7
bb2b7f75: folds
2583ab41: folds
5ab2e15d: folds
2ad815d2: folds
Uncalled bet ($0.5) returned to Hero
*** SHOWDOWN ***
Hero collected $0.53 from pot
*** SUMMARY ***
Total pot $0.55 | Rake $0.02 | Jackpot $0 | Bingo $0 | Fortune $0 | Tax $0
Seat 1: bb2b7f75 (button) folded before Flop (didn't bet)
Seat 2: 2583ab41 (small blind) folded before Flop
Seat 3: 5ab2e15d (big blind) folded before Flop
Seat 4: e896e324 folded before Flop (didn't bet)
Seat 5: 2ad815d2 folded before Flop
Seat 6: Hero collected ($0.53)


Poker Hand #RC3141726285: Hold'em No Limit ($0.05/$0.1) - 2024/12/12 13:11:28
Table 'RushAndCash22321545' 6-max Seat #1 is the button
Seat 1: 4e5c7119 ($14.85 in chips)
Seat 2: Hero ($20.16 in chips)
Seat 3: 22222ecf ($10 in chips)
Seat 4: b4bc8071 ($12.59 in chips)
Seat 5: bc2007a2 ($20.9 in chips)
Seat 6: 52c6c741 ($12.3 in chips)
Hero: posts small blind $0.05
22222ecf: posts big blind $0.1
*** HOLE CARDS ***
Dealt to 4e5c7119 
Dealt to Hero [7h 6h]
Dealt to 22222ecf 
Dealt to b4bc8071 
Dealt to bc2007a2 
Dealt to 52c6c741 
b4bc8071: folds
bc2007a2: folds
52c6c741: folds
4e5c7119: folds
Hero: raises $0.2 to $0.3
22222ecf: folds
Uncalled bet ($0.2) returned to Hero
*** SHOWDOWN ***
Hero collected $0.2 from pot
*** SUMMARY ***
Total pot $0.2 | Rake $0 | Jackpot $0 | Bingo $0 | Fortune $0 | Tax $0
Seat 1: 4e5c7119 (button) folded before Flop (didn't bet)
Seat 2: Hero (small blind) collected ($0.2)
Seat 3: 22222ecf (big blind) folded before Flop
Seat 4: b4bc8071 folded before Flop (didn't bet)
Seat 5: bc2007a2 folded before Flop (didn't bet)
Seat 6: 52c6c741 folded before Flop (didn't bet)


Poker Hand #RC3141726180: Hold'em No Limit ($0.05/$0.1) - 2024/12/12 13:11:02
Table 'RushAndCash22321440' 6-max Seat #1 is the button
Seat 1: Hero ($20.01 in chips)
Seat 2: 6d89c9cc ($24.84 in chips)
Seat 3: 506e90c1 ($10.06 in chips)
Seat 4: e12528c0 ($30.85 in chips)
Seat 5: a212e67a ($10.33 in chips)
Seat 6: 1eed6c31 ($8.23 in chips)
6d89c9cc: posts small blind $0.05
506e90c1: posts big blind $0.1
*** HOLE CARDS ***
Dealt to Hero [Th Kd]
Dealt to 6d89c9cc 
Dealt to 506e90c1 
Dealt to e12528c0 
Dealt to a212e67a 
Dealt to 1eed6c31 
e12528c0: folds
a212e67a: folds
1eed6c31: folds
Hero: raises $0.15 to $0.25
6d89c9cc: folds
506e90c1: folds
Uncalled bet ($0.15) returned to Hero
*** SHOWDOWN ***
Hero collected $0.25 from pot
*** SUMMARY ***
Total pot $0.25 | Rake $0 | Jackpot $0 | Bingo $0 | Fortune $0 | Tax $0
Seat 1: Hero (button) collected ($0.25)
Seat 2: 6d89c9cc (small blind) folded before Flop
Seat 3: 506e90c1 (big blind) folded before Flop
Seat 4: e12528c0 folded before Flop (didn't bet)
Seat 5: a212e67a folded before Flop (didn't bet)
Seat 6: 1eed6c31 folded before Flop (didn't bet)


Poker Hand #RC3141726166: Hold'em No Limit ($0.05/$0.1) - 2024/12/12 13:10:59
Table 'RushAndCash22321426' 6-max Seat #1 is the button
Seat 1: Hero ($20.01 in chips)
Seat 2: 5248da40 ($10 in chips)
Seat 3: cb418bfa ($10 in chips)
Seat 4: cc07b659 ($10.15 in chips)
Seat 5: 506e90c1 ($10.06 in chips)
Seat 6: 2b1a7fe5 ($11.08 in chips)
5248da40: posts small blind $0.05
cb418bfa: posts big blind $0.1
*** HOLE CARDS ***
Dealt to Hero [7s 9c]
Dealt to 5248da40 
Dealt to cb418bfa 
Dealt to cc07b659 
Dealt to 506e90c1 
Dealt to 2b1a7fe5 
cc07b659: raises $0.1 to $0.2
506e90c1: folds
2b1a7fe5: folds
Hero: folds
5248da40: folds
cb418bfa: folds
Uncalled bet ($0.1) returned to cc07b659
*** SHOWDOWN ***
cc07b659 collected $0.25 from pot
*** SUMMARY ***
Total pot $0.25 | Rake $0 | Jackpot $0 | Bingo $0 | Fortune $0 | Tax $0
Seat 1: Hero (button) folded before Flop (didn't bet)
Seat 2: 5248da40 (small blind) folded before Flop
Seat 3: cb418bfa (big blind) folded before Flop
Seat 4: cc07b659 collected ($0.25)
Seat 5: 506e90c1 folded before Flop (didn't bet)
Seat 6: 2b1a7fe5 folded before Flop (didn't bet)


Poker Hand #RC3141726106: Hold'em No Limit ($0.05/$0.1) - 2024/12/12 13:10:40
Table 'RushAndCash22321366' 6-max Seat #1 is the button
Seat 1: 1eed6c31 ($8.23 in chips)
Seat 2: 24c2159e ($11.89 in chips)
Seat 3: Hero ($19.96 in chips)
Seat 4: cb6a7240 ($11.3 in chips)
Seat 5: c5141ec9 ($13.75 in chips)
Seat 6: 52c6c741 ($12.02 in chips)
24c2159e: posts small blind $0.05
Hero: posts big blind $0.1
*** HOLE CARDS ***
Dealt to 1eed6c31 
Dealt to 24c2159e 
Dealt to Hero [9d Ts]
Dealt to cb6a7240 
Dealt to c5141ec9 
Dealt to 52c6c741 
cb6a7240: folds
c5141ec9: folds
52c6c741: folds
1eed6c31: folds
24c2159e: folds
Uncalled bet ($0.05) returned to Hero
*** SHOWDOWN ***
Hero collected $0.1 from pot
*** SUMMARY ***
Total pot $0.1 | Rake $0 | Jackpot $0 | Bingo $0 | Fortune $0 | Tax $0
Seat 1: 1eed6c31 (button) folded before Flop (didn't bet)
Seat 2: 24c2159e (small blind) folded before Flop
Seat 3: Hero (big blind) collected ($0.1)
Seat 4: cb6a7240 folded before Flop (didn't bet)
Seat 5: c5141ec9 folded before Flop (didn't bet)
Seat 6: 52c6c741 folded before Flop (didn't bet)


Poker Hand #RC3141726055: Hold'em No Limit ($0.05/$0.1) - 2024/12/12 13:10:28
Table 'RushAndCash22321315' 6-max Seat #1 is the button
Seat 1: 968b2ad6 ($12.4 in chips)
Seat 2: 36e10f27 ($11.41 in chips)
Seat 3: 26abca60 ($10 in chips)
Seat 4: 4d1634eb ($12.47 in chips)
Seat 5: 54d53a50 ($28.43 in chips)
Seat 6: Hero ($19.96 in chips)
36e10f27: posts small blind $0.05
26abca60: posts big blind $0.1
*** HOLE CARDS ***
Dealt to 968b2ad6 
Dealt to 36e10f27 
Dealt to 26abca60 
Dealt to 4d1634eb 
Dealt to 54d53a50 
Dealt to Hero [9h Kc]
4d1634eb: folds
54d53a50: folds
Hero: folds
968b2ad6: folds
36e10f27: folds
Uncalled bet ($0.05) returned to 26abca60
*** SHOWDOWN ***
26abca60 collected $0.1 from pot
*** SUMMARY ***
Total pot $0.1 | Rake $0 | Jackpot $0 | Bingo $0 | Fortune $0 | Tax $0
Seat 1: 968b2ad6 (button) folded before Flop (didn't bet)
Seat 2: 36e10f27 (small blind) folded before Flop
Seat 3: 26abca60 (big blind) collected ($0.1)
Seat 4: 4d1634eb folded before Flop (didn't bet)
Seat 5: 54d53a50 folded before Flop (didn't bet)
Seat 6: Hero folded before Flop (didn't bet)


Poker Hand #RC3141726008: Hold'em No Limit ($0.05/$0.1) - 2024/12/12 13:10:16
Table 'RushAndCash22321268' 6-max Seat #1 is the button
Seat 1: 4eb4d0d6 ($18.7 in chips)
Seat 2: Hero ($20.01 in chips)
Seat 3: 593f64c7 ($4.4 in chips)
Seat 4: 2746c1f0 ($20.35 in chips)
Seat 5: a730cdce ($11.19 in chips)
Seat 6: e896e324 ($11.48 in chips)
Hero: posts small blind $0.05
593f64c7: posts big blind $0.1
*** HOLE CARDS ***
Dealt to 4eb4d0d6 
Dealt to Hero [7s Qs]
Dealt to 593f64c7 
Dealt to 2746c1f0 
Dealt to a730cdce 
Dealt to e896e324 
2746c1f0: raises $0.12 to $0.22
a730cdce: raises $0.48 to $0.7
e896e324: folds
4eb4d0d6: folds
Hero: folds
593f64c7: folds
2746c1f0: raises $1.4 to $2.1
a730cdce: folds
Uncalled bet ($1.4) returned to 2746c1f0
*** SHOWDOWN ***
2746c1f0 collected $1.48 from pot
*** SUMMARY ***
Total pot $1.55 | Rake $0.07 | Jackpot $0 | Bingo $0 | Fortune $0 | Tax $0
Seat 1: 4eb4d0d6 (button) folded before Flop (didn't bet)
Seat 2: Hero (small blind) folded before Flop
Seat 3: 593f64c7 (big blind) folded before Flop
Seat 4: 2746c1f0 collected ($1.48)
Seat 5: a730cdce folded before Flop
Seat 6: e896e324 folded before Flop (didn't bet)


Poker Hand #RC3141725993: Hold'em No Limit ($0.05/$0.1) - 2024/12/12 13:10:13
Table 'RushAndCash22321253' 6-max Seat #1 is the button
Seat 1: 4b9faa96 ($11.95 in chips)
Seat 2: 41ad32d3 ($23.18 in chips)
Seat 3: dea1301e ($28.94 in chips)
Seat 4: 4eb4d0d6 ($18.7 in chips)
Seat 5: Hero ($20.01 in chips)
Seat 6: 81834a2f ($13.37 in chips)
41ad32d3: posts small blind $0.05
dea1301e: posts big blind $0.1
*** HOLE CARDS ***
Dealt to 4b9faa96 
Dealt to 41ad32d3 
Dealt to dea1301e 
Dealt to 4eb4d0d6 
Dealt to Hero [7h Ts]
Dealt to 81834a2f 
4eb4d0d6: folds
Hero: folds
81834a2f: folds
4b9faa96: folds
41ad32d3: raises $0.15 to $0.25
dea1301e: calls $0.15
*** FLOP *** [9s 8h Td]
41ad32d3: checks
dea1301e: bets $0.38
41ad32d3: folds
Uncalled bet ($0.38) returned to dea1301e
*** SHOWDOWN ***
dea1301e collected $0.48 from pot
*** SUMMARY ***
Total pot $0.5 | Rake $0.02 | Jackpot $0 | Bingo $0 | Fortune $0 | Tax $0
Board [9s 8h Td]
Seat 1: 4b9faa96 (button) folded before Flop (didn't bet)
Seat 2: 41ad32d3 (small blind) folded on the Flop
Seat 3: dea1301e (big blind) won ($0.48)
Seat 4: 4eb4d0d6 folded before Flop (didn't bet)
Seat 5: Hero folded before Flop (didn't bet)
Seat 6: 81834a2f folded before Flop (didn't bet)


Poker Hand #RC3141725967: Hold'em No Limit ($0.05/$0.1) - 2024/12/12 13:10:07
Table 'RushAndCash22321227' 6-max Seat #1 is the button
Seat 1: cc0ee7ad ($8.56 in chips)
Seat 2: f3cd242a ($13.51 in chips)
Seat 3: Hero ($20.11 in chips)
Seat 4: 4f76bae1 ($11.61 in chips)
Seat 5: 1a4620d0 ($10.43 in chips)
Seat 6: 566d8ba0 ($26.51 in chips)
f3cd242a: posts small blind $0.05
Hero: posts big blind $0.1
*** HOLE CARDS ***
Dealt to cc0ee7ad 
Dealt to f3cd242a 
Dealt to Hero [6h Kd]
Dealt to 4f76bae1 
Dealt to 1a4620d0 
Dealt to 566d8ba0 
4f76bae1: folds
1a4620d0: folds
566d8ba0: raises $0.1 to $0.2
cc0ee7ad: raises $0.55 to $0.75
f3cd242a: folds
Hero: folds
566d8ba0: raises $14.35 to $15.1
cc0ee7ad: calls $7.81 and is all-in
Uncalled bet ($6.54) returned to 566d8ba0
566d8ba0: shows [As Kc]
cc0ee7ad: shows [Ac Qh]
*** FLOP *** [Td Ah 2d]
*** TURN *** [Td Ah 2d] [4c]
*** RIVER *** [Td Ah 2d 4c] [Ad]
*** SHOWDOWN ***
566d8ba0 collected $16.82 from pot
*** SUMMARY ***
Total pot $17.27 | Rake $0.3 | Jackpot $0.15 | Bingo $0 | Fortune $0 | Tax $0
Board [Td Ah 2d 4c Ad]
Seat 1: cc0ee7ad (button) showed [Ac Qh] and lost with Three Aces
Seat 2: f3cd242a (small blind) folded before Flop
Seat 3: Hero (big blind) folded before Flop
Seat 4: 4f76bae1 folded before Flop (didn't bet)
Seat 5: 1a4620d0 folded before Flop (didn't bet)
Seat 6: 566d8ba0 showed [As Kc] and won ($16.82) with Three Aces


Poker Hand #RC3141725954: Hold'em No Limit ($0.05/$0.1) - 2024/12/12 13:10:04
Table 'RushAndCash22321214' 6-max Seat #1 is the button
Seat 1: 418b0280 ($10.05 in chips)
Seat 2: 916c6bd3 ($11.94 in chips)
Seat 3: 7576a2e9 ($12.84 in chips)
Seat 4: 844091a0 ($10.4 in chips)
Seat 5: Hero ($20.11 in chips)
Seat 6: 22e8274e ($23.62 in chips)
916c6bd3: posts small blind $0.05
7576a2e9: posts big blind $0.1
*** HOLE CARDS ***
Dealt to 418b0280 
Dealt to 916c6bd3 
Dealt to 7576a2e9 
Dealt to 844091a0 
Dealt to Hero [4s Qc]
Dealt to 22e8274e 
844091a0: folds
Hero: folds
22e8274e: folds
418b0280: raises $0.15 to $0.25
916c6bd3: calls $0.2
7576a2e9: folds
*** FLOP *** [6h 8d Jh]
916c6bd3: checks
418b0280: bets $0.2
916c6bd3: calls $0.2
*** TURN *** [6h 8d Jh] [Kd]
916c6bd3: checks
418b0280: bets $0.7
916c6bd3: calls $0.7
*** RIVER *** [6h 8d Jh Kd] [Tc]
916c6bd3: checks
418b0280: bets $2.35
916c6bd3: folds
Uncalled bet ($2.35) returned to 418b0280
*** SHOWDOWN ***
418b0280 collected $2.28 from pot
*** SUMMARY ***
Total pot $2.4 | Rake $0.12 | Jackpot $0 | Bingo $0 | Fortune $0 | Tax $0
Board [6h 8d Jh Kd Tc]
Seat 1: 418b0280 (button) won ($2.28)
Seat 2: 916c6bd3 (small blind) folded on the River
Seat 3: 7576a2e9 (big blind) folded before Flop
Seat 4: 844091a0 folded before Flop (didn't bet)
Seat 5: Hero folded before Flop (didn't bet)
Seat 6: 22e8274e folded before Flop (didn't bet)


Poker Hand #RC3141725938: Hold'em No Limit ($0.05/$0.1) - 2024/12/12 13:10:00
Table 'RushAndCash22321198' 6-max Seat #1 is the button
Seat 1: Hero ($20.11 in chips)
Seat 2: ae2a34aa ($10.69 in chips)
Seat 3: 72f58f29 ($11.13 in chips)
Seat 4: f3cd242a ($13.51 in chips)
Seat 5: cce00e74 ($9.49 in chips)
Seat 6: b1f396f4 ($20.57 in chips)
ae2a34aa: posts small blind $0.05
72f58f29: posts big blind $0.1
*** HOLE CARDS ***
Dealt to Hero [Ts 5s]
Dealt to ae2a34aa 
Dealt to 72f58f29 
Dealt to f3cd242a 
Dealt to cce00e74 
Dealt to b1f396f4 
f3cd242a: folds
cce00e74: folds
b1f396f4: folds
Hero: folds
ae2a34aa: folds
Uncalled bet ($0.05) returned to 72f58f29
*** SHOWDOWN ***
72f58f29 collected $0.1 from pot
*** SUMMARY ***
Total pot $0.1 | Rake $0 | Jackpot $0 | Bingo $0 | Fortune $0 | Tax $0
Seat 1: Hero (button) folded before Flop (didn't bet)
Seat 2: ae2a34aa (small blind) folded before Flop
Seat 3: 72f58f29 (big blind) collected ($0.1)
Seat 4: f3cd242a folded before Flop (didn't bet)
Seat 5: cce00e74 folded before Flop (didn't bet)
Seat 6: b1f396f4 folded before Flop (didn't bet)


Poker Hand #RC3141725922: Hold'em No Limit ($0.05/$0.1) - 2024/12/12 13:09:57
Table 'RushAndCash22321182' 6-max Seat #1 is the button
Seat 1: 3c7f222d ($11.59 in chips)
Seat 2: b17f5bfe ($7.6 in chips)
Seat 3: 7ee23c5e ($11.83 in chips)
Seat 4: dd68a104 ($17.5 in chips)
Seat 5: Hero ($20.11 in chips)
Seat 6: f3cd242a ($13.51 in chips)
b17f5bfe: posts small blind $0.05
7ee23c5e: posts big blind $0.1
*** HOLE CARDS ***
Dealt to 3c7f222d 
Dealt to b17f5bfe 
Dealt to 7ee23c5e 
Dealt to dd68a104 
Dealt to Hero [9h 2d]
Dealt to f3cd242a 
dd68a104: folds
Hero: folds
f3cd242a: folds
3c7f222d: raises $0.1 to $0.2
b17f5bfe: folds
7ee23c5e: calls $0.1
*** FLOP *** [Qc Tc Qh]
7ee23c5e: checks
3c7f222d: bets $0.15
7ee23c5e: folds
Uncalled bet ($0.15) returned to 3c7f222d
*** SHOWDOWN ***
3c7f222d collected $0.43 from pot
*** SUMMARY ***
Total pot $0.45 | Rake $0.02 | Jackpot $0 | Bingo $0 | Fortune $0 | Tax $0
Board [Qc Tc Qh]
Seat 1: 3c7f222d (button) won ($0.43)
Seat 2: b17f5bfe (small blind) folded before Flop
Seat 3: 7ee23c5e (big blind) folded on the Flop
Seat 4: dd68a104 folded before Flop (didn't bet)
Seat 5: Hero folded before Flop (didn't bet)
Seat 6: f3cd242a folded before Flop (didn't bet)


Poker Hand #RC3141725906: Hold'em No Limit ($0.05/$0.1) - 2024/12/12 13:09:53
Table 'RushAndCash22321166' 6-max Seat #1 is the button
Seat 1: 4c1c8756 ($10 in chips)
Seat 2: b738541f ($12.49 in chips)
Seat 3: dd68a104 ($17.6 in chips)
Seat 4: b17f5bfe ($7.6 in chips)
Seat 5: 7ee23c5e ($11.83 in chips)
Seat 6: Hero ($20.11 in chips)
b738541f: posts small blind $0.05
dd68a104: posts big blind $0.1
*** HOLE CARDS ***
Dealt to 4c1c8756 
Dealt to b738541f 
Dealt to dd68a104 
Dealt to b17f5bfe 
Dealt to 7ee23c5e 
Dealt to Hero [3h 4s]
b17f5bfe: folds
7ee23c5e: folds
Hero: folds
4c1c8756: folds
b738541f: folds
Uncalled bet ($0.05) returned to dd68a104
*** SHOWDOWN ***
dd68a104 collected $0.1 from pot
*** SUMMARY ***
Total pot $0.1 | Rake $0 | Jackpot $0 | Bingo $0 | Fortune $0 | Tax $0
Seat 1: 4c1c8756 (button) folded before Flop (didn't bet)
Seat 2: b738541f (small blind) folded before Flop
Seat 3: dd68a104 (big blind) collected ($0.1)
Seat 4: b17f5bfe folded before Flop (didn't bet)
Seat 5: 7ee23c5e folded before Flop (didn't bet)
Seat 6: Hero folded before Flop (didn't bet)


Poker Hand #RC3141725890: Hold'em No Limit ($0.05/$0.1) - 2024/12/12 13:09:50
Table 'RushAndCash22321150' 6-max Seat #1 is the button
Seat 1: 2a6446ed ($12.57 in chips)
Seat 2: Hero ($20.16 in chips)
Seat 3: 26abca60 ($10 in chips)
Seat 4: 37236510 ($8.96 in chips)
Seat 5: ebfcde93 ($10.32 in chips)
Seat 6: 316b7313 ($9.99 in chips)
Hero: posts small blind $0.05
26abca60: posts big blind $0.1
*** HOLE CARDS ***
Dealt to 2a6446ed 
Dealt to Hero [8s 2c]
Dealt to 26abca60 
Dealt to 37236510 
Dealt to ebfcde93 
Dealt to 316b7313 
37236510: folds
ebfcde93: folds
316b7313: folds
2a6446ed: folds
Hero: folds
Uncalled bet ($0.05) returned to 26abca60
*** SHOWDOWN ***
26abca60 collected $0.1 from pot
*** SUMMARY ***
Total pot $0.1 | Rake $0 | Jackpot $0 | Bingo $0 | Fortune $0 | Tax $0
Seat 1: 2a6446ed (button) folded before Flop (didn't bet)
Seat 2: Hero (small blind) folded before Flop
Seat 3: 26abca60 (big blind) collected ($0.1)
Seat 4: 37236510 folded before Flop (didn't bet)
Seat 5: ebfcde93 folded before Flop (didn't bet)
Seat 6: 316b7313 folded before Flop (didn't bet)


Poker Hand #RC3141725702: Hold'em No Limit ($0.05/$0.1) - 2024/12/12 13:09:08
Table 'RushAndCash22320962' 6-max Seat #1 is the button
Seat 1: ebfcde93 ($10 in chips)
Seat 2: 6c4ba3fb ($18.65 in chips)
Seat 3: Hero ($20.46 in chips)
Seat 4: c199627b ($16.37 in chips)
Seat 5: 7ec40c0d ($12.36 in chips)
Seat 6: 216abb36 ($16.74 in chips)
6c4ba3fb: posts small blind $0.05
Hero: posts big blind $0.1
*** HOLE CARDS ***
Dealt to ebfcde93 
Dealt to 6c4ba3fb 
Dealt to Hero [4h 4c]
Dealt to c199627b 
Dealt to 7ec40c0d 
Dealt to 216abb36 
c199627b: folds
7ec40c0d: folds
216abb36: folds
ebfcde93: raises $0.2 to $0.3
6c4ba3fb: folds
Hero: calls $0.2
*** FLOP *** [2s 2d Th]
Hero: checks
ebfcde93: bets $0.29
Hero: folds
Uncalled bet ($0.29) returned to ebfcde93
*** SHOWDOWN ***
ebfcde93 collected $0.62 from pot
*** SUMMARY ***
Total pot $0.65 | Rake $0.03 | Jackpot $0 | Bingo $0 | Fortune $0 | Tax $0
Board [2s 2d Th]
Seat 1: ebfcde93 (button) won ($0.62)
Seat 2: 6c4ba3fb (small blind) folded before Flop
Seat 3: Hero (big blind) folded on the Flop
Seat 4: c199627b folded before Flop (didn't bet)
Seat 5: 7ec40c0d folded before Flop (didn't bet)
Seat 6: 216abb36 folded before Flop (didn't bet)


Poker Hand #RC3141725688: Hold'em No Limit ($0.05/$0.1) - 2024/12/12 13:09:04
Table 'RushAndCash22320948' 6-max Seat #1 is the button
Seat 1: dea1301e ($28.32 in chips)
Seat 2: 36e85ed3 ($13.54 in chips)
Seat 3: 2746c1f0 ($19.54 in chips)
Seat 4: 23d20ac6 ($15.11 in chips)
Seat 5: 566d8ba0 ($26.71 in chips)
Seat 6: Hero ($20.46 in chips)
36e85ed3: posts small blind $0.05
2746c1f0: posts big blind $0.1
*** HOLE CARDS ***
Dealt to dea1301e 
Dealt to 36e85ed3 
Dealt to 2746c1f0 
Dealt to 23d20ac6 
Dealt to 566d8ba0 
Dealt to Hero [8h Qd]
23d20ac6: folds
566d8ba0: folds
Hero: folds
dea1301e: folds
36e85ed3: calls $0.05
2746c1f0: raises $0.2 to $0.3
36e85ed3: folds
Uncalled bet ($0.2) returned to 2746c1f0
*** SHOWDOWN ***
2746c1f0 collected $0.2 from pot
*** SUMMARY ***
Total pot $0.2 | Rake $0 | Jackpot $0 | Bingo $0 | Fortune $0 | Tax $0
Seat 1: dea1301e (button) folded before Flop (didn't bet)
Seat 2: 36e85ed3 (small blind) folded before Flop
Seat 3: 2746c1f0 (big blind) collected ($0.2)
Seat 4: 23d20ac6 folded before Flop (didn't bet)
Seat 5: 566d8ba0 folded before Flop (didn't bet)
Seat 6: Hero folded before Flop (didn't bet)


Poker Hand #RC3141725676: Hold'em No Limit ($0.05/$0.1) - 2024/12/12 13:09:01
Table 'RushAndCash22320936' 6-max Seat #1 is the button
Seat 1: b1f396f4 ($20.67 in chips)
Seat 2: 226dbbb0 ($10.79 in chips)
Seat 3: 14311dad ($10.15 in chips)
Seat 4: Hero ($20.46 in chips)
Seat 5: 7f65d70 ($10 in chips)
Seat 6: 84849e11 ($88.87 in chips)
226dbbb0: posts small blind $0.05
14311dad: posts big blind $0.1
*** HOLE CARDS ***
Dealt to b1f396f4 
Dealt to 226dbbb0 
Dealt to 14311dad 
Dealt to Hero [Qs 3d]
Dealt to 7f65d70 
Dealt to 84849e11 
Hero: folds
7f65d70: folds
84849e11: raises $0.2 to $0.3
b1f396f4: folds
226dbbb0: folds
14311dad: folds
Uncalled bet ($0.2) returned to 84849e11
*** SHOWDOWN ***
84849e11 collected $0.25 from pot
*** SUMMARY ***
Total pot $0.25 | Rake $0 | Jackpot $0 | Bingo $0 | Fortune $0 | Tax $0
Seat 1: b1f396f4 (button) folded before Flop (didn't bet)
Seat 2: 226dbbb0 (small blind) folded before Flop
Seat 3: 14311dad (big blind) folded before Flop
Seat 4: Hero folded before Flop (didn't bet)
Seat 5: 7f65d70 folded before Flop (didn't bet)
Seat 6: 84849e11 collected ($0.25)


Poker Hand #RC3141725662: Hold'em No Limit ($0.05/$0.1) - 2024/12/12 13:08:57
Table 'RushAndCash22320922' 6-max Seat #1 is the button
Seat 1: b82279c3 ($26.46 in chips)
Seat 2: 84849e11 ($88.92 in chips)
Seat 3: f44841fc ($10 in chips)
Seat 4: 8422b573 ($10 in chips)
Seat 5: Hero ($20.46 in chips)
Seat 6: 14311dad ($10.15 in chips)
84849e11: posts small blind $0.05
f44841fc: posts big blind $0.1
*** HOLE CARDS ***
Dealt to b82279c3 
Dealt to 84849e11 
Dealt to f44841fc 
Dealt to 8422b573 
Dealt to Hero [6c 2h]
Dealt to 14311dad 
8422b573: folds
Hero: folds
14311dad: folds
b82279c3: raises $0.15 to $0.25
84849e11: folds
f44841fc: folds
Uncalled bet ($0.15) returned to b82279c3
*** SHOWDOWN ***
b82279c3 collected $0.25 from pot
*** SUMMARY ***
Total pot $0.25 | Rake $0 | Jackpot $0 | Bingo $0 | Fortune $0 | Tax $0
Seat 1: b82279c3 (button) collected ($0.25)
Seat 2: 84849e11 (small blind) folded before Flop
Seat 3: f44841fc (big blind) folded before Flop
Seat 4: 8422b573 folded before Flop (didn't bet)
Seat 5: Hero folded before Flop (didn't bet)
Seat 6: 14311dad folded before Flop (didn't bet)


Poker Hand #RC3141725649: Hold'em No Limit ($0.05/$0.1) - 2024/12/12 13:08:54
Table 'RushAndCash22320909' 6-max Seat #1 is the button
Seat 1: 6d89c9cc ($24.82 in chips)
Seat 2: d515d6ec ($10 in chips)
Seat 3: 902b9d1a ($9.91 in chips)
Seat 4: f564c212 ($12.07 in chips)
Seat 5: 14311dad ($10.15 in chips)
Seat 6: Hero ($20.46 in chips)
d515d6ec: posts small blind $0.05
902b9d1a: posts big blind $0.1
*** HOLE CARDS ***
Dealt to 6d89c9cc 
Dealt to d515d6ec 
Dealt to 902b9d1a 
Dealt to f564c212 
Dealt to 14311dad 
Dealt to Hero [2s Qs]
f564c212: raises $0.12 to $0.22
14311dad: folds
Hero: folds
6d89c9cc: folds
d515d6ec: folds
902b9d1a: folds
Uncalled bet ($0.12) returned to f564c212
*** SHOWDOWN ***
f564c212 collected $0.25 from pot
*** SUMMARY ***
Total pot $0.25 | Rake $0 | Jackpot $0 | Bingo $0 | Fortune $0 | Tax $0
Seat 1: 6d89c9cc (button) folded before Flop (didn't bet)
Seat 2: d515d6ec (small blind) folded before Flop
Seat 3: 902b9d1a (big blind) folded before Flop
Seat 4: f564c212 collected ($0.25)
Seat 5: 14311dad folded before Flop (didn't bet)
Seat 6: Hero folded before Flop (didn't bet)


Poker Hand #RC3141725403: Hold'em No Limit ($0.05/$0.1) - 2024/12/12 13:07:53
Table 'RushAndCash22320663' 6-max Seat #1 is the button
Seat 1: 3e729116 ($12.1 in chips)
Seat 2: 3cdac696 ($6.44 in chips)
Seat 3: 84c13d8 ($27.45 in chips)
Seat 4: 55e95fce ($10.64 in chips)
Seat 5: Hero ($14.17 in chips)
Seat 6: eb12374a ($10.28 in chips)
3cdac696: posts small blind $0.05
84c13d8: posts big blind $0.1
*** HOLE CARDS ***
Dealt to 3e729116 
Dealt to 3cdac696 
Dealt to 84c13d8 
Dealt to 55e95fce 
Dealt to Hero [Kc Ks]
Dealt to eb12374a 
55e95fce: raises $0.1 to $0.2
Hero: raises $0.42 to $0.62
eb12374a: folds
3e729116: folds
3cdac696: raises $5.82 to $6.44 and is all-in
84c13d8: folds
55e95fce: folds
Hero: calls $5.82
3cdac696: shows [Kd Ac]
Hero: shows [Kc Ks]
*** FLOP *** [6c Ts 4s]
*** TURN *** [6c Ts 4s] [Th]
*** RIVER *** [6c Ts 4s Th] [2h]
*** SHOWDOWN ***
Hero collected $12.73 from pot
*** SUMMARY ***
Total pot $13.18 | Rake $0.3 | Jackpot $0.15 | Bingo $0 | Fortune $0 | Tax $0
Board [6c Ts 4s Th 2h]
Seat 1: 3e729116 (button) folded before Flop (didn't bet)
Seat 2: 3cdac696 (small blind) showed [Kd Ac] and lost with Pair of Tens
Seat 3: 84c13d8 (big blind) folded before Flop
Seat 4: 55e95fce folded before Flop
Seat 5: Hero showed [Kc Ks] and won ($12.73) with Pair of Kings and Pair of Tens
Seat 6: eb12374a folded before Flop (didn't bet)


Poker Hand #RC3141725390: Hold'em No Limit ($0.05/$0.1) - 2024/12/12 13:07:49
Table 'RushAndCash22320650' 6-max Seat #1 is the button
Seat 1: Hero ($14.17 in chips)
Seat 2: 6731d495 ($10.05 in chips)
Seat 3: 727f0a35 ($10.37 in chips)
Seat 4: 84c13d8 ($27.45 in chips)
Seat 5: 593f64c7 ($2.42 in chips)
Seat 6: dd68a104 ($17.21 in chips)
6731d495: posts small blind $0.05
727f0a35: posts big blind $0.1
*** HOLE CARDS ***
Dealt to Hero [7c 5d]
Dealt to 6731d495 
Dealt to 727f0a35 
Dealt to 84c13d8 
Dealt to 593f64c7 
Dealt to dd68a104 
84c13d8: folds
593f64c7: folds
dd68a104: folds
Hero: folds
6731d495: folds
Uncalled bet ($0.05) returned to 727f0a35
*** SHOWDOWN ***
727f0a35 collected $0.1 from pot
*** SUMMARY ***
Total pot $0.1 | Rake $0 | Jackpot $0 | Bingo $0 | Fortune $0 | Tax $0
Seat 1: Hero (button) folded before Flop (didn't bet)
Seat 2: 6731d495 (small blind) folded before Flop
Seat 3: 727f0a35 (big blind) collected ($0.1)
Seat 4: 84c13d8 folded before Flop (didn't bet)
Seat 5: 593f64c7 folded before Flop (didn't bet)
Seat 6: dd68a104 folded before Flop (didn't bet)


Poker Hand #RC3141725352: Hold'em No Limit ($0.05/$0.1) - 2024/12/12 13:07:40
Table 'RushAndCash22320612' 6-max Seat #1 is the button
Seat 1: d037fd58 ($12.48 in chips)
Seat 2: af208717 ($10.37 in chips)
Seat 3: Hero ($14.12 in chips)
Seat 4: 4b71434f ($10.15 in chips)
Seat 5: c4d674fe ($12.84 in chips)
Seat 6: 6904b57e ($18.65 in chips)
af208717: posts small blind $0.05
Hero: posts big blind $0.1
*** HOLE CARDS ***
Dealt to d037fd58 
Dealt to af208717 
Dealt to Hero [9h 4d]
Dealt to 4b71434f 
Dealt to c4d674fe 
Dealt to 6904b57e 
4b71434f: folds
c4d674fe: folds
6904b57e: folds
d037fd58: folds
af208717: folds
Uncalled bet ($0.05) returned to Hero
*** SHOWDOWN ***
Hero collected $0.1 from pot
*** SUMMARY ***
Total pot $0.1 | Rake $0 | Jackpot $0 | Bingo $0 | Fortune $0 | Tax $0
Seat 1: d037fd58 (button) folded before Flop (didn't bet)
Seat 2: af208717 (small blind) folded before Flop
Seat 3: Hero (big blind) collected ($0.1)
Seat 4: 4b71434f folded before Flop (didn't bet)
Seat 5: c4d674fe folded before Flop (didn't bet)
Seat 6: 6904b57e folded before Flop (didn't bet)


Poker Hand #RC3141725339: Hold'em No Limit ($0.05/$0.1) - 2024/12/12 13:07:36
Table 'RushAndCash22320599' 6-max Seat #1 is the button
Seat 1: b4bc8071 ($14.29 in chips)
Seat 2: Hero ($14.17 in chips)
Seat 3: cf64da1a ($36.38 in chips)
Seat 4: aecd8c87 ($10.66 in chips)
Seat 5: 68283690 ($18.61 in chips)
Seat 6: 1036e403 ($13.32 in chips)
Hero: posts small blind $0.05
cf64da1a: posts big blind $0.1
*** HOLE CARDS ***
Dealt to b4bc8071 
Dealt to Hero [5d 2d]
Dealt to cf64da1a 
Dealt to aecd8c87 
Dealt to 68283690 
Dealt to 1036e403 
aecd8c87: folds
68283690: folds
1036e403: raises $0.1 to $0.2
b4bc8071: folds
Hero: folds
cf64da1a: calls $0.1
*** FLOP *** [7h 9h Qd]
cf64da1a: checks
1036e403: bets $0.23
cf64da1a: folds
Uncalled bet ($0.23) returned to 1036e403
*** SHOWDOWN ***
1036e403 collected $0.43 from pot
*** SUMMARY ***
Total pot $0.45 | Rake $0.02 | Jackpot $0 | Bingo $0 | Fortune $0 | Tax $0
Board [7h 9h Qd]
Seat 1: b4bc8071 (button) folded before Flop (didn't bet)
Seat 2: Hero (small blind) folded before Flop
Seat 3: cf64da1a (big blind) folded on the Flop
Seat 4: aecd8c87 folded before Flop (didn't bet)
Seat 5: 68283690 folded before Flop (didn't bet)
Seat 6: 1036e403 won ($0.43)


Poker Hand #RC3141725323: Hold'em No Limit ($0.05/$0.1) - 2024/12/12 13:07:32
Table 'RushAndCash22320583' 6-max Seat #1 is the button
Seat 1: 8ebad06f ($10 in chips)
Seat 2: cf64da1a ($36.43 in chips)
Seat 3: 4cf26e8f ($10.48 in chips)
Seat 4: Hero ($14.17 in chips)
Seat 5: bc092e13 ($10.05 in chips)
Seat 6: 974940e1 ($11.83 in chips)
cf64da1a: posts small blind $0.05
4cf26e8f: posts big blind $0.1
*** HOLE CARDS ***
Dealt to 8ebad06f 
Dealt to cf64da1a 
Dealt to 4cf26e8f 
Dealt to Hero [4s Tc]
Dealt to bc092e13 
Dealt to 974940e1 
Hero: folds
bc092e13: folds
974940e1: folds
8ebad06f: folds
cf64da1a: folds
Uncalled bet ($0.05) returned to 4cf26e8f
*** SHOWDOWN ***
4cf26e8f collected $0.1 from pot
*** SUMMARY ***
Total pot $0.1 | Rake $0 | Jackpot $0 | Bingo $0 | Fortune $0 | Tax $0
Seat 1: 8ebad06f (button) folded before Flop (didn't bet)
Seat 2: cf64da1a (small blind) folded before Flop
Seat 3: 4cf26e8f (big blind) collected ($0.1)
Seat 4: Hero folded before Flop (didn't bet)
Seat 5: bc092e13 folded before Flop (didn't bet)
Seat 6: 974940e1 folded before Flop (didn't bet)


Poker Hand #RC3141725295: Hold'em No Limit ($0.05/$0.1) - 2024/12/12 13:07:25
Table 'RushAndCash22320555' 6-max Seat #1 is the button
Seat 1: Hero ($14.17 in chips)
Seat 2: 6b0057b1 ($10 in chips)
Seat 3: 5a1e5412 ($9.65 in chips)
Seat 4: 4b9faa96 ($10 in chips)
Seat 5: 1eed6c31 ($8.88 in chips)
Seat 6: 7b43c302 ($10 in chips)
6b0057b1: posts small blind $0.05
5a1e5412: posts big blind $0.1
*** HOLE CARDS ***
Dealt to Hero [8c Tc]
Dealt to 6b0057b1 
Dealt to 5a1e5412 
Dealt to 4b9faa96 
Dealt to 1eed6c31 
Dealt to 7b43c302 
4b9faa96: folds
1eed6c31: folds
7b43c302: folds
Hero: folds
6b0057b1: folds
Uncalled bet ($0.05) returned to 5a1e5412
*** SHOWDOWN ***
5a1e5412 collected $0.1 from pot
*** SUMMARY ***
Total pot $0.1 | Rake $0 | Jackpot $0 | Bingo $0 | Fortune $0 | Tax $0
Seat 1: Hero (button) folded before Flop (didn't bet)
Seat 2: 6b0057b1 (small blind) folded before Flop
Seat 3: 5a1e5412 (big blind) collected ($0.1)
Seat 4: 4b9faa96 folded before Flop (didn't bet)
Seat 5: 1eed6c31 folded before Flop (didn't bet)
Seat 6: 7b43c302 folded before Flop (didn't bet)


Poker Hand #RC3141725130: Hold'em No Limit ($0.05/$0.1) - 2024/12/12 13:06:47
Table 'RushAndCash22320390' 6-max Seat #1 is the button
Seat 1: 48f3df37 ($22.63 in chips)
Seat 2: 2c35e76a ($13.23 in chips)
Seat 3: Hero ($14.37 in chips)
Seat 4: 1cefc6e8 ($14.15 in chips)
Seat 5: 9ef3daf1 ($17.98 in chips)
Seat 6: 1eed6c31 ($8.65 in chips)
2c35e76a: posts small blind $0.05
Hero: posts big blind $0.1
*** HOLE CARDS ***
Dealt to 48f3df37 
Dealt to 2c35e76a 
Dealt to Hero [9s Ad]
Dealt to 1cefc6e8 
Dealt to 9ef3daf1 
Dealt to 1eed6c31 
1cefc6e8: folds
9ef3daf1: folds
1eed6c31: raises $0.1 to $0.2
48f3df37: folds
2c35e76a: folds
Hero: calls $0.1
*** FLOP *** [8c 2c Kh]
Hero: checks
1eed6c31: bets $0.23
Hero: folds
Uncalled bet ($0.23) returned to 1eed6c31
*** SHOWDOWN ***
1eed6c31 collected $0.43 from pot
*** SUMMARY ***
Total pot $0.45 | Rake $0.02 | Jackpot $0 | Bingo $0 | Fortune $0 | Tax $0
Board [8c 2c Kh]
Seat 1: 48f3df37 (button) folded before Flop (didn't bet)
Seat 2: 2c35e76a (small blind) folded before Flop
Seat 3: Hero (big blind) folded on the Flop
Seat 4: 1cefc6e8 folded before Flop (didn't bet)
Seat 5: 9ef3daf1 folded before Flop (didn't bet)
Seat 6: 1eed6c31 won ($0.43)


Poker Hand #RC3141725111: Hold'em No Limit ($0.05/$0.1) - 2024/12/12 13:06:42
Table 'RushAndCash22320371' 6-max Seat #1 is the button
Seat 1: 204f692c ($20.91 in chips)
Seat 2: 3f5e12f8 ($10.77 in chips)
Seat 3: 6904b57e ($18.02 in chips)
Seat 4: f564c212 ($11.23 in chips)
Seat 5: Hero ($14.37 in chips)
Seat 6: 637471ad ($10.42 in chips)
3f5e12f8: posts small blind $0.05
6904b57e: posts big blind $0.1
*** HOLE CARDS ***
Dealt to 204f692c 
Dealt to 3f5e12f8 
Dealt to 6904b57e 
Dealt to f564c212 
Dealt to Hero [Ts 6c]
Dealt to 637471ad 
f564c212: folds
Hero: folds
637471ad: raises $0.1 to $0.2
204f692c: folds
3f5e12f8: folds
6904b57e: folds
Uncalled bet ($0.1) returned to 637471ad
*** SHOWDOWN ***
637471ad collected $0.25 from pot
*** SUMMARY ***
Total pot $0.25 | Rake $0 | Jackpot $0 | Bingo $0 | Fortune $0 | Tax $0
Seat 1: 204f692c (button) folded before Flop (didn't bet)
Seat 2: 3f5e12f8 (small blind) folded before Flop
Seat 3: 6904b57e (big blind) folded before Flop
Seat 4: f564c212 folded before Flop (didn't bet)
Seat 5: Hero folded before Flop (didn't bet)
Seat 6: 637471ad collected ($0.25)


Poker Hand #RC3141725045: Hold'em No Limit ($0.05/$0.1) - 2024/12/12 13:06:26
Table 'RushAndCash22320305' 6-max Seat #1 is the button
Seat 1: 5bdc3e25 ($11.26 in chips)
Seat 2: Hero ($14.42 in chips)
Seat 3: b17f5bfe ($8.7 in chips)
Seat 4: 6731d495 ($10 in chips)
Seat 5: e2a23377 ($10.15 in chips)
Seat 6: 111c75 ($11.31 in chips)
Hero: posts small blind $0.05
b17f5bfe: posts big blind $0.1
*** HOLE CARDS ***
Dealt to 5bdc3e25 
Dealt to Hero [6c 4c]
Dealt to b17f5bfe 
Dealt to 6731d495 
Dealt to e2a23377 
Dealt to 111c75 
6731d495: folds
e2a23377: folds
111c75: raises $0.15 to $0.25
5bdc3e25: folds
Hero: folds
b17f5bfe: folds
Uncalled bet ($0.15) returned to 111c75
*** SHOWDOWN ***
111c75 collected $0.25 from pot
*** SUMMARY ***
Total pot $0.25 | Rake $0 | Jackpot $0 | Bingo $0 | Fortune $0 | Tax $0
Seat 1: 5bdc3e25 (button) folded before Flop (didn't bet)
Seat 2: Hero (small blind) folded before Flop
Seat 3: b17f5bfe (big blind) folded before Flop
Seat 4: 6731d495 folded before Flop (didn't bet)
Seat 5: e2a23377 folded before Flop (didn't bet)
Seat 6: 111c75 collected ($0.25)


Poker Hand #RC3141725031: Hold'em No Limit ($0.05/$0.1) - 2024/12/12 13:06:23
Table 'RushAndCash22320291' 6-max Seat #1 is the button
Seat 1: 593f64c7 ($2.47 in chips)
Seat 2: 5bdc3e25 ($11.31 in chips)
Seat 3: 5ab2e15d ($11.06 in chips)
Seat 4: b17f5bfe ($8.7 in chips)
Seat 5: c46a27c1 ($14.73 in chips)
Seat 6: Hero ($14.42 in chips)
5bdc3e25: posts small blind $0.05
5ab2e15d: posts big blind $0.1
*** HOLE CARDS ***
Dealt to 593f64c7 
Dealt to 5bdc3e25 
Dealt to 5ab2e15d 
Dealt to b17f5bfe 
Dealt to c46a27c1 
Dealt to Hero [5h 7s]
b17f5bfe: folds
c46a27c1: raises $0.1 to $0.2
Hero: folds
593f64c7: folds
5bdc3e25: folds
5ab2e15d: folds
Uncalled bet ($0.1) returned to c46a27c1
*** SHOWDOWN ***
c46a27c1 collected $0.25 from pot
*** SUMMARY ***
Total pot $0.25 | Rake $0 | Jackpot $0 | Bingo $0 | Fortune $0 | Tax $0
Seat 1: 593f64c7 (button) folded before Flop (didn't bet)
Seat 2: 5bdc3e25 (small blind) folded before Flop
Seat 3: 5ab2e15d (big blind) folded before Flop
Seat 4: b17f5bfe folded before Flop (didn't bet)
Seat 5: c46a27c1 collected ($0.25)
Seat 6: Hero folded before Flop (didn't bet)


Poker Hand #RC3141725020: Hold'em No Limit ($0.05/$0.1) - 2024/12/12 13:06:19
Table 'RushAndCash22320280' 6-max Seat #1 is the button
Seat 1: 2b1a7fe5 ($11.08 in chips)
Seat 2: f5628a04 ($15.84 in chips)
Seat 3: d037fd58 ($12.28 in chips)
Seat 4: bb09d73b ($4.35 in chips)
Seat 5: a0f1bc98 ($10.85 in chips)
Seat 6: Hero ($14.42 in chips)
f5628a04: posts small blind $0.05
d037fd58: posts big blind $0.1
*** HOLE CARDS ***
Dealt to 2b1a7fe5 
Dealt to f5628a04 
Dealt to d037fd58 
Dealt to bb09d73b 
Dealt to a0f1bc98 
Dealt to Hero [Qd 4d]
bb09d73b: folds
a0f1bc98: folds
Hero: folds
2b1a7fe5: folds
f5628a04: folds
Uncalled bet ($0.05) returned to d037fd58
*** SHOWDOWN ***
d037fd58 collected $0.1 from pot
*** SUMMARY ***
Total pot $0.1 | Rake $0 | Jackpot $0 | Bingo $0 | Fortune $0 | Tax $0
Seat 1: 2b1a7fe5 (button) folded before Flop (didn't bet)
Seat 2: f5628a04 (small blind) folded before Flop
Seat 3: d037fd58 (big blind) collected ($0.1)
Seat 4: bb09d73b folded before Flop (didn't bet)
Seat 5: a0f1bc98 folded before Flop (didn't bet)
Seat 6: Hero folded before Flop (didn't bet)


Poker Hand #RC3141725007: Hold'em No Limit ($0.05/$0.1) - 2024/12/12 13:06:16
Table 'RushAndCash22320267' 6-max Seat #1 is the button
Seat 1: b17f5bfe ($8.75 in chips)
Seat 2: Hero ($14.47 in chips)
Seat 3: bc8cb2ed ($6.33 in chips)
Seat 4: 701f843f ($9.73 in chips)
Seat 5: 2c35e76a ($13 in chips)
Seat 6: 2b1a7fe5 ($11.08 in chips)
Hero: posts small blind $0.05
bc8cb2ed: posts big blind $0.1
*** HOLE CARDS ***
Dealt to b17f5bfe 
Dealt to Hero [6h Qd]
Dealt to bc8cb2ed 
Dealt to 701f843f 
Dealt to 2c35e76a 
Dealt to 2b1a7fe5 
701f843f: folds
2c35e76a: folds
2b1a7fe5: folds
b17f5bfe: folds
Hero: folds
Uncalled bet ($0.05) returned to bc8cb2ed
*** SHOWDOWN ***
bc8cb2ed collected $0.1 from pot
*** SUMMARY ***
Total pot $0.1 | Rake $0 | Jackpot $0 | Bingo $0 | Fortune $0 | Tax $0
Seat 1: b17f5bfe (button) folded before Flop (didn't bet)
Seat 2: Hero (small blind) folded before Flop
Seat 3: bc8cb2ed (big blind) collected ($0.1)
Seat 4: 701f843f folded before Flop (didn't bet)
Seat 5: 2c35e76a folded before Flop (didn't bet)
Seat 6: 2b1a7fe5 folded before Flop (didn't bet)


Poker Hand #RC3141724993: Hold'em No Limit ($0.05/$0.1) - 2024/12/12 13:06:12
Table 'RushAndCash22320253' 6-max Seat #1 is the button
Seat 1: b73105eb ($10 in chips)
Seat 2: 719fb29e ($12.9 in chips)
Seat 3: 20a8d101 ($37.58 in chips)
Seat 4: Hero ($14.47 in chips)
Seat 5: 2b1a7fe5 ($11.08 in chips)
Seat 6: 794721cd ($10 in chips)
719fb29e: posts small blind $0.05
20a8d101: posts big blind $0.1
*** HOLE CARDS ***
Dealt to b73105eb 
Dealt to 719fb29e 
Dealt to 20a8d101 
Dealt to Hero [Kh 2d]
Dealt to 2b1a7fe5 
Dealt to 794721cd 
Hero: folds
2b1a7fe5: folds
794721cd: raises $0.15 to $0.25
b73105eb: folds
719fb29e: folds
20a8d101: calls $0.15
*** FLOP *** [Ad 3c 5c]
20a8d101: checks
794721cd: bets $0.2
20a8d101: calls $0.2
*** TURN *** [Ad 3c 5c] [8c]
20a8d101: checks
794721cd: checks
*** RIVER *** [Ad 3c 5c 8c] [Ks]
20a8d101: checks
794721cd: checks
20a8d101: shows [2s 2c] (Pair of Twos)
794721cd: shows [Ts Js] (Ace-High)
*** SHOWDOWN ***
20a8d101 collected $0.91 from pot
*** SUMMARY ***
Total pot $0.95 | Rake $0.04 | Jackpot $0 | Bingo $0 | Fortune $0 | Tax $0
Board [Ad 3c 5c 8c Ks]
Seat 1: b73105eb (button) folded before Flop (didn't bet)
Seat 2: 719fb29e (small blind) folded before Flop
Seat 3: 20a8d101 (big blind) showed [2s 2c] and won ($0.91) with Pair of Twos
Seat 4: Hero folded before Flop (didn't bet)
Seat 5: 2b1a7fe5 folded before Flop (didn't bet)
Seat 6: 794721cd showed [Ts Js] and lost with Ace-High


Poker Hand #RC3141724780: Hold'em No Limit ($0.05/$0.1) - 2024/12/12 13:05:16
Table 'RushAndCash22320040' 6-max Seat #1 is the button
Seat 1: 216abb36 ($10.35 in chips)
Seat 2: 7d40d863 ($11.55 in chips)
Seat 3: Hero ($15.61 in chips)
Seat 4: 2b1a7fe5 ($10 in chips)
Seat 5: c75bf164 ($7.71 in chips)
Seat 6: ae47099b ($13.73 in chips)
7d40d863: posts small blind $0.05
Hero: posts big blind $0.1
*** HOLE CARDS ***
Dealt to 216abb36 
Dealt to 7d40d863 
Dealt to Hero [Qc Tc]
Dealt to 2b1a7fe5 
Dealt to c75bf164 
Dealt to ae47099b 
2b1a7fe5: raises $0.15 to $0.25
c75bf164: folds
ae47099b: folds
216abb36: folds
7d40d863: folds
Hero: calls $0.15
*** FLOP *** [2s 7s 6c]
Hero: checks
2b1a7fe5: checks
*** TURN *** [2s 7s 6c] [7d]
Hero: bets $0.19
2b1a7fe5: calls $0.19
*** RIVER *** [2s 7s 6c 7d] [4c]
Hero: bets $0.7
2b1a7fe5: raises $1.82 to $2.52
Hero: folds
Uncalled bet ($1.82) returned to 2b1a7fe5
*** SHOWDOWN ***
2b1a7fe5 collected $2.22 from pot
*** SUMMARY ***
Total pot $2.33 | Rake $0.11 | Jackpot $0 | Bingo $0 | Fortune $0 | Tax $0
Board [2s 7s 6c 7d 4c]
Seat 1: 216abb36 (button) folded before Flop (didn't bet)
Seat 2: 7d40d863 (small blind) folded before Flop
Seat 3: Hero (big blind) folded on the River
Seat 4: 2b1a7fe5 won ($2.22)
Seat 5: c75bf164 folded before Flop (didn't bet)
Seat 6: ae47099b folded before Flop (didn't bet)


Poker Hand #RC3141674727: Hold'em No Limit ($0.05/$0.1) - 2024/12/12 13:05:01
Table 'RushAndCash22319987' 6-max Seat #1 is the button
Seat 1: Hero ($15.46 in chips)
Seat 2: afe10f69 ($10.13 in chips)
Seat 3: 2ff0a04b ($49.53 in chips)
Seat 4: b863ea8c ($23.48 in chips)
Seat 5: e40115b ($10.59 in chips)
Seat 6: cfe70ef2 ($10 in chips)
afe10f69: posts small blind $0.05
2ff0a04b: posts big blind $0.1
*** HOLE CARDS ***
Dealt to Hero [Qd 9c]
Dealt to afe10f69 
Dealt to 2ff0a04b 
Dealt to b863ea8c 
Dealt to e40115b 
Dealt to cfe70ef2 
b863ea8c: folds
e40115b: folds
cfe70ef2: folds
Hero: raises $0.15 to $0.25
afe10f69: folds
2ff0a04b: folds
Uncalled bet ($0.15) returned to Hero
*** SHOWDOWN ***
Hero collected $0.25 from pot
*** SUMMARY ***
Total pot $0.25 | Rake $0 | Jackpot $0 | Bingo $0 | Fortune $0 | Tax $0
Seat 1: Hero (button) collected ($0.25)
Seat 2: afe10f69 (small blind) folded before Flop
Seat 3: 2ff0a04b (big blind) folded before Flop
Seat 4: b863ea8c folded before Flop (didn't bet)
Seat 5: e40115b folded before Flop (didn't bet)
Seat 6: cfe70ef2 folded before Flop (didn't bet)


Poker Hand #RC3141674606: Hold'em No Limit ($0.05/$0.1) - 2024/12/12 13:04:26
Table 'RushAndCash22319866' 6-max Seat #1 is the button
Seat 1: 26077f2f ($10.6 in chips)
Seat 2: 36e85ed3 ($12.41 in chips)
Seat 3: 593f64c7 ($2.39 in chips)
Seat 4: Hero ($15.66 in chips)
Seat 5: 745c6911 ($13.34 in chips)
Seat 6: 1d2dacdf ($10.88 in chips)
36e85ed3: posts small blind $0.05
593f64c7: posts big blind $0.1
*** HOLE CARDS ***
Dealt to 26077f2f 
Dealt to 36e85ed3 
Dealt to 593f64c7 
Dealt to Hero [9s As]
Dealt to 745c6911 
Dealt to 1d2dacdf 
Hero: raises $0.1 to $0.2
745c6911: folds
1d2dacdf: raises $0.45 to $0.65
26077f2f: folds
36e85ed3: folds
593f64c7: folds
Hero: folds
Uncalled bet ($0.45) returned to 1d2dacdf
*** SHOWDOWN ***
1d2dacdf collected $0.53 from pot
*** SUMMARY ***
Total pot $0.55 | Rake $0.02 | Jackpot $0 | Bingo $0 | Fortune $0 | Tax $0
Seat 1: 26077f2f (button) folded before Flop (didn't bet)
Seat 2: 36e85ed3 (small blind) folded before Flop
Seat 3: 593f64c7 (big blind) folded before Flop
Seat 4: Hero folded before Flop
Seat 5: 745c6911 folded before Flop (didn't bet)
Seat 6: 1d2dacdf collected ($0.53)


Poker Hand #RC3141674592: Hold'em No Limit ($0.05/$0.1) - 2024/12/12 13:04:23
Table 'RushAndCash22319852' 6-max Seat #1 is the button
Seat 1: ff1406c1 ($15.63 in chips)
Seat 2: d4deed2f ($11.35 in chips)
Seat 3: 8424fd65 ($16.42 in chips)
Seat 4: 73e84fa ($29.16 in chips)
Seat 5: Hero ($15.66 in chips)
Seat 6: b73105eb ($10 in chips)
d4deed2f: posts small blind $0.05
8424fd65: posts big blind $0.1
*** HOLE CARDS ***
Dealt to ff1406c1 
Dealt to d4deed2f 
Dealt to 8424fd65 
Dealt to 73e84fa 
Dealt to Hero [9c Js]
Dealt to b73105eb 
73e84fa: folds
Hero: folds
b73105eb: raises $0.1 to $0.2
ff1406c1: folds
d4deed2f: folds
8424fd65: folds
Uncalled bet ($0.1) returned to b73105eb
*** SHOWDOWN ***
b73105eb collected $0.25 from pot
*** SUMMARY ***
Total pot $0.25 | Rake $0 | Jackpot $0 | Bingo $0 | Fortune $0 | Tax $0
Seat 1: ff1406c1 (button) folded before Flop (didn't bet)
Seat 2: d4deed2f (small blind) folded before Flop
Seat 3: 8424fd65 (big blind) folded before Flop
Seat 4: 73e84fa folded before Flop (didn't bet)
Seat 5: Hero folded before Flop (didn't bet)
Seat 6: b73105eb collected ($0.25)


Poker Hand #RC3141674537: Hold'em No Limit ($0.05/$0.1) - 2024/12/12 13:04:10
Table 'RushAndCash22319797' 6-max Seat #1 is the button
Seat 1: 893fb5b9 ($10.87 in chips)
Seat 2: Hero ($15.71 in chips)
Seat 3: c6786b68 ($13.47 in chips)
Seat 4: 37236510 ($4.54 in chips)
Seat 5: 2c35e76a ($13.6 in chips)
Seat 6: 66a73913 ($16.9 in chips)
Hero: posts small blind $0.05
c6786b68: posts big blind $0.1
*** HOLE CARDS ***
Dealt to 893fb5b9 
Dealt to Hero [9s Jc]
Dealt to c6786b68 
Dealt to 37236510 
Dealt to 2c35e76a 
Dealt to 66a73913 
37236510: raises $0.3 to $0.4
2c35e76a: raises $0.72 to $1.12
66a73913: folds
893fb5b9: folds
Hero: folds
c6786b68: folds
37236510: calls $0.72
*** FLOP *** [2h 5h Ah]
37236510: bets $2.39
2c35e76a: raises $10.09 to $12.48 and is all-in
37236510: calls $1.03 and is all-in
Uncalled bet ($9.06) returned to 2c35e76a
2c35e76a: shows [Qc Ac] (Pair of Aces)
37236510: shows [Qh Kh] (Ace High Flush)
*** TURN *** [2h 5h Ah] [7c]
*** RIVER *** [2h 5h Ah 7c] [8h]
*** SHOWDOWN ***
37236510 collected $8.78 from pot
*** SUMMARY ***
Total pot $9.23 | Rake $0.3 | Jackpot $0.15 | Bingo $0 | Fortune $0 | Tax $0
Board [2h 5h Ah 7c 8h]
Seat 1: 893fb5b9 (button) folded before Flop (didn't bet)
Seat 2: Hero (small blind) folded before Flop
Seat 3: c6786b68 (big blind) folded before Flop
Seat 4: 37236510 showed [Qh Kh] and won ($8.78) with Ace High Flush
Seat 5: 2c35e76a showed [Qc Ac] and lost with Pair of Aces
Seat 6: 66a73913 folded before Flop (didn't bet)


Poker Hand #RC3141674442: Hold'em No Limit ($0.05/$0.1) - 2024/12/12 13:03:49
Table 'RushAndCash22319702' 6-max Seat #1 is the button
Seat 1: c6786b68 ($13.47 in chips)
Seat 2: fe38852f ($10 in chips)
Seat 3: Hero ($15.81 in chips)
Seat 4: 17b5c9c3 ($11.21 in chips)
Seat 5: b73105eb ($10 in chips)
Seat 6: eb765b8f ($11.8 in chips)
fe38852f: posts small blind $0.05
Hero: posts big blind $0.1
*** HOLE CARDS ***
Dealt to c6786b68 
Dealt to fe38852f 
Dealt to Hero [2d Kd]
Dealt to 17b5c9c3 
Dealt to b73105eb 
Dealt to eb765b8f 
17b5c9c3: folds
b73105eb: folds
eb765b8f: raises $0.15 to $0.25
c6786b68: folds
fe38852f: folds
Hero: folds
Uncalled bet ($0.15) returned to eb765b8f
*** SHOWDOWN ***
eb765b8f collected $0.25 from pot
*** SUMMARY ***
Total pot $0.25 | Rake $0 | Jackpot $0 | Bingo $0 | Fortune $0 | Tax $0
Seat 1: c6786b68 (button) folded before Flop (didn't bet)
Seat 2: fe38852f (small blind) folded before Flop
Seat 3: Hero (big blind) folded before Flop
Seat 4: 17b5c9c3 folded before Flop (didn't bet)
Seat 5: b73105eb folded before Flop (didn't bet)
Seat 6: eb765b8f collected ($0.25)


Poker Hand #RC3141674427: Hold'em No Limit ($0.05/$0.1) - 2024/12/12 13:03:45
Table 'RushAndCash22319687' 6-max Seat #1 is the button
Seat 1: 506e90c1 ($10 in chips)
Seat 2: b738541f ($13.12 in chips)
Seat 3: 47ae29b2 ($10.15 in chips)
Seat 4: 17b5c9c3 ($11.21 in chips)
Seat 5: eb765b8f ($11.8 in chips)
Seat 6: Hero ($15.81 in chips)
b738541f: posts small blind $0.05
47ae29b2: posts big blind $0.1
*** HOLE CARDS ***
Dealt to 506e90c1 
Dealt to b738541f 
Dealt to 47ae29b2 
Dealt to 17b5c9c3 
Dealt to eb765b8f 
Dealt to Hero [8s 2s]
17b5c9c3: folds
eb765b8f: folds
Hero: folds
506e90c1: raises $0.15 to $0.25
b738541f: folds
47ae29b2: folds
Uncalled bet ($0.15) returned to 506e90c1
*** SHOWDOWN ***
506e90c1 collected $0.25 from pot
*** SUMMARY ***
Total pot $0.25 | Rake $0 | Jackpot $0 | Bingo $0 | Fortune $0 | Tax $0
Seat 1: 506e90c1 (button) collected ($0.25)
Seat 2: b738541f (small blind) folded before Flop
Seat 3: 47ae29b2 (big blind) folded before Flop
Seat 4: 17b5c9c3 folded before Flop (didn't bet)
Seat 5: eb765b8f folded before Flop (didn't bet)
Seat 6: Hero folded before Flop (didn't bet)


Poker Hand #RC3141674412: Hold'em No Limit ($0.05/$0.1) - 2024/12/12 13:03:42
Table 'RushAndCash22319672' 6-max Seat #1 is the button
Seat 1: Hero ($15.81 in chips)
Seat 2: f5628a04 ($15.76 in chips)
Seat 3: dea77808 ($10.97 in chips)
Seat 4: 727f0a35 ($10.74 in chips)
Seat 5: 3e729116 ($10.3 in chips)
Seat 6: b9ea8dd9 ($4.85 in chips)
f5628a04: posts small blind $0.05
dea77808: posts big blind $0.1
*** HOLE CARDS ***
Dealt to Hero [Qd 3c]
Dealt to f5628a04 
Dealt to dea77808 
Dealt to 727f0a35 
Dealt to 3e729116 
Dealt to b9ea8dd9 
727f0a35: raises $0.2 to $0.3
3e729116: folds
b9ea8dd9: folds
Hero: folds
f5628a04: raises $0.9 to $1.2
dea77808: folds
727f0a35: calls $0.9
*** FLOP *** [Kd 2s Qh]
f5628a04: bets $0.7
727f0a35: folds
Uncalled bet ($0.7) returned to f5628a04
*** SHOWDOWN ***
f5628a04 collected $2.38 from pot
*** SUMMARY ***
Total pot $2.5 | Rake $0.12 | Jackpot $0 | Bingo $0 | Fortune $0 | Tax $0
Board [Kd 2s Qh]
Seat 1: Hero (button) folded before Flop (didn't bet)
Seat 2: f5628a04 (small blind) won ($2.38)
Seat 3: dea77808 (big blind) folded before Flop
Seat 4: 727f0a35 folded on the Flop
Seat 5: 3e729116 folded before Flop (didn't bet)
Seat 6: b9ea8dd9 folded before Flop (didn't bet)


Poker Hand #RC3141674398: Hold'em No Limit ($0.05/$0.1) - 2024/12/12 13:03:38
Table 'RushAndCash22319658' 6-max Seat #1 is the button
Seat 1: cc07b659 ($10.28 in chips)
Seat 2: 73e84fa ($29.67 in chips)
Seat 3: bc2007a2 ($17.58 in chips)
Seat 4: 88a9583f ($43.94 in chips)
Seat 5: Hero ($15.81 in chips)
Seat 6: 74b4c8de ($14.5 in chips)
73e84fa: posts small blind $0.05
bc2007a2: posts big blind $0.1
*** HOLE CARDS ***
Dealt to cc07b659 
Dealt to 73e84fa 
Dealt to bc2007a2 
Dealt to 88a9583f 
Dealt to Hero [5c 9d]
Dealt to 74b4c8de 
88a9583f: raises $0.1 to $0.2
Hero: folds
74b4c8de: folds
cc07b659: calls $0.2
73e84fa: folds
bc2007a2: calls $0.1
*** FLOP *** [7c 8c Js]
bc2007a2: checks
88a9583f: checks
cc07b659: bets $0.21
bc2007a2: folds
88a9583f: folds
Uncalled bet ($0.21) returned to cc07b659
*** SHOWDOWN ***
cc07b659 collected $0.62 from pot
*** SUMMARY ***
Total pot $0.65 | Rake $0.03 | Jackpot $0 | Bingo $0 | Fortune $0 | Tax $0
Board [7c 8c Js]
Seat 1: cc07b659 (button) won ($0.62)
Seat 2: 73e84fa (small blind) folded before Flop
Seat 3: bc2007a2 (big blind) folded on the Flop
Seat 4: 88a9583f folded on the Flop
Seat 5: Hero folded before Flop (didn't bet)
Seat 6: 74b4c8de folded before Flop (didn't bet)


Poker Hand #RC3141674351: Hold'em No Limit ($0.05/$0.1) - 2024/12/12 13:03:25
Table 'RushAndCash22319611' 6-max Seat #1 is the button
Seat 1: 58f45f04 ($11.32 in chips)
Seat 2: 727f0a35 ($10.79 in chips)
Seat 3: 721d2ee6 ($14.31 in chips)
Seat 4: Hero ($15.66 in chips)
Seat 5: 1e25b5bb ($15.07 in chips)
Seat 6: f564c212 ($10 in chips)
727f0a35: posts small blind $0.05
721d2ee6: posts big blind $0.1
*** HOLE CARDS ***
Dealt to 58f45f04 
Dealt to 727f0a35 
Dealt to 721d2ee6 
Dealt to Hero [Ah Qd]
Dealt to 1e25b5bb 
Dealt to f564c212 
Hero: raises $0.1 to $0.2
1e25b5bb: folds
f564c212: folds
58f45f04: folds
727f0a35: folds
721d2ee6: folds
Uncalled bet ($0.1) returned to Hero
*** SHOWDOWN ***
Hero collected $0.25 from pot
*** SUMMARY ***
Total pot $0.25 | Rake $0 | Jackpot $0 | Bingo $0 | Fortune $0 | Tax $0
Seat 1: 58f45f04 (button) folded before Flop (didn't bet)
Seat 2: 727f0a35 (small blind) folded before Flop
Seat 3: 721d2ee6 (big blind) folded before Flop
Seat 4: Hero collected ($0.25)
Seat 5: 1e25b5bb folded before Flop (didn't bet)
Seat 6: f564c212 folded before Flop (didn't bet)


Poker Hand #RC3141674336: Hold'em No Limit ($0.05/$0.1) - 2024/12/12 13:03:22
Table 'RushAndCash22319596' 6-max Seat #1 is the button
Seat 1: 88fddf8e ($11.18 in chips)
Seat 2: 3b12e634 ($12.1 in chips)
Seat 3: f564c212 ($10 in chips)
Seat 4: 59363533 ($6.29 in chips)
Seat 5: Hero ($15.66 in chips)
Seat 6: caa14983 ($12.65 in chips)
3b12e634: posts small blind $0.05
f564c212: posts big blind $0.1
*** HOLE CARDS ***
Dealt to 88fddf8e 
Dealt to 3b12e634 
Dealt to f564c212 
Dealt to 59363533 
Dealt to Hero [Qd 7c]
Dealt to caa14983 
59363533: raises $0.1 to $0.2
Hero: folds
caa14983: calls $0.2
88fddf8e: folds
3b12e634: calls $0.15
f564c212: folds
*** FLOP *** [2d Kc 4s]
3b12e634: checks
59363533: checks
caa14983: checks
*** TURN *** [2d Kc 4s] [9h]
3b12e634: bets $0.24
59363533: calls $0.24
caa14983: folds
*** RIVER *** [2d Kc 4s 9h] [Ah]
3b12e634: checks
59363533: checks
3b12e634: shows [Ad 5s] (Pair of Aces)
59363533: shows [9c Qc] (Pair of Nines)
*** SHOWDOWN ***
3b12e634 collected $1.13 from pot
*** SUMMARY ***
Total pot $1.18 | Rake $0.05 | Jackpot $0 | Bingo $0 | Fortune $0 | Tax $0
Board [2d Kc 4s 9h Ah]
Seat 1: 88fddf8e (button) folded before Flop (didn't bet)
Seat 2: 3b12e634 (small blind) showed [Ad 5s] and won ($1.13) with Pair of Aces
Seat 3: f564c212 (big blind) folded before Flop
Seat 4: 59363533 showed [9c Qc] and lost with Pair of Nines
Seat 5: Hero folded before Flop (didn't bet)
Seat 6: caa14983 folded on the Turn


Poker Hand #RC3141674127: Hold'em No Limit ($0.05/$0.1) - 2024/12/12 13:02:28
Table 'RushAndCash22319387' 6-max Seat #1 is the button
Seat 1: Hero ($15.91 in chips)
Seat 2: 228a039d ($14.11 in chips)
Seat 3: 88fddf8e ($10.9 in chips)
Seat 4: 2edfec7c ($4.42 in chips)
Seat 5: 844091a0 ($10 in chips)
Seat 6: 95a503e1 ($14.75 in chips)
228a039d: posts small blind $0.05
88fddf8e: posts big blind $0.1
*** HOLE CARDS ***
Dealt to Hero [Tc As]
Dealt to 228a039d 
Dealt to 88fddf8e 
Dealt to 2edfec7c 
Dealt to 844091a0 
Dealt to 95a503e1 
2edfec7c: folds
844091a0: folds
95a503e1: folds
Hero: raises $0.15 to $0.25
228a039d: folds
88fddf8e: calls $0.15
*** FLOP *** [5h 7d 6d]
88fddf8e: checks
Hero: checks
*** TURN *** [5h 7d 6d] [6s]
88fddf8e: bets $0.69
Hero: folds
Uncalled bet ($0.69) returned to 88fddf8e
*** SHOWDOWN ***
88fddf8e collected $0.53 from pot
*** SUMMARY ***
Total pot $0.55 | Rake $0.02 | Jackpot $0 | Bingo $0 | Fortune $0 | Tax $0
Board [5h 7d 6d 6s]
Seat 1: Hero (button) folded on the Turn
Seat 2: 228a039d (small blind) folded before Flop
Seat 3: 88fddf8e (big blind) won ($0.53)
Seat 4: 2edfec7c folded before Flop (didn't bet)
Seat 5: 844091a0 folded before Flop (didn't bet)
Seat 6: 95a503e1 folded before Flop (didn't bet)


Poker Hand #RC3141673902: Hold'em No Limit ($0.05/$0.1) - 2024/12/12 13:01:34
Table 'RushAndCash22319162' 6-max Seat #1 is the button
Seat 1: 6a8aff3d ($32.4 in chips)
Seat 2: cfe70ef2 ($10 in chips)
Seat 3: Hero ($16.11 in chips)
Seat 4: d9ccf407 ($10.13 in chips)
Seat 5: 73d90cc7 ($12 in chips)
Seat 6: 88fddf8e ($10.67 in chips)
cfe70ef2: posts small blind $0.05
Hero: posts big blind $0.1
*** HOLE CARDS ***
Dealt to 6a8aff3d 
Dealt to cfe70ef2 
Dealt to Hero [5c 4c]
Dealt to d9ccf407 
Dealt to 73d90cc7 
Dealt to 88fddf8e 
d9ccf407: folds
73d90cc7: folds
88fddf8e: raises $0.1 to $0.2
6a8aff3d: folds
cfe70ef2: folds
Hero: calls $0.1
*** FLOP *** [2h Kd Ts]
Hero: checks
88fddf8e: checks
*** TURN *** [2h Kd Ts] [9s]
Hero: checks
88fddf8e: bets $0.2
Hero: folds
Uncalled bet ($0.2) returned to 88fddf8e
*** SHOWDOWN ***
88fddf8e collected $0.43 from pot
*** SUMMARY ***
Total pot $0.45 | Rake $0.02 | Jackpot $0 | Bingo $0 | Fortune $0 | Tax $0
Board [2h Kd Ts 9s]
Seat 1: 6a8aff3d (button) folded before Flop (didn't bet)
Seat 2: cfe70ef2 (small blind) folded before Flop
Seat 3: Hero (big blind) folded on the Turn
Seat 4: d9ccf407 folded before Flop (didn't bet)
Seat 5: 73d90cc7 folded before Flop (didn't bet)
Seat 6: 88fddf8e won ($0.43)


Poker Hand #RC3141673885: Hold'em No Limit ($0.05/$0.1) - 2024/12/12 13:01:30
Table 'RushAndCash22319145' 6-max Seat #1 is the button
Seat 1: ec7ff353 ($10 in chips)
Seat 2: Hero ($16.16 in chips)
Seat 3: 9dd125fd ($12.09 in chips)
Seat 4: cc07b659 ($10 in chips)
Seat 5: 6b0057b1 ($10.44 in chips)
Seat 6: 216abb36 ($10.48 in chips)
Hero: posts small blind $0.05
9dd125fd: posts big blind $0.1
*** HOLE CARDS ***
Dealt to ec7ff353 
Dealt to Hero [Td 2c]
Dealt to 9dd125fd 
Dealt to cc07b659 
Dealt to 6b0057b1 
Dealt to 216abb36 
cc07b659: folds
6b0057b1: folds
216abb36: raises $0.15 to $0.25
ec7ff353: folds
Hero: folds
9dd125fd: folds
Uncalled bet ($0.15) returned to 216abb36
*** SHOWDOWN ***
216abb36 collected $0.25 from pot
*** SUMMARY ***
Total pot $0.25 | Rake $0 | Jackpot $0 | Bingo $0 | Fortune $0 | Tax $0
Seat 1: ec7ff353 (button) folded before Flop (didn't bet)
Seat 2: Hero (small blind) folded before Flop
Seat 3: 9dd125fd (big blind) folded before Flop
Seat 4: cc07b659 folded before Flop (didn't bet)
Seat 5: 6b0057b1 folded before Flop (didn't bet)
Seat 6: 216abb36 collected ($0.25)


Poker Hand #RC3141673869: Hold'em No Limit ($0.05/$0.1) - 2024/12/12 13:01:27
Table 'RushAndCash22319129' 6-max Seat #1 is the button
Seat 1: 4d1634eb ($11.71 in chips)
Seat 2: 1cefc6e8 ($13.55 in chips)
Seat 3: 8424fd65 ($15.01 in chips)
Seat 4: b2132e5f ($13.98 in chips)
Seat 5: d43f1d14 ($10.25 in chips)
Seat 6: Hero ($16.16 in chips)
1cefc6e8: posts small blind $0.05
8424fd65: posts big blind $0.1
*** HOLE CARDS ***
Dealt to 4d1634eb 
Dealt to 1cefc6e8 
Dealt to 8424fd65 
Dealt to b2132e5f 
Dealt to d43f1d14 
Dealt to Hero [5c Ks]
b2132e5f: folds
d43f1d14: raises $0.15 to $0.25
Hero: folds
4d1634eb: calls $0.25
1cefc6e8: folds
8424fd65: folds
*** FLOP *** [8d Jd 6s]
d43f1d14: checks
4d1634eb: bets $0.22
d43f1d14: folds
Uncalled bet ($0.22) returned to 4d1634eb
*** SHOWDOWN ***
4d1634eb collected $0.62 from pot
*** SUMMARY ***
Total pot $0.65 | Rake $0.03 | Jackpot $0 | Bingo $0 | Fortune $0 | Tax $0
Board [8d Jd 6s]
Seat 1: 4d1634eb (button) won ($0.62)
Seat 2: 1cefc6e8 (small blind) folded before Flop
Seat 3: 8424fd65 (big blind) folded before Flop
Seat 4: b2132e5f folded before Flop (didn't bet)
Seat 5: d43f1d14 folded on the Flop
Seat 6: Hero folded before Flop (didn't bet)


Poker Hand #RC3141673855: Hold'em No Limit ($0.05/$0.1) - 2024/12/12 13:01:23
Table 'RushAndCash22319115' 6-max Seat #1 is the button
Seat 1: Hero ($16.16 in chips)
Seat 2: bb835227 ($11.8 in chips)
Seat 3: d6974a94 ($34.36 in chips)
Seat 4: 97a1e12e ($22.13 in chips)
Seat 5: 8424fd65 ($15.01 in chips)
Seat 6: 5ddf2544 ($24.24 in chips)
bb835227: posts small blind $0.05
d6974a94: posts big blind $0.1
*** HOLE CARDS ***
Dealt to Hero [2h 6h]
Dealt to bb835227 
Dealt to d6974a94 
Dealt to 97a1e12e 
Dealt to 8424fd65 
Dealt to 5ddf2544 
97a1e12e: folds
8424fd65: folds
5ddf2544: folds
Hero: folds
bb835227: raises $0.2 to $0.3
d6974a94: folds
Uncalled bet ($0.2) returned to bb835227
*** SHOWDOWN ***
bb835227 collected $0.2 from pot
*** SUMMARY ***
Total pot $0.2 | Rake $0 | Jackpot $0 | Bingo $0 | Fortune $0 | Tax $0
Seat 1: Hero (button) folded before Flop (didn't bet)
Seat 2: bb835227 (small blind) collected ($0.2)
Seat 3: d6974a94 (big blind) folded before Flop
Seat 4: 97a1e12e folded before Flop (didn't bet)
Seat 5: 8424fd65 folded before Flop (didn't bet)
Seat 6: 5ddf2544 folded before Flop (didn't bet)


Poker Hand #RC3141673824: Hold'em No Limit ($0.05/$0.1) - 2024/12/12 13:01:16
Table 'RushAndCash22319084' 6-max Seat #1 is the button
Seat 1: 968b2ad6 ($13.1 in chips)
Seat 2: 2db5d1cb ($12.26 in chips)
Seat 3: 73e84fa ($29.15 in chips)
Seat 4: 12b883d0 ($28.49 in chips)
Seat 5: Hero ($16.16 in chips)
Seat 6: c46a27c1 ($14.61 in chips)
2db5d1cb: posts small blind $0.05
73e84fa: posts big blind $0.1
*** HOLE CARDS ***
Dealt to 968b2ad6 
Dealt to 2db5d1cb 
Dealt to 73e84fa 
Dealt to 12b883d0 
Dealt to Hero [5c 5d]
Dealt to c46a27c1 
12b883d0: raises $0.1 to $0.2
Hero: folds
c46a27c1: folds
968b2ad6: folds
2db5d1cb: folds
73e84fa: calls $0.1
*** FLOP *** [2h Jh 3s]
73e84fa: checks
12b883d0: bets $0.15
73e84fa: raises $0.39 to $0.54
12b883d0: calls $0.39
*** TURN *** [2h Jh 3s] [9c]
73e84fa: bets $1.11
12b883d0: folds
Uncalled bet ($1.11) returned to 73e84fa
*** SHOWDOWN ***
73e84fa collected $1.46 from pot
*** SUMMARY ***
Total pot $1.53 | Rake $0.07 | Jackpot $0 | Bingo $0 | Fortune $0 | Tax $0
Board [2h Jh 3s 9c]
Seat 1: 968b2ad6 (button) folded before Flop (didn't bet)
Seat 2: 2db5d1cb (small blind) folded before Flop
Seat 3: 73e84fa (big blind) won ($1.46)
Seat 4: 12b883d0 folded on the Turn
Seat 5: Hero folded before Flop (didn't bet)
Seat 6: c46a27c1 folded before Flop (didn't bet)


Poker Hand #RC3141673787: Hold'em No Limit ($0.05/$0.1) - 2024/12/12 13:01:07
Table 'RushAndCash22319047' 6-max Seat #1 is the button
Seat 1: b2132e5f ($14.08 in chips)
Seat 2: Hero ($16.21 in chips)
Seat 3: 1c087ec5 ($40.68 in chips)
Seat 4: caa14983 ($10.82 in chips)
Seat 5: dd68a104 ($11.76 in chips)
Seat 6: c6786b68 ($15.44 in chips)
Hero: posts small blind $0.05
1c087ec5: posts big blind $0.1
*** HOLE CARDS ***
Dealt to b2132e5f 
Dealt to Hero [7c Qh]
Dealt to 1c087ec5 
Dealt to caa14983 
Dealt to dd68a104 
Dealt to c6786b68 
caa14983: folds
dd68a104: raises $0.1 to $0.2
c6786b68: folds
b2132e5f: folds
Hero: folds
1c087ec5: folds
Uncalled bet ($0.1) returned to dd68a104
*** SHOWDOWN ***
dd68a104 collected $0.25 from pot
*** SUMMARY ***
Total pot $0.25 | Rake $0 | Jackpot $0 | Bingo $0 | Fortune $0 | Tax $0
Seat 1: b2132e5f (button) folded before Flop (didn't bet)
Seat 2: Hero (small blind) folded before Flop
Seat 3: 1c087ec5 (big blind) folded before Flop
Seat 4: caa14983 folded before Flop (didn't bet)
Seat 5: dd68a104 collected ($0.25)
Seat 6: c6786b68 folded before Flop (didn't bet)


Poker Hand #RC3141673747: Hold'em No Limit ($0.05/$0.1) - 2024/12/12 13:00:58
Table 'RushAndCash22319007' 6-max Seat #1 is the button
Seat 1: f5628a04 ($16.63 in chips)
Seat 2: 73e84fa ($29.25 in chips)
Seat 3: Hero ($16.16 in chips)
Seat 4: 295cc1bc ($13.14 in chips)
Seat 5: 86ee8e36 ($28.53 in chips)
Seat 6: c86d72c6 ($6.62 in chips)
73e84fa: posts small blind $0.05
Hero: posts big blind $0.1
*** HOLE CARDS ***
Dealt to f5628a04 
Dealt to 73e84fa 
Dealt to Hero [Ah 2c]
Dealt to 295cc1bc 
Dealt to 86ee8e36 
Dealt to c86d72c6 
295cc1bc: folds
86ee8e36: folds
c86d72c6: folds
f5628a04: folds
73e84fa: folds
Uncalled bet ($0.05) returned to Hero
*** SHOWDOWN ***
Hero collected $0.1 from pot
*** SUMMARY ***
Total pot $0.1 | Rake $0 | Jackpot $0 | Bingo $0 | Fortune $0 | Tax $0
Seat 1: f5628a04 (button) folded before Flop (didn't bet)
Seat 2: 73e84fa (small blind) folded before Flop
Seat 3: Hero (big blind) collected ($0.1)
Seat 4: 295cc1bc folded before Flop (didn't bet)
Seat 5: 86ee8e36 folded before Flop (didn't bet)
Seat 6: c86d72c6 folded before Flop (didn't bet)


Poker Hand #RC3141673593: Hold'em No Limit ($0.05/$0.1) - 2024/12/12 13:00:22
Table 'RushAndCash22318853' 6-max Seat #1 is the button
Seat 1: 22ee6f58 ($10.36 in chips)
Seat 2: d6974a94 ($34.41 in chips)
Seat 3: bc8cb2ed ($5.09 in chips)
Seat 4: 88133657 ($10 in chips)
Seat 5: Hero ($15.93 in chips)
Seat 6: 9cfbee05 ($10 in chips)
d6974a94: posts small blind $0.05
bc8cb2ed: posts big blind $0.1
*** HOLE CARDS ***
Dealt to 22ee6f58 
Dealt to d6974a94 
Dealt to bc8cb2ed 
Dealt to 88133657 
Dealt to Hero [As 3s]
Dealt to 9cfbee05 
88133657: folds
Hero: raises $0.1 to $0.2
9cfbee05: folds
22ee6f58: folds
d6974a94: folds
bc8cb2ed: calls $0.1
*** FLOP *** [3d 2d 7s]
bc8cb2ed: checks
Hero: bets $0.15
bc8cb2ed: folds
Uncalled bet ($0.15) returned to Hero
*** SHOWDOWN ***
Hero collected $0.43 from pot
*** SUMMARY ***
Total pot $0.45 | Rake $0.02 | Jackpot $0 | Bingo $0 | Fortune $0 | Tax $0
Board [3d 2d 7s]
Seat 1: 22ee6f58 (button) folded before Flop (didn't bet)
Seat 2: d6974a94 (small blind) folded before Flop
Seat 3: bc8cb2ed (big blind) folded on the Flop
Seat 4: 88133657 folded before Flop (didn't bet)
Seat 5: Hero won ($0.43)
Seat 6: 9cfbee05 folded before Flop (didn't bet)


Poker Hand #RC3141673516: Hold'em No Limit ($0.05/$0.1) - 2024/12/12 13:00:03
Table 'RushAndCash22318776' 6-max Seat #1 is the button
Seat 1: ebfcde93 ($10 in chips)
Seat 2: 26077f2f ($10.33 in chips)
Seat 3: 3c989a00 ($16.82 in chips)
Seat 4: Hero ($16.13 in chips)
Seat 5: b4bc8071 ($10.49 in chips)
Seat 6: 1aa8c909 ($10.78 in chips)
26077f2f: posts small blind $0.05
3c989a00: posts big blind $0.1
*** HOLE CARDS ***
Dealt to ebfcde93 
Dealt to 26077f2f 
Dealt to 3c989a00 
Dealt to Hero [8c 8h]
Dealt to b4bc8071 
Dealt to 1aa8c909 
Hero: raises $0.1 to $0.2
b4bc8071: folds
1aa8c909: raises $0.4 to $0.6
ebfcde93: raises $1.2 to $1.8
26077f2f: folds
3c989a00: folds
Hero: folds
1aa8c909: calls $1.2
*** FLOP *** [6s 5c 7d]
1aa8c909: checks
ebfcde93: bets $1.51
1aa8c909: folds
Uncalled bet ($1.51) returned to ebfcde93
*** SHOWDOWN ***
ebfcde93 collected $3.61 from pot
*** SUMMARY ***
Total pot $3.95 | Rake $0.19 | Jackpot $0.15 | Bingo $0 | Fortune $0 | Tax $0
Board [6s 5c 7d]
Seat 1: ebfcde93 (button) won ($3.61)
Seat 2: 26077f2f (small blind) folded before Flop
Seat 3: 3c989a00 (big blind) folded before Flop
Seat 4: Hero folded before Flop
Seat 5: b4bc8071 folded before Flop (didn't bet)
Seat 6: 1aa8c909 folded on the Flop


Poker Hand #RC3141673502: Hold'em No Limit ($0.05/$0.1) - 2024/12/12 12:59:59
Table 'RushAndCash22318762' 6-max Seat #1 is the button
Seat 1: a730cdce ($10.64 in chips)
Seat 2: 226dbbb0 ($10 in chips)
Seat 3: a3d9ddb9 ($11.55 in chips)
Seat 4: 26077f2f ($10.33 in chips)
Seat 5: Hero ($16.13 in chips)
Seat 6: a2fc0fa3 ($10.13 in chips)
226dbbb0: posts small blind $0.05
a3d9ddb9: posts big blind $0.1
*** HOLE CARDS ***
Dealt to a730cdce 
Dealt to 226dbbb0 
Dealt to a3d9ddb9 
Dealt to 26077f2f 
Dealt to Hero [4d 5s]
Dealt to a2fc0fa3 
26077f2f: folds
Hero: folds
a2fc0fa3: raises $0.15 to $0.25
a730cdce: folds
226dbbb0: folds
a3d9ddb9: calls $0.15
*** FLOP *** [3s Th Ac]
a3d9ddb9: checks
a2fc0fa3: bets $0.42
a3d9ddb9: calls $0.42
*** TURN *** [3s Th Ac] [Jh]
a3d9ddb9: checks
a2fc0fa3: bets $1.39
a3d9ddb9: folds
Uncalled bet ($1.39) returned to a2fc0fa3
*** SHOWDOWN ***
a2fc0fa3 collected $1.32 from pot
*** SUMMARY ***
Total pot $1.39 | Rake $0.07 | Jackpot $0 | Bingo $0 | Fortune $0 | Tax $0
Board [3s Th Ac Jh]
Seat 1: a730cdce (button) folded before Flop (didn't bet)
Seat 2: 226dbbb0 (small blind) folded before Flop
Seat 3: a3d9ddb9 (big blind) folded on the Turn
Seat 4: 26077f2f folded before Flop (didn't bet)
Seat 5: Hero folded before Flop (didn't bet)
Seat 6: a2fc0fa3 won ($1.32)


Poker Hand #RC3141673487: Hold'em No Limit ($0.05/$0.1) - 2024/12/12 12:59:56
Table 'RushAndCash22318747' 6-max Seat #1 is the button
Seat 1: cb6a7240 ($10.32 in chips)
Seat 2: 2a6446ed ($17.07 in chips)
Seat 3: 8efbf75 ($9.85 in chips)
Seat 4: Hero ($16.13 in chips)
Seat 5: d9ccf407 ($10.33 in chips)
Seat 6: a4bd4854 ($10 in chips)
2a6446ed: posts small blind $0.05
8efbf75: posts big blind $0.1
*** HOLE CARDS ***
Dealt to cb6a7240 
Dealt to 2a6446ed 
Dealt to 8efbf75 
Dealt to Hero [5s 2h]
Dealt to d9ccf407 
Dealt to a4bd4854 
Hero: folds
d9ccf407: folds
a4bd4854: folds
cb6a7240: raises $0.1 to $0.2
2a6446ed: raises $0.7 to $0.9
8efbf75: folds
cb6a7240: raises $1.3 to $2.2
2a6446ed: folds
Uncalled bet ($1.3) returned to cb6a7240
*** SHOWDOWN ***
cb6a7240 collected $1.81 from pot
*** SUMMARY ***
Total pot $1.9 | Rake $0.09 | Jackpot $0 | Bingo $0 | Fortune $0 | Tax $0
Seat 1: cb6a7240 (button) collected ($1.81)
Seat 2: 2a6446ed (small blind) folded before Flop
Seat 3: 8efbf75 (big blind) folded before Flop
Seat 4: Hero folded before Flop (didn't bet)
Seat 5: d9ccf407 folded before Flop (didn't bet)
Seat 6: a4bd4854 folded before Flop (didn't bet)


Poker Hand #RC3141673415: Hold'em No Limit ($0.05/$0.1) - 2024/12/12 12:59:36
Table 'RushAndCash22318675' 6-max Seat #1 is the button
Seat 1: caa81877 ($6.83 in chips)
Seat 2: 619e7abb ($6.87 in chips)
Seat 3: c46a27c1 ($12.84 in chips)
Seat 4: 2fb13304 ($12.16 in chips)
Seat 5: 7d40d863 ($9.85 in chips)
Seat 6: Hero ($16.38 in chips)
619e7abb: posts small blind $0.05
c46a27c1: posts big blind $0.1
*** HOLE CARDS ***
Dealt to caa81877 
Dealt to 619e7abb 
Dealt to c46a27c1 
Dealt to 2fb13304 
Dealt to 7d40d863 
Dealt to Hero [Kd Qs]
2fb13304: folds
7d40d863: folds
Hero: raises $0.15 to $0.25
caa81877: folds
619e7abb: raises $0.85 to $1.1
c46a27c1: folds
Hero: folds
Uncalled bet ($0.85) returned to 619e7abb
*** SHOWDOWN ***
619e7abb collected $0.57 from pot
*** SUMMARY ***
Total pot $0.6 | Rake $0.03 | Jackpot $0 | Bingo $0 | Fortune $0 | Tax $0
Seat 1: caa81877 (button) folded before Flop (didn't bet)
Seat 2: 619e7abb (small blind) collected ($0.57)
Seat 3: c46a27c1 (big blind) folded before Flop
Seat 4: 2fb13304 folded before Flop (didn't bet)
Seat 5: 7d40d863 folded before Flop (didn't bet)
Seat 6: Hero folded before Flop


Poker Hand #RC3141673402: Hold'em No Limit ($0.05/$0.1) - 2024/12/12 12:59:33
Table 'RushAndCash22318662' 6-max Seat #1 is the button
Seat 1: Hero ($16.38 in chips)
Seat 2: 6904b57e ($10.43 in chips)
Seat 3: 9a7505e ($12.35 in chips)
Seat 4: 2ff36f92 ($7.73 in chips)
Seat 5: 1ecd1474 ($11.19 in chips)
Seat 6: 2441c176 ($10.74 in chips)
6904b57e: posts small blind $0.05
9a7505e: posts big blind $0.1
*** HOLE CARDS ***
Dealt to Hero [Qh 5d]
Dealt to 6904b57e 
Dealt to 9a7505e 
Dealt to 2ff36f92 
Dealt to 1ecd1474 
Dealt to 2441c176 
2ff36f92: raises $0.12 to $0.22
1ecd1474: folds
2441c176: folds
Hero: folds
6904b57e: raises $0.62 to $0.84
9a7505e: folds
2ff36f92: raises $6.89 to $7.73 and is all-in
6904b57e: calls $6.89
2ff36f92: shows [9h 9s]
6904b57e: shows [Ah As]
*** FLOP *** [9c 4d 3c]
*** TURN *** [9c 4d 3c] [8s]
*** RIVER *** [9c 4d 3c 8s] [Ac]
*** SHOWDOWN ***
6904b57e collected $15.11 from pot
*** SUMMARY ***
Total pot $15.56 | Rake $0.3 | Jackpot $0.15 | Bingo $0 | Fortune $0 | Tax $0
Board [9c 4d 3c 8s Ac]
Seat 1: Hero (button) folded before Flop (didn't bet)
Seat 2: 6904b57e (small blind) showed [Ah As] and won ($15.11) with Three Aces
Seat 3: 9a7505e (big blind) folded before Flop
Seat 4: 2ff36f92 showed [9h 9s] and lost with Three Nines
Seat 5: 1ecd1474 folded before Flop (didn't bet)
Seat 6: 2441c176 folded before Flop (didn't bet)


Poker Hand #RC3141673373: Hold'em No Limit ($0.05/$0.1) - 2024/12/12 12:59:25
Table 'RushAndCash22318633' 6-max Seat #1 is the button
Seat 1: a7936163 ($14.46 in chips)
Seat 2: Hero ($16.43 in chips)
Seat 3: e896e324 ($10 in chips)
Seat 4: ce410800 ($19.26 in chips)
Seat 5: 66f3bea2 ($10.15 in chips)
Seat 6: ab081f1e ($10 in chips)
Hero: posts small blind $0.05
e896e324: posts big blind $0.1
*** HOLE CARDS ***
Dealt to a7936163 
Dealt to Hero [Ts 2d]
Dealt to e896e324 
Dealt to ce410800 
Dealt to 66f3bea2 
Dealt to ab081f1e 
ce410800: folds
66f3bea2: folds
ab081f1e: raises $0.1 to $0.2
a7936163: folds
Hero: folds
e896e324: calls $0.1
*** FLOP *** [2c Js Qh]
e896e324: checks
ab081f1e: bets $0.23
e896e324: calls $0.23
*** TURN *** [2c Js Qh] [9s]
e896e324: checks
ab081f1e: bets $0.46
e896e324: calls $0.46
*** RIVER *** [2c Js Qh 9s] [7d]
e896e324: checks
ab081f1e: checks
e896e324: shows [Qd 8d] (Pair of Queens)
ab081f1e: shows [Qc Ac] (Pair of Queens)
*** SHOWDOWN ***
ab081f1e collected $1.74 from pot
*** SUMMARY ***
Total pot $1.83 | Rake $0.09 | Jackpot $0 | Bingo $0 | Fortune $0 | Tax $0
Board [2c Js Qh 9s 7d]
Seat 1: a7936163 (button) folded before Flop (didn't bet)
Seat 2: Hero (small blind) folded before Flop
Seat 3: e896e324 (big blind) showed [Qd 8d] and lost with Pair of Queens
Seat 4: ce410800 folded before Flop (didn't bet)
Seat 5: 66f3bea2 folded before Flop (didn't bet)
Seat 6: ab081f1e showed [Qc Ac] and won ($1.74) with Pair of Queens


Poker Hand #RC3141673337: Hold'em No Limit ($0.05/$0.1) - 2024/12/12 12:59:17
Table 'RushAndCash22318597' 6-max Seat #1 is the button
Seat 1: 902b9d1a ($8.7 in chips)
Seat 2: 2c35e76a ($11.27 in chips)
Seat 3: Hero ($16.53 in chips)
Seat 4: d07ab82c ($12.08 in chips)
Seat 5: 6904b57e ($10.48 in chips)
Seat 6: 721d2ee6 ($14.69 in chips)
2c35e76a: posts small blind $0.05
Hero: posts big blind $0.1
*** HOLE CARDS ***
Dealt to 902b9d1a 
Dealt to 2c35e76a 
Dealt to Hero [4d 9s]
Dealt to d07ab82c 
Dealt to 6904b57e 
Dealt to 721d2ee6 
d07ab82c: folds
6904b57e: folds
721d2ee6: raises $0.14 to $0.24
902b9d1a: folds
2c35e76a: folds
Hero: folds
Uncalled bet ($0.14) returned to 721d2ee6
*** SHOWDOWN ***
721d2ee6 collected $0.25 from pot
*** SUMMARY ***
Total pot $0.25 | Rake $0 | Jackpot $0 | Bingo $0 | Fortune $0 | Tax $0
Seat 1: 902b9d1a (button) folded before Flop (didn't bet)
Seat 2: 2c35e76a (small blind) folded before Flop
Seat 3: Hero (big blind) folded before Flop
Seat 4: d07ab82c folded before Flop (didn't bet)
Seat 5: 6904b57e folded before Flop (didn't bet)
Seat 6: 721d2ee6 collected ($0.25)


Poker Hand #RC3141673321: Hold'em No Limit ($0.05/$0.1) - 2024/12/12 12:59:13
Table 'RushAndCash22318581' 6-max Seat #1 is the button
Seat 1: caa14983 ($10.25 in chips)
Seat 2: 264523b9 ($10.16 in chips)
Seat 3: d1764387 ($14.01 in chips)
Seat 4: af208717 ($10.74 in chips)
Seat 5: e60f3780 ($12.21 in chips)
Seat 6: Hero ($16.53 in chips)
264523b9: posts small blind $0.05
d1764387: posts big blind $0.1
*** HOLE CARDS ***
Dealt to caa14983 
Dealt to 264523b9 
Dealt to d1764387 
Dealt to af208717 
Dealt to e60f3780 
Dealt to Hero [5h Kc]
af208717: raises $0.1 to $0.2
e60f3780: folds
Hero: folds
caa14983: folds
264523b9: folds
d1764387: folds
Uncalled bet ($0.1) returned to af208717
*** SHOWDOWN ***
af208717 collected $0.25 from pot
*** SUMMARY ***
Total pot $0.25 | Rake $0 | Jackpot $0 | Bingo $0 | Fortune $0 | Tax $0
Seat 1: caa14983 (button) folded before Flop (didn't bet)
Seat 2: 264523b9 (small blind) folded before Flop
Seat 3: d1764387 (big blind) folded before Flop
Seat 4: af208717 collected ($0.25)
Seat 5: e60f3780 folded before Flop (didn't bet)
Seat 6: Hero folded before Flop (didn't bet)


Poker Hand #RC3141673304: Hold'em No Limit ($0.05/$0.1) - 2024/12/12 12:59:10
Table 'RushAndCash22318564' 6-max Seat #1 is the button
Seat 1: a9eb45fc ($10.95 in chips)
Seat 2: cb8dca6d ($10.02 in chips)
Seat 3: d9ccf407 ($10.1 in chips)
Seat 4: Hero ($16.53 in chips)
Seat 5: 59363533 ($9.94 in chips)
Seat 6: af208717 ($10.74 in chips)
cb8dca6d: posts small blind $0.05
d9ccf407: posts big blind $0.1
*** HOLE CARDS ***
Dealt to a9eb45fc 
Dealt to cb8dca6d 
Dealt to d9ccf407 
Dealt to Hero [Qs Tc]
Dealt to 59363533 
Dealt to af208717 
Hero: folds
59363533: raises $0.1 to $0.2
af208717: folds
a9eb45fc: folds
cb8dca6d: folds
d9ccf407: calls $0.1
*** FLOP *** [2c 8d 2d]
d9ccf407: checks
59363533: checks
*** TURN *** [2c 8d 2d] [6c]
d9ccf407: bets $0.23
59363533: folds
Uncalled bet ($0.23) returned to d9ccf407
*** SHOWDOWN ***
d9ccf407 collected $0.43 from pot
*** SUMMARY ***
Total pot $0.45 | Rake $0.02 | Jackpot $0 | Bingo $0 | Fortune $0 | Tax $0
Board [2c 8d 2d 6c]
Seat 1: a9eb45fc (button) folded before Flop (didn't bet)
Seat 2: cb8dca6d (small blind) folded before Flop
Seat 3: d9ccf407 (big blind) won ($0.43)
Seat 4: Hero folded before Flop (didn't bet)
Seat 5: 59363533 folded on the Turn
Seat 6: af208717 folded before Flop (didn't bet)


Poker Hand #RC3141673289: Hold'em No Limit ($0.05/$0.1) - 2024/12/12 12:59:06
Table 'RushAndCash22318549' 6-max Seat #1 is the button
Seat 1: Hero ($16.53 in chips)
Seat 2: 6c4ba3fb ($13.56 in chips)
Seat 3: 25c1f7d7 ($10.21 in chips)
Seat 4: 4682aa5c ($10 in chips)
Seat 5: caa14983 ($10.25 in chips)
Seat 6: 84cc5caa ($10.64 in chips)
6c4ba3fb: posts small blind $0.05
25c1f7d7: posts big blind $0.1
*** HOLE CARDS ***
Dealt to Hero [2c 5d]
Dealt to 6c4ba3fb 
Dealt to 25c1f7d7 
Dealt to 4682aa5c 
Dealt to caa14983 
Dealt to 84cc5caa 
4682aa5c: folds
caa14983: folds
84cc5caa: folds
Hero: folds
6c4ba3fb: folds
Uncalled bet ($0.05) returned to 25c1f7d7
*** SHOWDOWN ***
25c1f7d7 collected $0.1 from pot
*** SUMMARY ***
Total pot $0.1 | Rake $0 | Jackpot $0 | Bingo $0 | Fortune $0 | Tax $0
Seat 1: Hero (button) folded before Flop (didn't bet)
Seat 2: 6c4ba3fb (small blind) folded before Flop
Seat 3: 25c1f7d7 (big blind) collected ($0.1)
Seat 4: 4682aa5c folded before Flop (didn't bet)
Seat 5: caa14983 folded before Flop (didn't bet)
Seat 6: 84cc5caa folded before Flop (didn't bet)


Poker Hand #RC3141673273: Hold'em No Limit ($0.05/$0.1) - 2024/12/12 12:59:03
Table 'RushAndCash22318533' 6-max Seat #1 is the button
Seat 1: 1677a3f4 ($15.04 in chips)
Seat 2: Hero ($16.58 in chips)
Seat 3: ead6156b ($5.61 in chips)
Seat 4: 1cefc6e8 ($13.7 in chips)
Seat 5: 7bad2adb ($10 in chips)
Seat 6: a730cdce ($10.79 in chips)
Hero: posts small blind $0.05
ead6156b: posts big blind $0.1
*** HOLE CARDS ***
Dealt to 1677a3f4 
Dealt to Hero [9h 5c]
Dealt to ead6156b 
Dealt to 1cefc6e8 
Dealt to 7bad2adb 
Dealt to a730cdce 
1cefc6e8: folds
7bad2adb: folds
a730cdce: folds
1677a3f4: raises $0.2 to $0.3
Hero: folds
ead6156b: folds
Uncalled bet ($0.2) returned to 1677a3f4
*** SHOWDOWN ***
1677a3f4 collected $0.25 from pot
*** SUMMARY ***
Total pot $0.25 | Rake $0 | Jackpot $0 | Bingo $0 | Fortune $0 | Tax $0
Seat 1: 1677a3f4 (button) collected ($0.25)
Seat 2: Hero (small blind) folded before Flop
Seat 3: ead6156b (big blind) folded before Flop
Seat 4: 1cefc6e8 folded before Flop (didn't bet)
Seat 5: 7bad2adb folded before Flop (didn't bet)
Seat 6: a730cdce folded before Flop (didn't bet)


Poker Hand #RC3141673192: Hold'em No Limit ($0.05/$0.1) - 2024/12/12 12:58:45
Table 'RushAndCash22318452' 6-max Seat #1 is the button
Seat 1: 17b381d5 ($34.22 in chips)
Seat 2: ab081f1e ($10 in chips)
Seat 3: Hero ($16.68 in chips)
Seat 4: 6c4ba3fb ($13.41 in chips)
Seat 5: ec7ff353 ($12.4 in chips)
Seat 6: 36e85ed3 ($10 in chips)
ab081f1e: posts small blind $0.05
Hero: posts big blind $0.1
*** HOLE CARDS ***
Dealt to 17b381d5 
Dealt to ab081f1e 
Dealt to Hero [4d 2h]
Dealt to 6c4ba3fb 
Dealt to ec7ff353 
Dealt to 36e85ed3 
6c4ba3fb: raises $0.1 to $0.2
ec7ff353: folds
36e85ed3: folds
17b381d5: folds
ab081f1e: folds
Hero: folds
Uncalled bet ($0.1) returned to 6c4ba3fb
*** SHOWDOWN ***
6c4ba3fb collected $0.25 from pot
*** SUMMARY ***
Total pot $0.25 | Rake $0 | Jackpot $0 | Bingo $0 | Fortune $0 | Tax $0
Seat 1: 17b381d5 (button) folded before Flop (didn't bet)
Seat 2: ab081f1e (small blind) folded before Flop
Seat 3: Hero (big blind) folded before Flop
Seat 4: 6c4ba3fb collected ($0.25)
Seat 5: ec7ff353 folded before Flop (didn't bet)
Seat 6: 36e85ed3 folded before Flop (didn't bet)


Poker Hand #RC3141672953: Hold'em No Limit ($0.05/$0.1) - 2024/12/12 12:57:45
Table 'RushAndCash22318213' 6-max Seat #1 is the button
Seat 1: 6c4ba3fb ($14.83 in chips)
Seat 2: b4bc8071 ($10.46 in chips)
Seat 3: 83a198b3 ($10.37 in chips)
Seat 4: 88133657 ($10.16 in chips)
Seat 5: Hero ($15.21 in chips)
Seat 6: 88fddf8e ($10 in chips)
b4bc8071: posts small blind $0.05
83a198b3: posts big blind $0.1
*** HOLE CARDS ***
Dealt to 6c4ba3fb 
Dealt to b4bc8071 
Dealt to 83a198b3 
Dealt to 88133657 
Dealt to Hero [Qs As]
Dealt to 88fddf8e 
88133657: raises $0.1 to $0.2
Hero: raises $0.42 to $0.62
88fddf8e: folds
6c4ba3fb: calls $0.62
b4bc8071: folds
83a198b3: folds
88133657: folds
*** FLOP *** [2h Qc 8d]
Hero: checks
6c4ba3fb: bets $0.8
Hero: calls $0.8
*** TURN *** [2h Qc 8d] [5s]
Hero: checks
6c4ba3fb: checks
*** RIVER *** [2h Qc 8d 5s] [7c]
Hero: bets $1.5
6c4ba3fb: folds
Uncalled bet ($1.5) returned to Hero
*** SHOWDOWN ***
Hero collected $2.89 from pot
*** SUMMARY ***
Total pot $3.19 | Rake $0.15 | Jackpot $0.15 | Bingo $0 | Fortune $0 | Tax $0
Board [2h Qc 8d 5s 7c]
Seat 1: 6c4ba3fb (button) folded on the River
Seat 2: b4bc8071 (small blind) folded before Flop
Seat 3: 83a198b3 (big blind) folded before Flop
Seat 4: 88133657 folded before Flop
Seat 5: Hero won ($2.89)
Seat 6: 88fddf8e folded before Flop (didn't bet)


Poker Hand #RC3141672929: Hold'em No Limit ($0.05/$0.1) - 2024/12/12 12:57:40
Table 'RushAndCash22318189' 6-max Seat #1 is the button
Seat 1: 974f52 ($35.77 in chips)
Seat 2: b2132e5f ($14.67 in chips)
Seat 3: 5ab2e15d ($10 in chips)
Seat 4: 526323fa ($10 in chips)
Seat 5: 24c2159e ($10 in chips)
Seat 6: Hero ($15.21 in chips)
b2132e5f: posts small blind $0.05
5ab2e15d: posts big blind $0.1
*** HOLE CARDS ***
Dealt to 974f52 
Dealt to b2132e5f 
Dealt to 5ab2e15d 
Dealt to 526323fa 
Dealt to 24c2159e 
Dealt to Hero [Js 5h]
526323fa: folds
24c2159e: folds
Hero: folds
974f52: folds
b2132e5f: folds
Uncalled bet ($0.05) returned to 5ab2e15d
*** SHOWDOWN ***
5ab2e15d collected $0.1 from pot
*** SUMMARY ***
Total pot $0.1 | Rake $0 | Jackpot $0 | Bingo $0 | Fortune $0 | Tax $0
Seat 1: 974f52 (button) folded before Flop (didn't bet)
Seat 2: b2132e5f (small blind) folded before Flop
Seat 3: 5ab2e15d (big blind) collected ($0.1)
Seat 4: 526323fa folded before Flop (didn't bet)
Seat 5: 24c2159e folded before Flop (didn't bet)
Seat 6: Hero folded before Flop (didn't bet)


Poker Hand #RC3141672914: Hold'em No Limit ($0.05/$0.1) - 2024/12/12 12:57:37
Table 'RushAndCash22318174' 6-max Seat #1 is the button
Seat 1: 24c2159e ($10 in chips)
Seat 2: 5ddf2544 ($13.4 in chips)
Seat 3: 6904b57e ($10.07 in chips)
Seat 4: 526323fa ($10 in chips)
Seat 5: Hero ($15.21 in chips)
Seat 6: 89d15c60 ($11.9 in chips)
5ddf2544: posts small blind $0.05
6904b57e: posts big blind $0.1
*** HOLE CARDS ***
Dealt to 24c2159e 
Dealt to 5ddf2544 
Dealt to 6904b57e 
Dealt to 526323fa 
Dealt to Hero [4d 5c]
Dealt to 89d15c60 
526323fa: folds
Hero: folds
89d15c60: folds
24c2159e: folds
5ddf2544: raises $0.18 to $0.28
6904b57e: folds
Uncalled bet ($0.18) returned to 5ddf2544
*** SHOWDOWN ***
5ddf2544 collected $0.2 from pot
*** SUMMARY ***
Total pot $0.2 | Rake $0 | Jackpot $0 | Bingo $0 | Fortune $0 | Tax $0
Seat 1: 24c2159e (button) folded before Flop (didn't bet)
Seat 2: 5ddf2544 (small blind) collected ($0.2)
Seat 3: 6904b57e (big blind) folded before Flop
Seat 4: 526323fa folded before Flop (didn't bet)
Seat 5: Hero folded before Flop (didn't bet)
Seat 6: 89d15c60 folded before Flop (didn't bet)


Poker Hand #RC3141672901: Hold'em No Limit ($0.05/$0.1) - 2024/12/12 12:57:33
Table 'RushAndCash22318161' 6-max Seat #1 is the button
Seat 1: Hero ($15.21 in chips)
Seat 2: ed5538ab ($13.12 in chips)
Seat 3: a6717311 ($22.63 in chips)
Seat 4: 4bddf600 ($9.19 in chips)
Seat 5: 2b1a7fe5 ($17.82 in chips)
Seat 6: 974f52 ($35.77 in chips)
ed5538ab: posts small blind $0.05
a6717311: posts big blind $0.1
*** HOLE CARDS ***
Dealt to Hero [4h 9s]
Dealt to ed5538ab 
Dealt to a6717311 
Dealt to 4bddf600 
Dealt to 2b1a7fe5 
Dealt to 974f52 
4bddf600: folds
2b1a7fe5: folds
974f52: folds
Hero: folds
ed5538ab: raises $0.2 to $0.3
a6717311: calls $0.2
*** FLOP *** [2h 5s 5c]
ed5538ab: checks
a6717311: bets $0.2
ed5538ab: calls $0.2
*** TURN *** [2h 5s 5c] [8h]
ed5538ab: checks
a6717311: bets $1.25
ed5538ab: folds
Uncalled bet ($1.25) returned to a6717311
*** SHOWDOWN ***
a6717311 collected $0.95 from pot
*** SUMMARY ***
Total pot $1 | Rake $0.05 | Jackpot $0 | Bingo $0 | Fortune $0 | Tax $0
Board [2h 5s 5c 8h]
Seat 1: Hero (button) folded before Flop (didn't bet)
Seat 2: ed5538ab (small blind) folded on the Turn
Seat 3: a6717311 (big blind) won ($0.95)
Seat 4: 4bddf600 folded before Flop (didn't bet)
Seat 5: 2b1a7fe5 folded before Flop (didn't bet)
Seat 6: 974f52 folded before Flop (didn't bet)


Poker Hand #RC3141672859: Hold'em No Limit ($0.05/$0.1) - 2024/12/12 12:57:23
Table 'RushAndCash22318119' 6-max Seat #1 is the button
Seat 1: 916c6bd3 ($14.9 in chips)
Seat 2: Hero ($15.26 in chips)
Seat 3: 27c51518 ($23.03 in chips)
Seat 4: 60b2f955 ($10 in chips)
Seat 5: b2132e5f ($14.52 in chips)
Seat 6: f383ae87 ($23.81 in chips)
Hero: posts small blind $0.05
27c51518: posts big blind $0.1
*** HOLE CARDS ***
Dealt to 916c6bd3 
Dealt to Hero [4h 4d]
Dealt to 27c51518 
Dealt to 60b2f955 
Dealt to b2132e5f 
Dealt to f383ae87 
60b2f955: folds
b2132e5f: raises $0.15 to $0.25
f383ae87: folds
916c6bd3: folds
Hero: folds
27c51518: folds
Uncalled bet ($0.15) returned to b2132e5f
*** SHOWDOWN ***
b2132e5f collected $0.25 from pot
*** SUMMARY ***
Total pot $0.25 | Rake $0 | Jackpot $0 | Bingo $0 | Fortune $0 | Tax $0
Seat 1: 916c6bd3 (button) folded before Flop (didn't bet)
Seat 2: Hero (small blind) folded before Flop
Seat 3: 27c51518 (big blind) folded before Flop
Seat 4: 60b2f955 folded before Flop (didn't bet)
Seat 5: b2132e5f collected ($0.25)
Seat 6: f383ae87 folded before Flop (didn't bet)


Poker Hand #RC3141672624: Hold'em No Limit ($0.05/$0.1) - 2024/12/12 12:56:22
Table 'RushAndCash22317884' 6-max Seat #1 is the button
Seat 1: c199627b ($7.63 in chips)
Seat 2: 27c51518 ($22.62 in chips)
Seat 3: Hero ($15.71 in chips)
Seat 4: 2ff36f92 ($10.13 in chips)
Seat 5: aaca7529 ($6.96 in chips)
Seat 6: 4898aa10 ($30.79 in chips)
27c51518: posts small blind $0.05
Hero: posts big blind $0.1
*** HOLE CARDS ***
Dealt to c199627b 
Dealt to 27c51518 
Dealt to Hero [4d 4s]
Dealt to 2ff36f92 
Dealt to aaca7529 
Dealt to 4898aa10 
2ff36f92: folds
aaca7529: folds
4898aa10: folds
c199627b: folds
27c51518: raises $0.2 to $0.3
Hero: calls $0.2
*** FLOP *** [8s 5d Qh]
27c51518: bets $0.15
Hero: calls $0.15
*** TURN *** [8s 5d Qh] [Jd]
27c51518: checks
Hero: checks
*** RIVER *** [8s 5d Qh Jd] [8c]
27c51518: bets $0.23
Hero: folds
Uncalled bet ($0.23) returned to 27c51518
*** SHOWDOWN ***
27c51518 collected $0.86 from pot
*** SUMMARY ***
Total pot $0.9 | Rake $0.04 | Jackpot $0 | Bingo $0 | Fortune $0 | Tax $0
Board [8s 5d Qh Jd 8c]
Seat 1: c199627b (button) folded before Flop (didn't bet)
Seat 2: 27c51518 (small blind) won ($0.86)
Seat 3: Hero (big blind) folded on the River
Seat 4: 2ff36f92 folded before Flop (didn't bet)
Seat 5: aaca7529 folded before Flop (didn't bet)
Seat 6: 4898aa10 folded before Flop (didn't bet)


Poker Hand #RC3141672612: Hold'em No Limit ($0.05/$0.1) - 2024/12/12 12:56:19
Table 'RushAndCash22317872' 6-max Seat #1 is the button
Seat 1: c199627b ($7.63 in chips)
Seat 2: 5b14e7af ($27.28 in chips)
Seat 3: 844091a0 ($12.75 in chips)
Seat 4: a9eb45fc ($11.28 in chips)
Seat 5: Hero ($15.71 in chips)
Seat 6: 1cefc6e8 ($12.82 in chips)
5b14e7af: posts small blind $0.05
844091a0: posts big blind $0.1
*** HOLE CARDS ***
Dealt to c199627b 
Dealt to 5b14e7af 
Dealt to 844091a0 
Dealt to a9eb45fc 
Dealt to Hero [9h 7c]
Dealt to 1cefc6e8 
a9eb45fc: folds
Hero: folds
1cefc6e8: folds
c199627b: folds
5b14e7af: folds
Uncalled bet ($0.05) returned to 844091a0
*** SHOWDOWN ***
844091a0 collected $0.1 from pot
*** SUMMARY ***
Total pot $0.1 | Rake $0 | Jackpot $0 | Bingo $0 | Fortune $0 | Tax $0
Seat 1: c199627b (button) folded before Flop (didn't bet)
Seat 2: 5b14e7af (small blind) folded before Flop
Seat 3: 844091a0 (big blind) collected ($0.1)
Seat 4: a9eb45fc folded before Flop (didn't bet)
Seat 5: Hero folded before Flop (didn't bet)
Seat 6: 1cefc6e8 folded before Flop (didn't bet)


Poker Hand #RC3141672593: Hold'em No Limit ($0.05/$0.1) - 2024/12/12 12:56:14
Table 'RushAndCash22317853' 6-max Seat #1 is the button
Seat 1: 6a8aff3d ($34.72 in chips)
Seat 2: e12528c0 ($31.64 in chips)
Seat 3: cacc74b2 ($12.65 in chips)
Seat 4: Hero ($15.71 in chips)
Seat 5: f323cdf3 ($12.62 in chips)
Seat 6: f0c37558 ($16.34 in chips)
e12528c0: posts small blind $0.05
cacc74b2: posts big blind $0.1
*** HOLE CARDS ***
Dealt to 6a8aff3d 
Dealt to e12528c0 
Dealt to cacc74b2 
Dealt to Hero [2c 6h]
Dealt to f323cdf3 
Dealt to f0c37558 
Hero: folds
f323cdf3: raises $0.1 to $0.2
f0c37558: folds
6a8aff3d: calls $0.2
e12528c0: folds
cacc74b2: calls $0.1
*** FLOP *** [9s 2h Ah]
cacc74b2: checks
f323cdf3: checks
6a8aff3d: bets $0.51
cacc74b2: folds
f323cdf3: calls $0.51
*** TURN *** [9s 2h Ah] [3h]
f323cdf3: checks
6a8aff3d: checks
*** RIVER *** [9s 2h Ah 3h] [4h]
f323cdf3: bets $0.4
6a8aff3d: calls $0.4
f323cdf3: shows [Ad 4d] (Pair of Aces and Pair of Fours)
6a8aff3d: shows [5d 9d] (Fives-High Straight)
*** SHOWDOWN ***
6a8aff3d collected $2.35 from pot
*** SUMMARY ***
Total pot $2.47 | Rake $0.12 | Jackpot $0 | Bingo $0 | Fortune $0 | Tax $0
Board [9s 2h Ah 3h 4h]
Seat 1: 6a8aff3d (button) showed [5d 9d] and won ($2.35) with Fives-High Straight
Seat 2: e12528c0 (small blind) folded before Flop
Seat 3: cacc74b2 (big blind) folded on the Flop
Seat 4: Hero folded before Flop (didn't bet)
Seat 5: f323cdf3 showed [Ad 4d] and lost with Pair of Aces and Pair of Fours
Seat 6: f0c37558 folded before Flop (didn't bet)


Poker Hand #RC3141672498: Hold'em No Limit ($0.05/$0.1) - 2024/12/12 12:55:50
Table 'RushAndCash22317758' 6-max Seat #1 is the button
Seat 1: 73d90cc7 ($13.08 in chips)
Seat 2: Hero ($15.76 in chips)
Seat 3: 5b982aa5 ($15.13 in chips)
Seat 4: 3c75bc00 ($36.35 in chips)
Seat 5: 5e5bf12a ($8.24 in chips)
Seat 6: 643f85e7 ($12.64 in chips)
Hero: posts small blind $0.05
5b982aa5: posts big blind $0.1
*** HOLE CARDS ***
Dealt to 73d90cc7 
Dealt to Hero [Kd Qs]
Dealt to 5b982aa5 
Dealt to 3c75bc00 
Dealt to 5e5bf12a 
Dealt to 643f85e7 
3c75bc00: folds
5e5bf12a: raises $0.15 to $0.25
643f85e7: folds
73d90cc7: folds
Hero: folds
5b982aa5: folds
Uncalled bet ($0.15) returned to 5e5bf12a
*** SHOWDOWN ***
5e5bf12a collected $0.25 from pot
*** SUMMARY ***
Total pot $0.25 | Rake $0 | Jackpot $0 | Bingo $0 | Fortune $0 | Tax $0
Seat 1: 73d90cc7 (button) folded before Flop (didn't bet)
Seat 2: Hero (small blind) folded before Flop
Seat 3: 5b982aa5 (big blind) folded before Flop
Seat 4: 3c75bc00 folded before Flop (didn't bet)
Seat 5: 5e5bf12a collected ($0.25)
Seat 6: 643f85e7 folded before Flop (didn't bet)


Poker Hand #RC3141672485: Hold'em No Limit ($0.05/$0.1) - 2024/12/12 12:55:47
Table 'RushAndCash22317745' 6-max Seat #1 is the button
Seat 1: 5ddf2544 ($13.54 in chips)
Seat 2: 73d90cc7 ($13.13 in chips)
Seat 3: 5346f1e0 ($11.29 in chips)
Seat 4: 79af8002 ($10 in chips)
Seat 5: Hero ($15.76 in chips)
Seat 6: 974f52 ($36.59 in chips)
73d90cc7: posts small blind $0.05
5346f1e0: posts big blind $0.1
*** HOLE CARDS ***
Dealt to 5ddf2544 
Dealt to 73d90cc7 
Dealt to 5346f1e0 
Dealt to 79af8002 
Dealt to Hero [5c Tc]
Dealt to 974f52 
79af8002: folds
Hero: folds
974f52: raises $0.1 to $0.2
5ddf2544: folds
73d90cc7: folds
5346f1e0: calls $0.1
*** FLOP *** [2s Ks Qs]
5346f1e0: checks
974f52: bets $0.15
5346f1e0: raises $0.5 to $0.65
974f52: folds
Uncalled bet ($0.5) returned to 5346f1e0
*** SHOWDOWN ***
5346f1e0 collected $0.72 from pot
*** SUMMARY ***
Total pot $0.75 | Rake $0.03 | Jackpot $0 | Bingo $0 | Fortune $0 | Tax $0
Board [2s Ks Qs]
Seat 1: 5ddf2544 (button) folded before Flop (didn't bet)
Seat 2: 73d90cc7 (small blind) folded before Flop
Seat 3: 5346f1e0 (big blind) won ($0.72)
Seat 4: 79af8002 folded before Flop (didn't bet)
Seat 5: Hero folded before Flop (didn't bet)
Seat 6: 974f52 folded on the Flop


Poker Hand #RC3141672467: Hold'em No Limit ($0.05/$0.1) - 2024/12/12 12:55:42
Table 'RushAndCash22317727' 6-max Seat #1 is the button
Seat 1: 1d37642 ($4.81 in chips)
Seat 2: fc90d2af ($6.7 in chips)
Seat 3: Hero ($15.86 in chips)
Seat 4: 77907fc4 ($22.61 in chips)
Seat 5: 2e735933 ($15.04 in chips)
Seat 6: 11a00985 ($21.68 in chips)
fc90d2af: posts small blind $0.05
Hero: posts big blind $0.1
*** HOLE CARDS ***
Dealt to 1d37642 
Dealt to fc90d2af 
Dealt to Hero [5c 9h]
Dealt to 77907fc4 
Dealt to 2e735933 
Dealt to 11a00985 
77907fc4: raises $0.1 to $0.2
2e735933: raises $0.45 to $0.65
11a00985: folds
1d37642: folds
fc90d2af: folds
Hero: folds
77907fc4: calls $0.45
*** FLOP *** [8c 4h Td]
77907fc4: checks
2e735933: bets $0.75
77907fc4: calls $0.75
*** TURN *** [8c 4h Td] [Kd]
77907fc4: checks
2e735933: bets $2.25
77907fc4: calls $2.25
*** RIVER *** [8c 4h Td Kd] [Jh]
77907fc4: checks
2e735933: bets $11.39 and is all-in
77907fc4: folds
Uncalled bet ($11.39) returned to 2e735933
*** SHOWDOWN ***
2e735933 collected $7 from pot
*** SUMMARY ***
Total pot $7.45 | Rake $0.3 | Jackpot $0.15 | Bingo $0 | Fortune $0 | Tax $0
Board [8c 4h Td Kd Jh]
Seat 1: 1d37642 (button) folded before Flop (didn't bet)
Seat 2: fc90d2af (small blind) folded before Flop
Seat 3: Hero (big blind) folded before Flop
Seat 4: 77907fc4 folded on the River
Seat 5: 2e735933 won ($7)
Seat 6: 11a00985 folded before Flop (didn't bet)


Poker Hand #RC3141672456: Hold'em No Limit ($0.05/$0.1) - 2024/12/12 12:55:39
Table 'RushAndCash22317716' 6-max Seat #1 is the button
Seat 1: Hero ($15.86 in chips)
Seat 2: 1d2dacdf ($10.88 in chips)
Seat 3: 3c1b4ee8 ($10.2 in chips)
Seat 4: a7936163 ($13.64 in chips)
Seat 5: 1d37642 ($4.81 in chips)
Seat 6: 38992bb8 ($11.56 in chips)
1d2dacdf: posts small blind $0.05
3c1b4ee8: posts big blind $0.1
*** HOLE CARDS ***
Dealt to Hero [7c Ts]
Dealt to 1d2dacdf 
Dealt to 3c1b4ee8 
Dealt to a7936163 
Dealt to 1d37642 
Dealt to 38992bb8 
a7936163: folds
1d37642: folds
38992bb8: folds
Hero: folds
1d2dacdf: raises $0.2 to $0.3
3c1b4ee8: folds
Uncalled bet ($0.2) returned to 1d2dacdf
*** SHOWDOWN ***
1d2dacdf collected $0.2 from pot
*** SUMMARY ***
Total pot $0.2 | Rake $0 | Jackpot $0 | Bingo $0 | Fortune $0 | Tax $0
Seat 1: Hero (button) folded before Flop (didn't bet)
Seat 2: 1d2dacdf (small blind) collected ($0.2)
Seat 3: 3c1b4ee8 (big blind) folded before Flop
Seat 4: a7936163 folded before Flop (didn't bet)
Seat 5: 1d37642 folded before Flop (didn't bet)
Seat 6: 38992bb8 folded before Flop (didn't bet)


Poker Hand #RC3141672113: Hold'em No Limit ($0.05/$0.1) - 2024/12/12 12:54:11
Table 'RushAndCash22317373' 6-max Seat #1 is the button
Seat 1: 8fc49c26 ($42.92 in chips)
Seat 2: 902b9d1a ($9.52 in chips)
Seat 3: 1d2dacdf ($11.28 in chips)
Seat 4: cd226443 ($11.79 in chips)
Seat 5: Hero ($15.45 in chips)
Seat 6: 31859aca ($6.84 in chips)
902b9d1a: posts small blind $0.05
1d2dacdf: posts big blind $0.1
*** HOLE CARDS ***
Dealt to 8fc49c26 
Dealt to 902b9d1a 
Dealt to 1d2dacdf 
Dealt to cd226443 
Dealt to Hero [Td Jd]
Dealt to 31859aca 
cd226443: folds
Hero: raises $0.1 to $0.2
31859aca: folds
8fc49c26: folds
902b9d1a: folds
1d2dacdf: calls $0.1
*** FLOP *** [3h Tc 8s]
1d2dacdf: checks
Hero: bets $0.2
1d2dacdf: calls $0.2
*** TURN *** [3h Tc 8s] [Kc]
1d2dacdf: checks
Hero: checks
*** RIVER *** [3h Tc 8s Kc] [Jc]
1d2dacdf: checks
Hero: bets $0.64
1d2dacdf: folds
Uncalled bet ($0.64) returned to Hero
*** SHOWDOWN ***
Hero collected $0.81 from pot
*** SUMMARY ***
Total pot $0.85 | Rake $0.04 | Jackpot $0 | Bingo $0 | Fortune $0 | Tax $0
Board [3h Tc 8s Kc Jc]
Seat 1: 8fc49c26 (button) folded before Flop (didn't bet)
Seat 2: 902b9d1a (small blind) folded before Flop
Seat 3: 1d2dacdf (big blind) folded on the River
Seat 4: cd226443 folded before Flop (didn't bet)
Seat 5: Hero won ($0.81)
Seat 6: 31859aca folded before Flop (didn't bet)


Poker Hand #RC3141672101: Hold'em No Limit ($0.05/$0.1) - 2024/12/12 12:54:08
Table 'RushAndCash22317361' 6-max Seat #1 is the button
Seat 1: 25c1f7d7 ($10 in chips)
Seat 2: 232c056f ($8.73 in chips)
Seat 3: 7576a2e9 ($10.32 in chips)
Seat 4: Hero ($15.45 in chips)
Seat 5: a88ccb70 ($10 in chips)
Seat 6: 1d2dacdf ($11.28 in chips)
232c056f: posts small blind $0.05
7576a2e9: posts big blind $0.1
*** HOLE CARDS ***
Dealt to 25c1f7d7 
Dealt to 232c056f 
Dealt to 7576a2e9 
Dealt to Hero [Qs 8h]
Dealt to a88ccb70 
Dealt to 1d2dacdf 
Hero: folds
a88ccb70: folds
1d2dacdf: folds
25c1f7d7: folds
232c056f: raises $0.15 to $0.25
7576a2e9: folds
Uncalled bet ($0.15) returned to 232c056f
*** SHOWDOWN ***
232c056f collected $0.2 from pot
*** SUMMARY ***
Total pot $0.2 | Rake $0 | Jackpot $0 | Bingo $0 | Fortune $0 | Tax $0
Seat 1: 25c1f7d7 (button) folded before Flop (didn't bet)
Seat 2: 232c056f (small blind) collected ($0.2)
Seat 3: 7576a2e9 (big blind) folded before Flop
Seat 4: Hero folded before Flop (didn't bet)
Seat 5: a88ccb70 folded before Flop (didn't bet)
Seat 6: 1d2dacdf folded before Flop (didn't bet)


Poker Hand #RC3141672086: Hold'em No Limit ($0.05/$0.1) - 2024/12/12 12:54:05
Table 'RushAndCash22317346' 6-max Seat #1 is the button
Seat 1: Hero ($15.45 in chips)
Seat 2: d8e077e9 ($39.8 in chips)
Seat 3: e6eec7bb ($10.26 in chips)
Seat 4: 111c75 ($10 in chips)
Seat 5: 31859aca ($6.84 in chips)
Seat 6: e12528c0 ($32.75 in chips)
d8e077e9: posts small blind $0.05
e6eec7bb: posts big blind $0.1
*** HOLE CARDS ***
Dealt to Hero [2h 3d]
Dealt to d8e077e9 
Dealt to e6eec7bb 
Dealt to 111c75 
Dealt to 31859aca 
Dealt to e12528c0 
111c75: folds
31859aca: folds
e12528c0: folds
Hero: folds
d8e077e9: folds
Uncalled bet ($0.05) returned to e6eec7bb
*** SHOWDOWN ***
e6eec7bb collected $0.1 from pot
*** SUMMARY ***
Total pot $0.1 | Rake $0 | Jackpot $0 | Bingo $0 | Fortune $0 | Tax $0
Seat 1: Hero (button) folded before Flop (didn't bet)
Seat 2: d8e077e9 (small blind) folded before Flop
Seat 3: e6eec7bb (big blind) collected ($0.1)
Seat 4: 111c75 folded before Flop (didn't bet)
Seat 5: 31859aca folded before Flop (didn't bet)
Seat 6: e12528c0 folded before Flop (didn't bet)


Poker Hand #RC3141672040: Hold'em No Limit ($0.05/$0.1) - 2024/12/12 12:53:53
Table 'RushAndCash22317300' 6-max Seat #1 is the button
Seat 1: 79af8002 ($10 in chips)
Seat 2: Hero ($15.5 in chips)
Seat 3: cf64da1a ($21.02 in chips)
Seat 4: d037fd58 ($14.31 in chips)
Seat 5: f4a0e033 ($10 in chips)
Seat 6: ec7ff353 ($10.15 in chips)
Hero: posts small blind $0.05
cf64da1a: posts big blind $0.1
*** HOLE CARDS ***
Dealt to 79af8002 
Dealt to Hero [7d 9h]
Dealt to cf64da1a 
Dealt to d037fd58 
Dealt to f4a0e033 
Dealt to ec7ff353 
d037fd58: folds
f4a0e033: folds
ec7ff353: folds
79af8002: folds
Hero: folds
Uncalled bet ($0.05) returned to cf64da1a
*** SHOWDOWN ***
cf64da1a collected $0.1 from pot
*** SUMMARY ***
Total pot $0.1 | Rake $0 | Jackpot $0 | Bingo $0 | Fortune $0 | Tax $0
Seat 1: 79af8002 (button) folded before Flop (didn't bet)
Seat 2: Hero (small blind) folded before Flop
Seat 3: cf64da1a (big blind) collected ($0.1)
Seat 4: d037fd58 folded before Flop (didn't bet)
Seat 5: f4a0e033 folded before Flop (didn't bet)
Seat 6: ec7ff353 folded before Flop (didn't bet)


Poker Hand #RC3141671964: Hold'em No Limit ($0.05/$0.1) - 2024/12/12 12:53:35
Table 'RushAndCash22317224' 6-max Seat #1 is the button
Seat 1: 4e5c7119 ($12.5 in chips)
Seat 2: d037fd58 ($14.61 in chips)
Seat 3: Hero ($15.23 in chips)
Seat 4: e0c4f56b ($9.42 in chips)
Seat 5: ab081f1e ($10 in chips)
Seat 6: f3cd242a ($18.11 in chips)
d037fd58: posts small blind $0.05
Hero: posts big blind $0.1
*** HOLE CARDS ***
Dealt to 4e5c7119 
Dealt to d037fd58 
Dealt to Hero [Jd Js]
Dealt to e0c4f56b 
Dealt to ab081f1e 
Dealt to f3cd242a 
e0c4f56b: folds
ab081f1e: folds
f3cd242a: folds
4e5c7119: folds
d037fd58: raises $0.2 to $0.3
Hero: raises $0.6 to $0.9
d037fd58: folds
Uncalled bet ($0.6) returned to Hero
*** SHOWDOWN ***
Hero collected $0.57 from pot
*** SUMMARY ***
Total pot $0.6 | Rake $0.03 | Jackpot $0 | Bingo $0 | Fortune $0 | Tax $0
Seat 1: 4e5c7119 (button) folded before Flop (didn't bet)
Seat 2: d037fd58 (small blind) folded before Flop
Seat 3: Hero (big blind) collected ($0.57)
Seat 4: e0c4f56b folded before Flop (didn't bet)
Seat 5: ab081f1e folded before Flop (didn't bet)
Seat 6: f3cd242a folded before Flop (didn't bet)


Poker Hand #RC3141671953: Hold'em No Limit ($0.05/$0.1) - 2024/12/12 12:53:31
Table 'RushAndCash22317213' 6-max Seat #1 is the button
Seat 1: 3cdac696 ($8.87 in chips)
Seat 2: 14311dad ($11.84 in chips)
Seat 3: 84cc5caa ($10.15 in chips)
Seat 4: Hero ($15.23 in chips)
Seat 5: 7ee23c5e ($10.18 in chips)
Seat 6: d8e077e9 ($39.43 in chips)
14311dad: posts small blind $0.05
84cc5caa: posts big blind $0.1
*** HOLE CARDS ***
Dealt to 3cdac696 
Dealt to 14311dad 
Dealt to 84cc5caa 
Dealt to Hero [Kh 3s]
Dealt to 7ee23c5e 
Dealt to d8e077e9 
Hero: folds
7ee23c5e: raises $0.15 to $0.25
d8e077e9: folds
3cdac696: folds
14311dad: folds
84cc5caa: folds
Uncalled bet ($0.15) returned to 7ee23c5e
*** SHOWDOWN ***
7ee23c5e collected $0.25 from pot
*** SUMMARY ***
Total pot $0.25 | Rake $0 | Jackpot $0 | Bingo $0 | Fortune $0 | Tax $0
Seat 1: 3cdac696 (button) folded before Flop (didn't bet)
Seat 2: 14311dad (small blind) folded before Flop
Seat 3: 84cc5caa (big blind) folded before Flop
Seat 4: Hero folded before Flop (didn't bet)
Seat 5: 7ee23c5e collected ($0.25)
Seat 6: d8e077e9 folded before Flop (didn't bet)


Poker Hand #RC3141671909: Hold'em No Limit ($0.05/$0.1) - 2024/12/12 12:53:20
Table 'RushAndCash22317169' 6-max Seat #1 is the button
Seat 1: f4a6a825 ($10 in chips)
Seat 2: 8a55880e ($10 in chips)
Seat 3: 5041f166 ($13.71 in chips)
Seat 4: 7bad2adb ($10 in chips)
Seat 5: 1677a3f4 ($11.79 in chips)
Seat 6: Hero ($15.23 in chips)
8a55880e: posts small blind $0.05
5041f166: posts big blind $0.1
*** HOLE CARDS ***
Dealt to f4a6a825 
Dealt to 8a55880e 
Dealt to 5041f166 
Dealt to 7bad2adb 
Dealt to 1677a3f4 
Dealt to Hero [Qs Jc]
7bad2adb: folds
1677a3f4: raises $0.2 to $0.3
Hero: folds
f4a6a825: folds
8a55880e: folds
5041f166: folds
Uncalled bet ($0.2) returned to 1677a3f4
*** SHOWDOWN ***
1677a3f4 collected $0.25 from pot
*** SUMMARY ***
Total pot $0.25 | Rake $0 | Jackpot $0 | Bingo $0 | Fortune $0 | Tax $0
Seat 1: f4a6a825 (button) folded before Flop (didn't bet)
Seat 2: 8a55880e (small blind) folded before Flop
Seat 3: 5041f166 (big blind) folded before Flop
Seat 4: 7bad2adb folded before Flop (didn't bet)
Seat 5: 1677a3f4 collected ($0.25)
Seat 6: Hero folded before Flop (didn't bet)


Poker Hand #RC3141671894: Hold'em No Limit ($0.05/$0.1) - 2024/12/12 12:53:16
Table 'RushAndCash22317154' 6-max Seat #1 is the button
Seat 1: 95e11761 ($9.43 in chips)
Seat 2: 15f3779a ($19.64 in chips)
Seat 3: 7829feb5 ($12.33 in chips)
Seat 4: Hero ($15.23 in chips)
Seat 5: e3914f0b ($27.25 in chips)
Seat 6: a730cdce ($10.28 in chips)
15f3779a: posts small blind $0.05
7829feb5: posts big blind $0.1
*** HOLE CARDS ***
Dealt to 95e11761 
Dealt to 15f3779a 
Dealt to 7829feb5 
Dealt to Hero [3s 7h]
Dealt to e3914f0b 
Dealt to a730cdce 
Hero: folds
e3914f0b: raises $0.1 to $0.2
a730cdce: folds
95e11761: folds
15f3779a: calls $0.15
7829feb5: folds
*** FLOP *** [7c 8d 4d]
15f3779a: checks
e3914f0b: checks
*** TURN *** [7c 8d 4d] [4s]
15f3779a: bets $0.38
e3914f0b: folds
Uncalled bet ($0.38) returned to 15f3779a
*** SHOWDOWN ***
15f3779a collected $0.48 from pot
*** SUMMARY ***
Total pot $0.5 | Rake $0.02 | Jackpot $0 | Bingo $0 | Fortune $0 | Tax $0
Board [7c 8d 4d 4s]
Seat 1: 95e11761 (button) folded before Flop (didn't bet)
Seat 2: 15f3779a (small blind) won ($0.48)
Seat 3: 7829feb5 (big blind) folded before Flop
Seat 4: Hero folded before Flop (didn't bet)
Seat 5: e3914f0b folded on the Turn
Seat 6: a730cdce folded before Flop (didn't bet)


Poker Hand #RC3141671883: Hold'em No Limit ($0.05/$0.1) - 2024/12/12 12:53:13
Table 'RushAndCash22317143' 6-max Seat #1 is the button
Seat 1: dbcd9107 ($21.21 in chips)
Seat 2: ec7ff353 ($10 in chips)
Seat 3: 232c056f ($9.83 in chips)
Seat 4: Hero ($15.23 in chips)
Seat 5: ead6156b ($7.06 in chips)
Seat 6: a3382d82 ($19.26 in chips)
ec7ff353: posts small blind $0.05
232c056f: posts big blind $0.1
*** HOLE CARDS ***
Dealt to dbcd9107 
Dealt to ec7ff353 
Dealt to 232c056f 
Dealt to Hero [2c Qd]
Dealt to ead6156b 
Dealt to a3382d82 
Hero: folds
ead6156b: raises $0.1 to $0.2
a3382d82: folds
dbcd9107: raises $0.4 to $0.6
ec7ff353: folds
232c056f: folds
ead6156b: calls $0.4
*** FLOP *** [7d 6d Kh]
ead6156b: checks
dbcd9107: checks
*** TURN *** [7d 6d Kh] [8c]
ead6156b: bets $0.68
dbcd9107: folds
Uncalled bet ($0.68) returned to ead6156b
*** SHOWDOWN ***
ead6156b collected $1.29 from pot
*** SUMMARY ***
Total pot $1.35 | Rake $0.06 | Jackpot $0 | Bingo $0 | Fortune $0 | Tax $0
Board [7d 6d Kh 8c]
Seat 1: dbcd9107 (button) folded on the Turn
Seat 2: ec7ff353 (small blind) folded before Flop
Seat 3: 232c056f (big blind) folded before Flop
Seat 4: Hero folded before Flop (didn't bet)
Seat 5: ead6156b won ($1.29)
Seat 6: a3382d82 folded before Flop (didn't bet)


Poker Hand #RC3141671383: Hold'em No Limit ($0.05/$0.1) - 2024/12/12 12:51:03
Table 'RushAndCash22316643' 6-max Seat #1 is the button
Seat 1: d07ab82c ($10.55 in chips)
Seat 2: Hero ($17.38 in chips)
Seat 3: 9665c30f ($10.93 in chips)
Seat 4: ca4fa05a ($8 in chips)
Seat 5: dbcd9107 ($19.32 in chips)
Seat 6: 2e3105a5 ($11.92 in chips)
Hero: posts small blind $0.05
9665c30f: posts big blind $0.1
*** HOLE CARDS ***
Dealt to d07ab82c 
Dealt to Hero [Kc Jc]
Dealt to 9665c30f 
Dealt to ca4fa05a 
Dealt to dbcd9107 
Dealt to 2e3105a5 
ca4fa05a: folds
dbcd9107: raises $0.1 to $0.2
2e3105a5: folds
d07ab82c: folds
Hero: raises $0.7 to $0.9
9665c30f: folds
dbcd9107: calls $0.7
*** FLOP *** [Td 6s 8s]
Hero: checks
dbcd9107: checks
*** TURN *** [Td 6s 8s] [Kd]
Hero: checks
dbcd9107: bets $1.25
Hero: calls $1.25
*** RIVER *** [Td 6s 8s Kd] [4s]
Hero: checks
dbcd9107: bets $2.25
Hero: folds
Uncalled bet ($2.25) returned to dbcd9107
*** SHOWDOWN ***
dbcd9107 collected $4.04 from pot
*** SUMMARY ***
Total pot $4.4 | Rake $0.21 | Jackpot $0.15 | Bingo $0 | Fortune $0 | Tax $0
Board [Td 6s 8s Kd 4s]
Seat 1: d07ab82c (button) folded before Flop (didn't bet)
Seat 2: Hero (small blind) folded on the River
Seat 3: 9665c30f (big blind) folded before Flop
Seat 4: ca4fa05a folded before Flop (didn't bet)
Seat 5: dbcd9107 won ($4.04)
Seat 6: 2e3105a5 folded before Flop (didn't bet)


Poker Hand #RC3141671344: Hold'em No Limit ($0.05/$0.1) - 2024/12/12 12:50:53
Table 'RushAndCash22316604' 6-max Seat #1 is the button
Seat 1: Hero ($17.38 in chips)
Seat 2: 232c056f ($9.43 in chips)
Seat 3: 2b1a7fe5 ($16.98 in chips)
Seat 4: ab081f1e ($10 in chips)
Seat 5: ead6156b ($7.38 in chips)
Seat 6: 2746c1f0 ($10 in chips)
232c056f: posts small blind $0.05
2b1a7fe5: posts big blind $0.1
*** HOLE CARDS ***
Dealt to Hero [Qs Td]
Dealt to 232c056f 
Dealt to 2b1a7fe5 
Dealt to ab081f1e 
Dealt to ead6156b 
Dealt to 2746c1f0 
ab081f1e: folds
ead6156b: folds
2746c1f0: raises $0.15 to $0.25
Hero: folds
232c056f: raises $0.6 to $0.85
2b1a7fe5: folds
2746c1f0: folds
Uncalled bet ($0.6) returned to 232c056f
*** SHOWDOWN ***
232c056f collected $0.57 from pot
*** SUMMARY ***
Total pot $0.6 | Rake $0.03 | Jackpot $0 | Bingo $0 | Fortune $0 | Tax $0
Seat 1: Hero (button) folded before Flop (didn't bet)
Seat 2: 232c056f (small blind) collected ($0.57)
Seat 3: 2b1a7fe5 (big blind) folded before Flop
Seat 4: ab081f1e folded before Flop (didn't bet)
Seat 5: ead6156b folded before Flop (didn't bet)
Seat 6: 2746c1f0 folded before Flop


Poker Hand #RC3141671292: Hold'em No Limit ($0.05/$0.1) - 2024/12/12 12:50:40
Table 'RushAndCash22316552' 6-max Seat #1 is the button
Seat 1: 24c2159e ($10.55 in chips)
Seat 2: fed024e0 ($10.67 in chips)
Seat 3: Hero ($17.48 in chips)
Seat 4: 101c026b ($24.8 in chips)
Seat 5: 4e5c7119 ($11.45 in chips)
Seat 6: c4d674fe ($11.28 in chips)
fed024e0: posts small blind $0.05
Hero: posts big blind $0.1
*** HOLE CARDS ***
Dealt to 24c2159e 
Dealt to fed024e0 
Dealt to Hero [2d Jd]
Dealt to 101c026b 
Dealt to 4e5c7119 
Dealt to c4d674fe 
101c026b: folds
4e5c7119: folds
c4d674fe: raises $0.1 to $0.2
24c2159e: folds
fed024e0: folds
Hero: folds
Uncalled bet ($0.1) returned to c4d674fe
*** SHOWDOWN ***
c4d674fe collected $0.25 from pot
*** SUMMARY ***
Total pot $0.25 | Rake $0 | Jackpot $0 | Bingo $0 | Fortune $0 | Tax $0
Seat 1: 24c2159e (button) folded before Flop (didn't bet)
Seat 2: fed024e0 (small blind) folded before Flop
Seat 3: Hero (big blind) folded before Flop
Seat 4: 101c026b folded before Flop (didn't bet)
Seat 5: 4e5c7119 folded before Flop (didn't bet)
Seat 6: c4d674fe collected ($0.25)


Poker Hand #RC3141671276: Hold'em No Limit ($0.05/$0.1) - 2024/12/12 12:50:37
Table 'RushAndCash22316536' 6-max Seat #1 is the button
Seat 1: 661d577b ($10 in chips)
Seat 2: 645be922 ($10.38 in chips)
Seat 3: a1394882 ($10 in chips)
Seat 4: Hero ($17.48 in chips)
Seat 5: 1a8ef95a ($11.57 in chips)
Seat 6: 23d20ac6 ($16.89 in chips)
645be922: posts small blind $0.05
a1394882: posts big blind $0.1
*** HOLE CARDS ***
Dealt to 661d577b 
Dealt to 645be922 
Dealt to a1394882 
Dealt to Hero [3s 2d]
Dealt to 1a8ef95a 
Dealt to 23d20ac6 
Hero: folds
1a8ef95a: raises $0.11 to $0.21
23d20ac6: folds
661d577b: folds
645be922: folds
a1394882: calls $0.11
*** FLOP *** [2s Qd 4d]
a1394882: checks
1a8ef95a: bets $0.3
a1394882: folds
Uncalled bet ($0.3) returned to 1a8ef95a
*** SHOWDOWN ***
1a8ef95a collected $0.45 from pot
*** SUMMARY ***
Total pot $0.47 | Rake $0.02 | Jackpot $0 | Bingo $0 | Fortune $0 | Tax $0
Board [2s Qd 4d]
Seat 1: 661d577b (button) folded before Flop (didn't bet)
Seat 2: 645be922 (small blind) folded before Flop
Seat 3: a1394882 (big blind) folded on the Flop
Seat 4: Hero folded before Flop (didn't bet)
Seat 5: 1a8ef95a won ($0.45)
Seat 6: 23d20ac6 folded before Flop (didn't bet)


Poker Hand #RC3141671258: Hold'em No Limit ($0.05/$0.1) - 2024/12/12 12:50:33
Table 'RushAndCash22316518' 6-max Seat #1 is the button
Seat 1: 902b9d1a ($9.58 in chips)
Seat 2: cacc74b2 ($12.42 in chips)
Seat 3: 356c8abd ($12.02 in chips)
Seat 4: c2b852ae ($10.8 in chips)
Seat 5: Hero ($17.48 in chips)
Seat 6: 57474058 ($18.69 in chips)
cacc74b2: posts small blind $0.05
356c8abd: posts big blind $0.1
*** HOLE CARDS ***
Dealt to 902b9d1a 
Dealt to cacc74b2 
Dealt to 356c8abd 
Dealt to c2b852ae 
Dealt to Hero [As 5c]
Dealt to 57474058 
c2b852ae: folds
Hero: folds
57474058: raises $0.1 to $0.2
902b9d1a: folds
cacc74b2: folds
356c8abd: folds
Uncalled bet ($0.1) returned to 57474058
*** SHOWDOWN ***
57474058 collected $0.25 from pot
*** SUMMARY ***
Total pot $0.25 | Rake $0 | Jackpot $0 | Bingo $0 | Fortune $0 | Tax $0
Seat 1: 902b9d1a (button) folded before Flop (didn't bet)
Seat 2: cacc74b2 (small blind) folded before Flop
Seat 3: 356c8abd (big blind) folded before Flop
Seat 4: c2b852ae folded before Flop (didn't bet)
Seat 5: Hero folded before Flop (didn't bet)
Seat 6: 57474058 collected ($0.25)


Poker Hand #RC3141671228: Hold'em No Limit ($0.05/$0.1) - 2024/12/12 12:50:25
Table 'RushAndCash22316488' 6-max Seat #1 is the button
Seat 1: 356c8abd ($12.02 in chips)
Seat 2: 2fb13304 ($10.06 in chips)
Seat 3: 80ebdd41 ($10 in chips)
Seat 4: 5b14e7af ($24.72 in chips)
Seat 5: 5ab2e15d ($10.2 in chips)
Seat 6: Hero ($17.48 in chips)
2fb13304: posts small blind $0.05
80ebdd41: posts big blind $0.1
*** HOLE CARDS ***
Dealt to 356c8abd 
Dealt to 2fb13304 
Dealt to 80ebdd41 
Dealt to 5b14e7af 
Dealt to 5ab2e15d 
Dealt to Hero [Ks Qd]
5b14e7af: raises $0.2 to $0.3
5ab2e15d: folds
Hero: folds
356c8abd: folds
2fb13304: folds
80ebdd41: calls $0.2
*** FLOP *** [8d Ac 4d]
80ebdd41: checks
5b14e7af: bets $0.33
80ebdd41: raises $0.97 to $1.3
5b14e7af: calls $0.97
*** TURN *** [8d Ac 4d] [Ts]
80ebdd41: checks
5b14e7af: bets $3
80ebdd41: folds
Uncalled bet ($3) returned to 5b14e7af
*** SHOWDOWN ***
5b14e7af collected $2.95 from pot
*** SUMMARY ***
Total pot $3.25 | Rake $0.15 | Jackpot $0.15 | Bingo $0 | Fortune $0 | Tax $0
Board [8d Ac 4d Ts]
Seat 1: 356c8abd (button) folded before Flop (didn't bet)
Seat 2: 2fb13304 (small blind) folded before Flop
Seat 3: 80ebdd41 (big blind) folded on the Turn
Seat 4: 5b14e7af won ($2.95)
Seat 5: 5ab2e15d folded before Flop (didn't bet)
Seat 6: Hero folded before Flop (didn't bet)


Poker Hand #RC3141671211: Hold'em No Limit ($0.05/$0.1) - 2024/12/12 12:50:22
Table 'RushAndCash22316471' 6-max Seat #1 is the button
Seat 1: Hero ($17.48 in chips)
Seat 2: 2db5d1cb ($11.1 in chips)
Seat 3: 418b0280 ($12.28 in chips)
Seat 4: 24039de0 ($10 in chips)
Seat 5: 22e8274e ($14.37 in chips)
Seat 6: d940390d ($17.73 in chips)
2db5d1cb: posts small blind $0.05
418b0280: posts big blind $0.1
*** HOLE CARDS ***
Dealt to Hero [Jc 4h]
Dealt to 2db5d1cb 
Dealt to 418b0280 
Dealt to 24039de0 
Dealt to 22e8274e 
Dealt to d940390d 
24039de0: folds
22e8274e: folds
d940390d: folds
Hero: folds
2db5d1cb: folds
Uncalled bet ($0.05) returned to 418b0280
*** SHOWDOWN ***
418b0280 collected $0.1 from pot
*** SUMMARY ***
Total pot $0.1 | Rake $0 | Jackpot $0 | Bingo $0 | Fortune $0 | Tax $0
Seat 1: Hero (button) folded before Flop (didn't bet)
Seat 2: 2db5d1cb (small blind) folded before Flop
Seat 3: 418b0280 (big blind) collected ($0.1)
Seat 4: 24039de0 folded before Flop (didn't bet)
Seat 5: 22e8274e folded before Flop (didn't bet)
Seat 6: d940390d folded before Flop (didn't bet)


Poker Hand #RC3141671198: Hold'em No Limit ($0.05/$0.1) - 2024/12/12 12:50:18
Table 'RushAndCash22316458' 6-max Seat #1 is the button
Seat 1: d09451f5 ($12.14 in chips)
Seat 2: Hero ($17.38 in chips)
Seat 3: d940390d ($17.83 in chips)
Seat 4: f4a0e033 ($13.68 in chips)
Seat 5: 3c75bc00 ($36.47 in chips)
Seat 6: d6b17ac7 ($10.82 in chips)
Hero: posts small blind $0.05
d940390d: posts big blind $0.1
*** HOLE CARDS ***
Dealt to d09451f5 
Dealt to Hero [6c Jd]
Dealt to d940390d 
Dealt to f4a0e033 
Dealt to 3c75bc00 
Dealt to d6b17ac7 
f4a0e033: folds
3c75bc00: folds
d6b17ac7: folds
d09451f5: folds
Hero: folds
Uncalled bet ($0.05) returned to d940390d
*** SHOWDOWN ***
d940390d collected $0.1 from pot
*** SUMMARY ***
Total pot $0.1 | Rake $0 | Jackpot $0 | Bingo $0 | Fortune $0 | Tax $0
Seat 1: d09451f5 (button) folded before Flop (didn't bet)
Seat 2: Hero (small blind) folded before Flop
Seat 3: d940390d (big blind) collected ($0.1)
Seat 4: f4a0e033 folded before Flop (didn't bet)
Seat 5: 3c75bc00 folded before Flop (didn't bet)
Seat 6: d6b17ac7 folded before Flop (didn't bet)


Poker Hand #RC3141671184: Hold'em No Limit ($0.05/$0.1) - 2024/12/12 12:50:15
Table 'RushAndCash22316444' 6-max Seat #1 is the button
Seat 1: d940390d ($17.83 in chips)
Seat 2: d6b17ac7 ($10.87 in chips)
Seat 3: Hero ($17.48 in chips)
Seat 4: 26efdee0 ($22.09 in chips)
Seat 5: aaca7529 ($7 in chips)
Seat 6: 35b5987 ($18.94 in chips)
d6b17ac7: posts small blind $0.05
Hero: posts big blind $0.1
*** HOLE CARDS ***
Dealt to d940390d 
Dealt to d6b17ac7 
Dealt to Hero [Tc 4s]
Dealt to 26efdee0 
Dealt to aaca7529 
Dealt to 35b5987 
26efdee0: folds
aaca7529: folds
35b5987: folds
d940390d: folds
d6b17ac7: folds
Uncalled bet ($0.05) returned to Hero
*** SHOWDOWN ***
Hero collected $0.1 from pot
*** SUMMARY ***
Total pot $0.1 | Rake $0 | Jackpot $0 | Bingo $0 | Fortune $0 | Tax $0
Seat 1: d940390d (button) folded before Flop (didn't bet)
Seat 2: d6b17ac7 (small blind) folded before Flop
Seat 3: Hero (big blind) collected ($0.1)
Seat 4: 26efdee0 folded before Flop (didn't bet)
Seat 5: aaca7529 folded before Flop (didn't bet)
Seat 6: 35b5987 folded before Flop (didn't bet)


Poker Hand #RC3141671171: Hold'em No Limit ($0.05/$0.1) - 2024/12/12 12:50:11
Table 'RushAndCash22316431' 6-max Seat #1 is the button
Seat 1: 1d656e64 ($103.18 in chips)
Seat 2: 844091a0 ($10.5 in chips)
Seat 3: 54a8e111 ($10.28 in chips)
Seat 4: 24039de0 ($10 in chips)
Seat 5: Hero ($17.48 in chips)
Seat 6: cacc74b2 ($12.42 in chips)
844091a0: posts small blind $0.05
54a8e111: posts big blind $0.1
*** HOLE CARDS ***
Dealt to 1d656e64 
Dealt to 844091a0 
Dealt to 54a8e111 
Dealt to 24039de0 
Dealt to Hero [8d 4h]
Dealt to cacc74b2 
24039de0: folds
Hero: folds
cacc74b2: folds
1d656e64: raises $0.2 to $0.3
844091a0: folds
54a8e111: folds
Uncalled bet ($0.2) returned to 1d656e64
*** SHOWDOWN ***
1d656e64 collected $0.25 from pot
*** SUMMARY ***
Total pot $0.25 | Rake $0 | Jackpot $0 | Bingo $0 | Fortune $0 | Tax $0
Seat 1: 1d656e64 (button) collected ($0.25)
Seat 2: 844091a0 (small blind) folded before Flop
Seat 3: 54a8e111 (big blind) folded before Flop
Seat 4: 24039de0 folded before Flop (didn't bet)
Seat 5: Hero folded before Flop (didn't bet)
Seat 6: cacc74b2 folded before Flop (didn't bet)


Poker Hand #RC3141671156: Hold'em No Limit ($0.05/$0.1) - 2024/12/12 12:50:07
Table 'RushAndCash22316416' 6-max Seat #1 is the button
Seat 1: 20a8d101 ($13.54 in chips)
Seat 2: 1d656e64 ($103.23 in chips)
Seat 3: 1a8ef95a ($11.57 in chips)
Seat 4: Hero ($17.48 in chips)
Seat 5: 27c51518 ($23.06 in chips)
Seat 6: c279dad0 ($19.53 in chips)
1d656e64: posts small blind $0.05
1a8ef95a: posts big blind $0.1
*** HOLE CARDS ***
Dealt to 20a8d101 
Dealt to 1d656e64 
Dealt to 1a8ef95a 
Dealt to Hero [8s 6s]
Dealt to 27c51518 
Dealt to c279dad0 
Hero: folds
27c51518: folds
c279dad0: raises $0.1 to $0.2
20a8d101: raises $0.42 to $0.62
1d656e64: folds
1a8ef95a: folds
c279dad0: calls $0.42
*** FLOP *** [Qh 6c 8c]
c279dad0: checks
20a8d101: bets $0.46
c279dad0: calls $0.46
*** TURN *** [Qh 6c 8c] [Qc]
c279dad0: bets $1.07
20a8d101: calls $1.07
*** RIVER *** [Qh 6c 8c Qc] [Qs]
c279dad0: checks
20a8d101: bets $7.3
c279dad0: folds
Uncalled bet ($7.3) returned to 20a8d101
c279dad0: shows [9d 9c] (Queens Full over Nines)
*** SHOWDOWN ***
20a8d101 collected $4.09 from pot
*** SUMMARY ***
Total pot $4.45 | Rake $0.21 | Jackpot $0.15 | Bingo $0 | Fortune $0 | Tax $0
Board [Qh 6c 8c Qc Qs]
Seat 1: 20a8d101 (button) won ($4.09)
Seat 2: 1d656e64 (small blind) folded before Flop
Seat 3: 1a8ef95a (big blind) folded before Flop
Seat 4: Hero folded before Flop (didn't bet)
Seat 5: 27c51518 folded before Flop (didn't bet)
Seat 6: c279dad0 folded on the River


Poker Hand #RC3141671141: Hold'em No Limit ($0.05/$0.1) - 2024/12/12 12:50:04
Table 'RushAndCash22316401' 6-max Seat #1 is the button
Seat 1: 27c51518 ($23.06 in chips)
Seat 2: a7936163 ($15.34 in chips)
Seat 3: be2bfc8f ($10 in chips)
Seat 4: Hero ($17.48 in chips)
Seat 5: b4bc8071 ($11.39 in chips)
Seat 6: 77907fc4 ($23.93 in chips)
a7936163: posts small blind $0.05
be2bfc8f: posts big blind $0.1
*** HOLE CARDS ***
Dealt to 27c51518 
Dealt to a7936163 
Dealt to be2bfc8f 
Dealt to Hero [4s 2s]
Dealt to b4bc8071 
Dealt to 77907fc4 
Hero: folds
b4bc8071: folds
77907fc4: folds
27c51518: folds
a7936163: raises $0.2 to $0.3
be2bfc8f: folds
Uncalled bet ($0.2) returned to a7936163
*** SHOWDOWN ***
a7936163 collected $0.2 from pot
*** SUMMARY ***
Total pot $0.2 | Rake $0 | Jackpot $0 | Bingo $0 | Fortune $0 | Tax $0
Seat 1: 27c51518 (button) folded before Flop (didn't bet)
Seat 2: a7936163 (small blind) collected ($0.2)
Seat 3: be2bfc8f (big blind) folded before Flop
Seat 4: Hero folded before Flop (didn't bet)
Seat 5: b4bc8071 folded before Flop (didn't bet)
Seat 6: 77907fc4 folded before Flop (didn't bet)


Poker Hand #RC3141671128: Hold'em No Limit ($0.05/$0.1) - 2024/12/12 12:50:00
Table 'RushAndCash22316388' 6-max Seat #1 is the button
Seat 1: Hero ($17.48 in chips)
Seat 2: 66a73913 ($16.84 in chips)
Seat 3: 5e5bf12a ($8.67 in chips)
Seat 4: be885022 ($13.55 in chips)
Seat 5: b1f396f4 ($26.51 in chips)
Seat 6: 5ddf2544 ($14.14 in chips)
66a73913: posts small blind $0.05
5e5bf12a: posts big blind $0.1
*** HOLE CARDS ***
Dealt to Hero [6h Jc]
Dealt to 66a73913 
Dealt to 5e5bf12a 
Dealt to be885022 
Dealt to b1f396f4 
Dealt to 5ddf2544 
be885022: folds
b1f396f4: folds
5ddf2544: folds
Hero: folds
66a73913: raises $0.2 to $0.3
5e5bf12a: folds
Uncalled bet ($0.2) returned to 66a73913
*** SHOWDOWN ***
66a73913 collected $0.2 from pot
*** SUMMARY ***
Total pot $0.2 | Rake $0 | Jackpot $0 | Bingo $0 | Fortune $0 | Tax $0
Seat 1: Hero (button) folded before Flop (didn't bet)
Seat 2: 66a73913 (small blind) collected ($0.2)
Seat 3: 5e5bf12a (big blind) folded before Flop
Seat 4: be885022 folded before Flop (didn't bet)
Seat 5: b1f396f4 folded before Flop (didn't bet)
Seat 6: 5ddf2544 folded before Flop (didn't bet)


Poker Hand #RC3141671104: Hold'em No Limit ($0.05/$0.1) - 2024/12/12 12:49:54
Table 'RushAndCash22316364' 6-max Seat #1 is the button
Seat 1: b1f396f4 ($26.51 in chips)
Seat 2: Hero ($17.53 in chips)
Seat 3: aa6f9192 ($10 in chips)
Seat 4: 9a7505e ($14.16 in chips)
Seat 5: e6eec7bb ($10 in chips)
Seat 6: f04fb852 ($13.7 in chips)
Hero: posts small blind $0.05
aa6f9192: posts big blind $0.1
*** HOLE CARDS ***
Dealt to b1f396f4 
Dealt to Hero [6d 4s]
Dealt to aa6f9192 
Dealt to 9a7505e 
Dealt to e6eec7bb 
Dealt to f04fb852 
9a7505e: folds
e6eec7bb: raises $0.13 to $0.23
f04fb852: folds
b1f396f4: folds
Hero: folds
aa6f9192: calls $0.13
*** FLOP *** [5c Ts 9c]
aa6f9192: checks
e6eec7bb: checks
*** TURN *** [5c Ts 9c] [9d]
aa6f9192: bets $0.17
e6eec7bb: calls $0.17
*** RIVER *** [5c Ts 9c 9d] [As]
aa6f9192: checks
e6eec7bb: checks
aa6f9192: shows [8s 8d] (Pair of Nines and Pair of Eights)
e6eec7bb: shows [6c 6h] (Pair of Nines and Pair of Sixes)
*** SHOWDOWN ***
aa6f9192 collected $0.81 from pot
*** SUMMARY ***
Total pot $0.85 | Rake $0.04 | Jackpot $0 | Bingo $0 | Fortune $0 | Tax $0
Board [5c Ts 9c 9d As]
Seat 1: b1f396f4 (button) folded before Flop (didn't bet)
Seat 2: Hero (small blind) folded before Flop
Seat 3: aa6f9192 (big blind) showed [8s 8d] and won ($0.81) with Pair of Nines and Pair of Eights
Seat 4: 9a7505e folded before Flop (didn't bet)
Seat 5: e6eec7bb showed [6c 6h] and lost with Pair of Nines and Pair of Sixes
Seat 6: f04fb852 folded before Flop (didn't bet)


Poker Hand #RC3141671049: Hold'em No Limit ($0.05/$0.1) - 2024/12/12 12:49:40
Table 'RushAndCash22316309' 6-max Seat #1 is the button
Seat 1: 7ee23c5e ($10.25 in chips)
Seat 2: f5628a04 ($11.2 in chips)
Seat 3: Hero ($17.63 in chips)
Seat 4: 3896325a ($10.15 in chips)
Seat 5: f879c2d8 ($10 in chips)
Seat 6: be24e56d ($17.43 in chips)
f5628a04: posts small blind $0.05
Hero: posts big blind $0.1
*** HOLE CARDS ***
Dealt to 7ee23c5e 
Dealt to f5628a04 
Dealt to Hero [Kd 2h]
Dealt to 3896325a 
Dealt to f879c2d8 
Dealt to be24e56d 
3896325a: raises $0.15 to $0.25
f879c2d8: folds
be24e56d: folds
7ee23c5e: folds
f5628a04: folds
Hero: folds
Uncalled bet ($0.15) returned to 3896325a
*** SHOWDOWN ***
3896325a collected $0.25 from pot
*** SUMMARY ***
Total pot $0.25 | Rake $0 | Jackpot $0 | Bingo $0 | Fortune $0 | Tax $0
Seat 1: 7ee23c5e (button) folded before Flop (didn't bet)
Seat 2: f5628a04 (small blind) folded before Flop
Seat 3: Hero (big blind) folded before Flop
Seat 4: 3896325a collected ($0.25)
Seat 5: f879c2d8 folded before Flop (didn't bet)
Seat 6: be24e56d folded before Flop (didn't bet)


Poker Hand #RC3141671037: Hold'em No Limit ($0.05/$0.1) - 2024/12/12 12:49:37
Table 'RushAndCash22316297' 6-max Seat #1 is the button
Seat 1: d19ee248 ($8.85 in chips)
Seat 2: 24039de0 ($10.23 in chips)
Seat 3: 79af8002 ($10.1 in chips)
Seat 4: Hero ($17.63 in chips)
Seat 5: 2ff0a04b ($49.71 in chips)
Seat 6: 643f85e7 ($11.03 in chips)
24039de0: posts small blind $0.05
79af8002: posts big blind $0.1
*** HOLE CARDS ***
Dealt to d19ee248 
Dealt to 24039de0 
Dealt to 79af8002 
Dealt to Hero [8c 3d]
Dealt to 2ff0a04b 
Dealt to 643f85e7 
Hero: folds
2ff0a04b: folds
643f85e7: raises $0.11 to $0.21
d19ee248: raises $0.44 to $0.65
24039de0: folds
79af8002: folds
643f85e7: calls $0.44
*** FLOP *** [7d Ad 5h]
643f85e7: checks
d19ee248: bets $0.45
643f85e7: folds
Uncalled bet ($0.45) returned to d19ee248
*** SHOWDOWN ***
d19ee248 collected $1.38 from pot
*** SUMMARY ***
Total pot $1.45 | Rake $0.07 | Jackpot $0 | Bingo $0 | Fortune $0 | Tax $0
Board [7d Ad 5h]
Seat 1: d19ee248 (button) won ($1.38)
Seat 2: 24039de0 (small blind) folded before Flop
Seat 3: 79af8002 (big blind) folded before Flop
Seat 4: Hero folded before Flop (didn't bet)
Seat 5: 2ff0a04b folded before Flop (didn't bet)
Seat 6: 643f85e7 folded on the Flop


Poker Hand #RC3141670762: Hold'em No Limit ($0.05/$0.1) - 2024/12/12 12:48:24
Table 'RushAndCash22316022' 6-max Seat #1 is the button
Seat 1: fed024e0 ($10.69 in chips)
Seat 2: 895d916a ($35.33 in chips)
Seat 3: 643f85e7 ($10.3 in chips)
Seat 4: 1c087ec5 ($40.18 in chips)
Seat 5: Hero ($18.38 in chips)
Seat 6: 295cc1bc ($10 in chips)
895d916a: posts small blind $0.05
643f85e7: posts big blind $0.1
*** HOLE CARDS ***
Dealt to fed024e0 
Dealt to 895d916a 
Dealt to 643f85e7 
Dealt to 1c087ec5 
Dealt to Hero [Th As]
Dealt to 295cc1bc 
1c087ec5: folds
Hero: raises $0.1 to $0.2
295cc1bc: folds
fed024e0: folds
895d916a: folds
643f85e7: calls $0.1
*** FLOP *** [Kh 3h 9d]
643f85e7: checks
Hero: bets $0.15
643f85e7: calls $0.15
*** TURN *** [Kh 3h 9d] [Jh]
643f85e7: checks
Hero: bets $0.4
643f85e7: calls $0.4
*** RIVER *** [Kh 3h 9d Jh] [2s]
643f85e7: checks
Hero: checks
643f85e7: shows [Qs Js] (Pair of Jacks)
Hero: shows [Th As] (Ace-High)
*** SHOWDOWN ***
643f85e7 collected $1.48 from pot
*** SUMMARY ***
Total pot $1.55 | Rake $0.07 | Jackpot $0 | Bingo $0 | Fortune $0 | Tax $0
Board [Kh 3h 9d Jh 2s]
Seat 1: fed024e0 (button) folded before Flop (didn't bet)
Seat 2: 895d916a (small blind) folded before Flop
Seat 3: 643f85e7 (big blind) showed [Qs Js] and won ($1.48) with Pair of Jacks
Seat 4: 1c087ec5 folded before Flop (didn't bet)
Seat 5: Hero showed [Th As] and lost with Ace-High
Seat 6: 295cc1bc folded before Flop (didn't bet)


Poker Hand #RC3141670751: Hold'em No Limit ($0.05/$0.1) - 2024/12/12 12:48:21
Table 'RushAndCash22316011' 6-max Seat #1 is the button
Seat 1: 643f85e7 ($10.3 in chips)
Seat 2: 24c2159e ($10 in chips)
Seat 3: 59de94fc ($13.36 in chips)
Seat 4: e18303a2 ($13.96 in chips)
Seat 5: Hero ($18.38 in chips)
Seat 6: 2a6446ed ($18.18 in chips)
24c2159e: posts small blind $0.05
59de94fc: posts big blind $0.1
*** HOLE CARDS ***
Dealt to 643f85e7 
Dealt to 24c2159e 
Dealt to 59de94fc 
Dealt to e18303a2 
Dealt to Hero [3s 7c]
Dealt to 2a6446ed 
e18303a2: folds
Hero: folds
2a6446ed: folds
643f85e7: folds
24c2159e: folds
Uncalled bet ($0.05) returned to 59de94fc
*** SHOWDOWN ***
59de94fc collected $0.1 from pot
*** SUMMARY ***
Total pot $0.1 | Rake $0 | Jackpot $0 | Bingo $0 | Fortune $0 | Tax $0
Seat 1: 643f85e7 (button) folded before Flop (didn't bet)
Seat 2: 24c2159e (small blind) folded before Flop
Seat 3: 59de94fc (big blind) collected ($0.1)
Seat 4: e18303a2 folded before Flop (didn't bet)
Seat 5: Hero folded before Flop (didn't bet)
Seat 6: 2a6446ed folded before Flop (didn't bet)


Poker Hand #RC3141670673: Hold'em No Limit ($0.05/$0.1) - 2024/12/12 12:48:00
Table 'RushAndCash22315933' 6-max Seat #1 is the button
Seat 1: cacc74b2 ($12.82 in chips)
Seat 2: 5e5bf12a ($9.85 in chips)
Seat 3: 75ae83f ($10 in chips)
Seat 4: Hero ($18.38 in chips)
Seat 5: 874888c4 ($11.76 in chips)
Seat 6: 8cfa2620 ($19.73 in chips)
Cash Drop to Pot : total $1 
5e5bf12a: posts small blind $0.05
75ae83f: posts big blind $0.1
*** HOLE CARDS ***
Dealt to cacc74b2 
Dealt to 5e5bf12a 
Dealt to 75ae83f 
Dealt to Hero [6c Ah]
Dealt to 874888c4 
Dealt to 8cfa2620 
Hero: folds
874888c4: folds
8cfa2620: raises $0.3 to $0.4
cacc74b2: calls $0.4
5e5bf12a: calls $0.35
75ae83f: folds
*** FLOP *** [Qs Qd 7h]
5e5bf12a: checks
8cfa2620: bets $0.76
cacc74b2: folds
5e5bf12a: folds
Uncalled bet ($0.76) returned to 8cfa2620
*** SHOWDOWN ***
8cfa2620 collected $2.19 from pot
*** SUMMARY ***
Total pot $2.3 | Rake $0.11 | Jackpot $0 | Bingo $0 | Fortune $0 | Tax $0
Board [Qs Qd 7h]
Seat 1: cacc74b2 (button) folded on the Flop
Seat 2: 5e5bf12a (small blind) folded on the Flop
Seat 3: 75ae83f (big blind) folded before Flop
Seat 4: Hero folded before Flop (didn't bet)
Seat 5: 874888c4 folded before Flop (didn't bet)
Seat 6: 8cfa2620 won ($2.19)


Poker Hand #RC3141670643: Hold'em No Limit ($0.05/$0.1) - 2024/12/12 12:47:52
Table 'RushAndCash22315903' 6-max Seat #1 is the button
Seat 1: bf6a4250 ($10 in chips)
Seat 2: Hero ($18.43 in chips)
Seat 3: 1fe7df8c ($14.78 in chips)
Seat 4: 6c4ba3fb ($9.77 in chips)
Seat 5: 59de94fc ($13.41 in chips)
Seat 6: e6eec7bb ($10.05 in chips)
Hero: posts small blind $0.05
1fe7df8c: posts big blind $0.1
*** HOLE CARDS ***
Dealt to bf6a4250 
Dealt to Hero [4c 9h]
Dealt to 1fe7df8c 
Dealt to 6c4ba3fb 
Dealt to 59de94fc 
Dealt to e6eec7bb 
6c4ba3fb: folds
59de94fc: folds
e6eec7bb: raises $0.13 to $0.23
bf6a4250: folds
Hero: folds
1fe7df8c: calls $0.13
*** FLOP *** [Ts 6d Ad]
1fe7df8c: checks
e6eec7bb: bets $0.17
1fe7df8c: folds
Uncalled bet ($0.17) returned to e6eec7bb
*** SHOWDOWN ***
e6eec7bb collected $0.49 from pot
*** SUMMARY ***
Total pot $0.51 | Rake $0.02 | Jackpot $0 | Bingo $0 | Fortune $0 | Tax $0
Board [Ts 6d Ad]
Seat 1: bf6a4250 (button) folded before Flop (didn't bet)
Seat 2: Hero (small blind) folded before Flop
Seat 3: 1fe7df8c (big blind) folded on the Flop
Seat 4: 6c4ba3fb folded before Flop (didn't bet)
Seat 5: 59de94fc folded before Flop (didn't bet)
Seat 6: e6eec7bb won ($0.49)


Poker Hand #RC3141670600: Hold'em No Limit ($0.05/$0.1) - 2024/12/12 12:47:41
Table 'RushAndCash22315860' 6-max Seat #1 is the button
Seat 1: df2e1f5d ($10.36 in chips)
Seat 2: 874888c4 ($11.81 in chips)
Seat 3: Hero ($18.38 in chips)
Seat 4: a9eb45fc ($10 in chips)
Seat 5: d19ee248 ($9 in chips)
Seat 6: d6b17ac7 ($10.72 in chips)
874888c4: posts small blind $0.05
Hero: posts big blind $0.1
*** HOLE CARDS ***
Dealt to df2e1f5d 
Dealt to 874888c4 
Dealt to Hero [3d 3h]
Dealt to a9eb45fc 
Dealt to d19ee248 
Dealt to d6b17ac7 
a9eb45fc: folds
d19ee248: folds
d6b17ac7: folds
df2e1f5d: folds
874888c4: folds
Uncalled bet ($0.05) returned to Hero
*** SHOWDOWN ***
Hero collected $0.1 from pot
*** SUMMARY ***
Total pot $0.1 | Rake $0 | Jackpot $0 | Bingo $0 | Fortune $0 | Tax $0
Seat 1: df2e1f5d (button) folded before Flop (didn't bet)
Seat 2: 874888c4 (small blind) folded before Flop
Seat 3: Hero (big blind) collected ($0.1)
Seat 4: a9eb45fc folded before Flop (didn't bet)
Seat 5: d19ee248 folded before Flop (didn't bet)
Seat 6: d6b17ac7 folded before Flop (didn't bet)


Poker Hand #RC3141670228: Hold'em No Limit ($0.05/$0.1) - 2024/12/12 12:46:01
Table 'RushAndCash22315488' 6-max Seat #1 is the button
Seat 1: Hero ($17.12 in chips)
Seat 2: 3c1b4ee8 ($11.04 in chips)
Seat 3: 14311dad ($10 in chips)
Seat 4: e9fe744a ($39.39 in chips)
Seat 5: 65bfb346 ($18.67 in chips)
Seat 6: 4898aa10 ($23.88 in chips)
3c1b4ee8: posts small blind $0.05
14311dad: posts big blind $0.1
*** HOLE CARDS ***
Dealt to Hero [Ad Kh]
Dealt to 3c1b4ee8 
Dealt to 14311dad 
Dealt to e9fe744a 
Dealt to 65bfb346 
Dealt to 4898aa10 
e9fe744a: folds
65bfb346: folds
4898aa10: folds
Hero: raises $0.15 to $0.25
3c1b4ee8: folds
14311dad: calls $0.15
*** FLOP *** [Kd 9c 2h]
14311dad: checks
Hero: bets $0.19
14311dad: raises $0.9 to $1.09
Hero: calls $0.9
*** TURN *** [Kd 9c 2h] [Qc]
14311dad: checks
Hero: checks
*** RIVER *** [Kd 9c 2h Qc] [8s]
14311dad: checks
Hero: checks
14311dad: shows [Ah 4h] (Ace-High)
Hero: shows [Ad Kh] (Pair of Kings)
*** SHOWDOWN ***
Hero collected $2.6 from pot
*** SUMMARY ***
Total pot $2.73 | Rake $0.13 | Jackpot $0 | Bingo $0 | Fortune $0 | Tax $0
Board [Kd 9c 2h Qc 8s]
Seat 1: Hero (button) showed [Ad Kh] and won ($2.6) with Pair of Kings
Seat 2: 3c1b4ee8 (small blind) folded before Flop
Seat 3: 14311dad (big blind) showed [Ah 4h] and lost with Ace-High
Seat 4: e9fe744a folded before Flop (didn't bet)
Seat 5: 65bfb346 folded before Flop (didn't bet)
Seat 6: 4898aa10 folded before Flop (didn't bet)


Poker Hand #RC3141670208: Hold'em No Limit ($0.05/$0.1) - 2024/12/12 12:45:57
Table 'RushAndCash22315468' 6-max Seat #1 is the button
Seat 1: 4db3d050 ($8.46 in chips)
Seat 2: 20a8d101 ($13.33 in chips)
Seat 3: 15f3779a ($19.96 in chips)
Seat 4: 5b14e7af ($22.82 in chips)
Seat 5: af208717 ($13.03 in chips)
Seat 6: Hero ($17.12 in chips)
20a8d101: posts small blind $0.05
15f3779a: posts big blind $0.1
*** HOLE CARDS ***
Dealt to 4db3d050 
Dealt to 20a8d101 
Dealt to 15f3779a 
Dealt to 5b14e7af 
Dealt to af208717 
Dealt to Hero [2s 3s]
5b14e7af: folds
af208717: folds
Hero: folds
4db3d050: folds
20a8d101: folds
Uncalled bet ($0.05) returned to 15f3779a
*** SHOWDOWN ***
15f3779a collected $0.1 from pot
*** SUMMARY ***
Total pot $0.1 | Rake $0 | Jackpot $0 | Bingo $0 | Fortune $0 | Tax $0
Seat 1: 4db3d050 (button) folded before Flop (didn't bet)
Seat 2: 20a8d101 (small blind) folded before Flop
Seat 3: 15f3779a (big blind) collected ($0.1)
Seat 4: 5b14e7af folded before Flop (didn't bet)
Seat 5: af208717 folded before Flop (didn't bet)
Seat 6: Hero folded before Flop (didn't bet)


Poker Hand #RC3141670196: Hold'em No Limit ($0.05/$0.1) - 2024/12/12 12:45:53
Table 'RushAndCash22315456' 6-max Seat #1 is the button
Seat 1: Hero ($17.12 in chips)
Seat 2: 4a1f9c37 ($12.23 in chips)
Seat 3: bf6a4250 ($11.53 in chips)
Seat 4: c2b852ae ($11.73 in chips)
Seat 5: ce846db ($9.11 in chips)
Seat 6: b82279c3 ($40.86 in chips)
4a1f9c37: posts small blind $0.05
bf6a4250: posts big blind $0.1
*** HOLE CARDS ***
Dealt to Hero [7s Kh]
Dealt to 4a1f9c37 
Dealt to bf6a4250 
Dealt to c2b852ae 
Dealt to ce846db 
Dealt to b82279c3 
c2b852ae: folds
ce846db: folds
b82279c3: raises $0.15 to $0.25
Hero: folds
4a1f9c37: folds
bf6a4250: folds
Uncalled bet ($0.15) returned to b82279c3
*** SHOWDOWN ***
b82279c3 collected $0.25 from pot
*** SUMMARY ***
Total pot $0.25 | Rake $0 | Jackpot $0 | Bingo $0 | Fortune $0 | Tax $0
Seat 1: Hero (button) folded before Flop (didn't bet)
Seat 2: 4a1f9c37 (small blind) folded before Flop
Seat 3: bf6a4250 (big blind) folded before Flop
Seat 4: c2b852ae folded before Flop (didn't bet)
Seat 5: ce846db folded before Flop (didn't bet)
Seat 6: b82279c3 collected ($0.25)


Poker Hand #RC3141670184: Hold'em No Limit ($0.05/$0.1) - 2024/12/12 12:45:50
Table 'RushAndCash22315444' 6-max Seat #1 is the button
Seat 1: 95e11761 ($12.35 in chips)
Seat 2: Hero ($17.17 in chips)
Seat 3: 3e399c74 ($10 in chips)
Seat 4: 65bfb346 ($18.72 in chips)
Seat 5: af208717 ($13.03 in chips)
Seat 6: 8ebad06f ($15.16 in chips)
Hero: posts small blind $0.05
3e399c74: posts big blind $0.1
*** HOLE CARDS ***
Dealt to 95e11761 
Dealt to Hero [3c 6s]
Dealt to 3e399c74 
Dealt to 65bfb346 
Dealt to af208717 
Dealt to 8ebad06f 
65bfb346: folds
af208717: folds
8ebad06f: folds
95e11761: raises $0.15 to $0.25
Hero: folds
3e399c74: calls $0.15
*** FLOP *** [Qc 4c Ad]
3e399c74: checks
95e11761: checks
*** TURN *** [Qc 4c Ad] [5c]
3e399c74: bets $0.35
95e11761: calls $0.35
*** RIVER *** [Qc 4c Ad 5c] [9c]
3e399c74: bets $0.6
95e11761: calls $0.6
3e399c74: shows [8c Ac] (Ace High Flush)
95e11761: shows [Ks 8s] (Ace-High)
*** SHOWDOWN ***
3e399c74 collected $2.33 from pot
*** SUMMARY ***
Total pot $2.45 | Rake $0.12 | Jackpot $0 | Bingo $0 | Fortune $0 | Tax $0
Board [Qc 4c Ad 5c 9c]
Seat 1: 95e11761 (button) showed [Ks 8s] and lost with Ace-High
Seat 2: Hero (small blind) folded before Flop
Seat 3: 3e399c74 (big blind) showed [8c Ac] and won ($2.33) with Ace High Flush
Seat 4: 65bfb346 folded before Flop (didn't bet)
Seat 5: af208717 folded before Flop (didn't bet)
Seat 6: 8ebad06f folded before Flop (didn't bet)


Poker Hand #RC3141670171: Hold'em No Limit ($0.05/$0.1) - 2024/12/12 12:45:47
Table 'RushAndCash22315431' 6-max Seat #1 is the button
Seat 1: 5c1d4f73 ($10.35 in chips)
Seat 2: 51e7f794 ($3.75 in chips)
Seat 3: ee992e7e ($10 in chips)
Seat 4: af208717 ($13.03 in chips)
Seat 5: Hero ($17.17 in chips)
Seat 6: 17d1a506 ($13.69 in chips)
51e7f794: posts small blind $0.05
ee992e7e: posts big blind $0.1
*** HOLE CARDS ***
Dealt to 5c1d4f73 
Dealt to 51e7f794 
Dealt to ee992e7e 
Dealt to af208717 
Dealt to Hero [9s 6c]
Dealt to 17d1a506 
af208717: folds
Hero: folds
17d1a506: folds
5c1d4f73: raises $0.15 to $0.25
51e7f794: raises $0.45 to $0.7
ee992e7e: folds
5c1d4f73: folds
Uncalled bet ($0.45) returned to 51e7f794
*** SHOWDOWN ***
51e7f794 collected $0.57 from pot
*** SUMMARY ***
Total pot $0.6 | Rake $0.03 | Jackpot $0 | Bingo $0 | Fortune $0 | Tax $0
Seat 1: 5c1d4f73 (button) folded before Flop
Seat 2: 51e7f794 (small blind) collected ($0.57)
Seat 3: ee992e7e (big blind) folded before Flop
Seat 4: af208717 folded before Flop (didn't bet)
Seat 5: Hero folded before Flop (didn't bet)
Seat 6: 17d1a506 folded before Flop (didn't bet)


Poker Hand #RC3141669990: Hold'em No Limit ($0.05/$0.1) - 2024/12/12 12:44:57
Table 'RushAndCash22315250' 6-max Seat #1 is the button
Seat 1: ce410800 ($10.54 in chips)
Seat 2: ea8b094 ($6.87 in chips)
Seat 3: Hero ($10.75 in chips)
Seat 4: e896e324 ($10 in chips)
Seat 5: 51e7f794 ($4 in chips)
Seat 6: cc8462b1 ($13.11 in chips)
ea8b094: posts small blind $0.05
Hero: posts big blind $0.1
*** HOLE CARDS ***
Dealt to ce410800 
Dealt to ea8b094 
Dealt to Hero [Kc Kd]
Dealt to e896e324 
Dealt to 51e7f794 
Dealt to cc8462b1 
e896e324: folds
51e7f794: folds
cc8462b1: folds
ce410800: folds
ea8b094: raises $0.2 to $0.3
Hero: raises $0.5 to $0.8
ea8b094: raises $6.07 to $6.87 and is all-in
Hero: calls $6.07
ea8b094: shows [Ts Td]
Hero: shows [Kc Kd]
*** FLOP *** [8c Ks 3c]
*** TURN *** [8c Ks 3c] [Qh]
*** RIVER *** [8c Ks 3c Qh] [Ac]
*** SHOWDOWN ***
Hero collected $13.29 from pot
*** SUMMARY ***
Total pot $13.74 | Rake $0.3 | Jackpot $0.15 | Bingo $0 | Fortune $0 | Tax $0
Board [8c Ks 3c Qh Ac]
Seat 1: ce410800 (button) folded before Flop (didn't bet)
Seat 2: ea8b094 (small blind) showed [Ts Td] and lost with Pair of Tens
Seat 3: Hero (big blind) showed [Kc Kd] and won ($13.29) with Three Kings
Seat 4: e896e324 folded before Flop (didn't bet)
Seat 5: 51e7f794 folded before Flop (didn't bet)
Seat 6: cc8462b1 folded before Flop (didn't bet)


Poker Hand #RC3141669977: Hold'em No Limit ($0.05/$0.1) - 2024/12/12 12:44:54
Table 'RushAndCash22315237' 6-max Seat #1 is the button
Seat 1: 22e8274e ($14.1 in chips)
Seat 2: a6717311 ($20 in chips)
Seat 3: 77907fc4 ($24.24 in chips)
Seat 4: Hero ($10.75 in chips)
Seat 5: bc092e13 ($10 in chips)
Seat 6: 9c5748d ($20.75 in chips)
a6717311: posts small blind $0.05
77907fc4: posts big blind $0.1
*** HOLE CARDS ***
Dealt to 22e8274e 
Dealt to a6717311 
Dealt to 77907fc4 
Dealt to Hero [Qd Tc]
Dealt to bc092e13 
Dealt to 9c5748d 
Hero: folds
bc092e13: folds
9c5748d: folds
22e8274e: folds
a6717311: raises $0.2 to $0.3
77907fc4: calls $0.2
*** FLOP *** [Qs Ah 5h]
a6717311: checks
77907fc4: bets $0.1
a6717311: folds
Uncalled bet ($0.1) returned to 77907fc4
*** SHOWDOWN ***
77907fc4 collected $0.57 from pot
*** SUMMARY ***
Total pot $0.6 | Rake $0.03 | Jackpot $0 | Bingo $0 | Fortune $0 | Tax $0
Board [Qs Ah 5h]
Seat 1: 22e8274e (button) folded before Flop (didn't bet)
Seat 2: a6717311 (small blind) folded on the Flop
Seat 3: 77907fc4 (big blind) won ($0.57)
Seat 4: Hero folded before Flop (didn't bet)
Seat 5: bc092e13 folded before Flop (didn't bet)
Seat 6: 9c5748d folded before Flop (didn't bet)


Poker Hand #RC3141669963: Hold'em No Limit ($0.05/$0.1) - 2024/12/12 12:44:51
Table 'RushAndCash22315223' 6-max Seat #1 is the button
Seat 1: 4746887d ($13.75 in chips)
Seat 2: b17f5bfe ($5.78 in chips)
Seat 3: 1039fde1 ($12.67 in chips)
Seat 4: 1f83b349 ($9.38 in chips)
Seat 5: Hero ($10.75 in chips)
Seat 6: 3f7822ab ($20.15 in chips)
b17f5bfe: posts small blind $0.05
1039fde1: posts big blind $0.1
*** HOLE CARDS ***
Dealt to 4746887d 
Dealt to b17f5bfe 
Dealt to 1039fde1 
Dealt to 1f83b349 
Dealt to Hero [Td 3c]
Dealt to 3f7822ab 
1f83b349: folds
Hero: folds
3f7822ab: folds
4746887d: folds
b17f5bfe: folds
Uncalled bet ($0.05) returned to 1039fde1
*** SHOWDOWN ***
1039fde1 collected $0.1 from pot
*** SUMMARY ***
Total pot $0.1 | Rake $0 | Jackpot $0 | Bingo $0 | Fortune $0 | Tax $0
Seat 1: 4746887d (button) folded before Flop (didn't bet)
Seat 2: b17f5bfe (small blind) folded before Flop
Seat 3: 1039fde1 (big blind) collected ($0.1)
Seat 4: 1f83b349 folded before Flop (didn't bet)
Seat 5: Hero folded before Flop (didn't bet)
Seat 6: 3f7822ab folded before Flop (didn't bet)


Poker Hand #RC3141669928: Hold'em No Limit ($0.05/$0.1) - 2024/12/12 12:44:42
Table 'RushAndCash22315188' 6-max Seat #1 is the button
Seat 1: a1f416c7 ($10.66 in chips)
Seat 2: 8ebad06f ($14.83 in chips)
Seat 3: 204f692c ($10 in chips)
Seat 4: d827b781 ($13.88 in chips)
Seat 5: Hero ($10.75 in chips)
Seat 6: 9a52083d ($24.52 in chips)
8ebad06f: posts small blind $0.05
204f692c: posts big blind $0.1
*** HOLE CARDS ***
Dealt to a1f416c7 
Dealt to 8ebad06f 
Dealt to 204f692c 
Dealt to d827b781 
Dealt to Hero [4d Ac]
Dealt to 9a52083d 
d827b781: folds
Hero: folds
9a52083d: folds
a1f416c7: folds
8ebad06f: raises $0.2 to $0.3
204f692c: folds
Uncalled bet ($0.2) returned to 8ebad06f
*** SHOWDOWN ***
8ebad06f collected $0.2 from pot
*** SUMMARY ***
Total pot $0.2 | Rake $0 | Jackpot $0 | Bingo $0 | Fortune $0 | Tax $0
Seat 1: a1f416c7 (button) folded before Flop (didn't bet)
Seat 2: 8ebad06f (small blind) collected ($0.2)
Seat 3: 204f692c (big blind) folded before Flop
Seat 4: d827b781 folded before Flop (didn't bet)
Seat 5: Hero folded before Flop (didn't bet)
Seat 6: 9a52083d folded before Flop (didn't bet)


Poker Hand #RC3141669910: Hold'em No Limit ($0.05/$0.1) - 2024/12/12 12:44:38
Table 'RushAndCash22315170' 6-max Seat #1 is the button
Seat 1: 1e41d97e ($6 in chips)
Seat 2: 92e8bfbd ($25.73 in chips)
Seat 3: 8ebad06f ($14.93 in chips)
Seat 4: b73e1c09 ($24.57 in chips)
Seat 5: Hero ($10.75 in chips)
Seat 6: 673ecd77 ($22.35 in chips)
92e8bfbd: posts small blind $0.05
8ebad06f: posts big blind $0.1
*** HOLE CARDS ***
Dealt to 1e41d97e 
Dealt to 92e8bfbd 
Dealt to 8ebad06f 
Dealt to b73e1c09 
Dealt to Hero [2s Jc]
Dealt to 673ecd77 
b73e1c09: folds
Hero: folds
673ecd77: raises $0.15 to $0.25
1e41d97e: folds
92e8bfbd: calls $0.2
8ebad06f: folds
*** FLOP *** [9h 6h Td]
92e8bfbd: checks
673ecd77: checks
*** TURN *** [9h 6h Td] [3h]
92e8bfbd: bets $0.45
673ecd77: calls $0.45
*** RIVER *** [9h 6h Td 3h] [Tc]
92e8bfbd: bets $0.5
673ecd77: calls $0.5
92e8bfbd: shows [6c 6s] (Sixes Full over Tens)
673ecd77: shows [Ah 9d] (Pair of Tens and Pair of Nines)
*** SHOWDOWN ***
92e8bfbd collected $2.38 from pot
*** SUMMARY ***
Total pot $2.5 | Rake $0.12 | Jackpot $0 | Bingo $0 | Fortune $0 | Tax $0
Board [9h 6h Td 3h Tc]
Seat 1: 1e41d97e (button) folded before Flop (didn't bet)
Seat 2: 92e8bfbd (small blind) showed [6c 6s] and won ($2.38) with Sixes Full over Tens
Seat 3: 8ebad06f (big blind) folded before Flop
Seat 4: b73e1c09 folded before Flop (didn't bet)
Seat 5: Hero folded before Flop (didn't bet)
Seat 6: 673ecd77 showed [Ah 9d] and lost with Pair of Tens and Pair of Nines


Poker Hand #RC3141669894: Hold'em No Limit ($0.05/$0.1) - 2024/12/12 12:44:34
Table 'RushAndCash22315154' 6-max Seat #1 is the button
Seat 1: Hero ($10.75 in chips)
Seat 2: 916c6bd3 ($4.44 in chips)
Seat 3: 22e8274e ($14.3 in chips)
Seat 4: 3c1b4ee8 ($10.62 in chips)
Seat 5: 673ecd77 ($22.35 in chips)
Seat 6: 77907fc4 ($24.01 in chips)
916c6bd3: posts small blind $0.05
22e8274e: posts big blind $0.1
*** HOLE CARDS ***
Dealt to Hero [6d 3h]
Dealt to 916c6bd3 
Dealt to 22e8274e 
Dealt to 3c1b4ee8 
Dealt to 673ecd77 
Dealt to 77907fc4 
3c1b4ee8: folds
673ecd77: folds
77907fc4: raises $0.1 to $0.2
Hero: folds
916c6bd3: folds
22e8274e: calls $0.1
*** FLOP *** [4d 3c 7h]
22e8274e: checks
77907fc4: bets $0.15
22e8274e: folds
Uncalled bet ($0.15) returned to 77907fc4
*** SHOWDOWN ***
77907fc4 collected $0.43 from pot
*** SUMMARY ***
Total pot $0.45 | Rake $0.02 | Jackpot $0 | Bingo $0 | Fortune $0 | Tax $0
Board [4d 3c 7h]
Seat 1: Hero (button) folded before Flop (didn't bet)
Seat 2: 916c6bd3 (small blind) folded before Flop
Seat 3: 22e8274e (big blind) folded on the Flop
Seat 4: 3c1b4ee8 folded before Flop (didn't bet)
Seat 5: 673ecd77 folded before Flop (didn't bet)
Seat 6: 77907fc4 won ($0.43)


Poker Hand #RC3141669843: Hold'em No Limit ($0.05/$0.1) - 2024/12/12 12:44:23
Table 'RushAndCash22315103' 6-max Seat #1 is the button
Seat 1: b51a8683 ($10 in chips)
Seat 2: Hero ($10.8 in chips)
Seat 3: e18303a2 ($13.24 in chips)
Seat 4: e2a23377 ($10 in chips)
Seat 5: 9a52083d ($24.57 in chips)
Seat 6: 31e1f60f ($14.98 in chips)
Hero: posts small blind $0.05
e18303a2: posts big blind $0.1
*** HOLE CARDS ***
Dealt to b51a8683 
Dealt to Hero [Th 9d]
Dealt to e18303a2 
Dealt to e2a23377 
Dealt to 9a52083d 
Dealt to 31e1f60f 
e2a23377: folds
9a52083d: folds
31e1f60f: folds
b51a8683: raises $0.15 to $0.25
Hero: folds
e18303a2: folds
Uncalled bet ($0.15) returned to b51a8683
*** SHOWDOWN ***
b51a8683 collected $0.25 from pot
*** SUMMARY ***
Total pot $0.25 | Rake $0 | Jackpot $0 | Bingo $0 | Fortune $0 | Tax $0
Seat 1: b51a8683 (button) collected ($0.25)
Seat 2: Hero (small blind) folded before Flop
Seat 3: e18303a2 (big blind) folded before Flop
Seat 4: e2a23377 folded before Flop (didn't bet)
Seat 5: 9a52083d folded before Flop (didn't bet)
Seat 6: 31e1f60f folded before Flop (didn't bet)


Poker Hand #RC3141669752: Hold'em No Limit ($0.05/$0.1) - 2024/12/12 12:44:02
Table 'RushAndCash22315012' 6-max Seat #1 is the button
Seat 1: b17f5bfe ($5.78 in chips)
Seat 2: 3e399c74 ($10.15 in chips)
Seat 3: Hero ($10.57 in chips)
Seat 4: 3b768af1 ($12.39 in chips)
Seat 5: f04fb852 ($10.11 in chips)
Seat 6: 75ae83f ($10.45 in chips)
3e399c74: posts small blind $0.05
Hero: posts big blind $0.1
*** HOLE CARDS ***
Dealt to b17f5bfe 
Dealt to 3e399c74 
Dealt to Hero [Ad Ac]
Dealt to 3b768af1 
Dealt to f04fb852 
Dealt to 75ae83f 
3b768af1: folds
f04fb852: raises $0.1 to $0.2
75ae83f: folds
b17f5bfe: folds
3e399c74: folds
Hero: raises $0.8 to $1
f04fb852: folds
Uncalled bet ($0.8) returned to Hero
*** SHOWDOWN ***
Hero collected $0.43 from pot
*** SUMMARY ***
Total pot $0.45 | Rake $0.02 | Jackpot $0 | Bingo $0 | Fortune $0 | Tax $0
Seat 1: b17f5bfe (button) folded before Flop (didn't bet)
Seat 2: 3e399c74 (small blind) folded before Flop
Seat 3: Hero (big blind) collected ($0.43)
Seat 4: 3b768af1 folded before Flop (didn't bet)
Seat 5: f04fb852 folded before Flop
Seat 6: 75ae83f folded before Flop (didn't bet)


Poker Hand #RC3141669727: Hold'em No Limit ($0.05/$0.1) - 2024/12/12 12:43:57
Table 'RushAndCash22314987' 6-max Seat #1 is the button
Seat 1: 2db5d1cb ($13.13 in chips)
Seat 2: 25c1f7d7 ($10 in chips)
Seat 3: 17b381d5 ($25.1 in chips)
Seat 4: Hero ($10.57 in chips)
Seat 5: a8e8a7b5 ($19.58 in chips)
Seat 6: 40c5a5bd ($10 in chips)
25c1f7d7: posts small blind $0.05
17b381d5: posts big blind $0.1
*** HOLE CARDS ***
Dealt to 2db5d1cb 
Dealt to 25c1f7d7 
Dealt to 17b381d5 
Dealt to Hero [Qs 8s]
Dealt to a8e8a7b5 
Dealt to 40c5a5bd 
Hero: folds
a8e8a7b5: raises $0.15 to $0.25
40c5a5bd: folds
2db5d1cb: folds
25c1f7d7: folds
17b381d5: calls $0.15
*** FLOP *** [Ts 7h 4s]
17b381d5: checks
a8e8a7b5: bets $0.27
17b381d5: calls $0.27
*** TURN *** [Ts 7h 4s] [Ad]
17b381d5: checks
a8e8a7b5: bets $0.83
17b381d5: folds
Uncalled bet ($0.83) returned to a8e8a7b5
*** SHOWDOWN ***
a8e8a7b5 collected $1.04 from pot
*** SUMMARY ***
Total pot $1.09 | Rake $0.05 | Jackpot $0 | Bingo $0 | Fortune $0 | Tax $0
Board [Ts 7h 4s Ad]
Seat 1: 2db5d1cb (button) folded before Flop (didn't bet)
Seat 2: 25c1f7d7 (small blind) folded before Flop
Seat 3: 17b381d5 (big blind) folded on the Turn
Seat 4: Hero folded before Flop (didn't bet)
Seat 5: a8e8a7b5 won ($1.04)
Seat 6: 40c5a5bd folded before Flop (didn't bet)


Poker Hand #RC3141669712: Hold'em No Limit ($0.05/$0.1) - 2024/12/12 12:43:53
Table 'RushAndCash22314972' 6-max Seat #1 is the button
Seat 1: 14311dad ($10.15 in chips)
Seat 2: 481b7ef8 ($10.11 in chips)
Seat 3: aaca7529 ($6.04 in chips)
Seat 4: Hero ($10.57 in chips)
Seat 5: 2db5d1cb ($13.13 in chips)
Seat 6: b1f396f4 ($29.14 in chips)
481b7ef8: posts small blind $0.05
aaca7529: posts big blind $0.1
*** HOLE CARDS ***
Dealt to 14311dad 
Dealt to 481b7ef8 
Dealt to aaca7529 
Dealt to Hero [6d 3c]
Dealt to 2db5d1cb 
Dealt to b1f396f4 
Hero: folds
2db5d1cb: folds
b1f396f4: folds
14311dad: raises $0.15 to $0.25
481b7ef8: folds
aaca7529: calls $0.15
*** FLOP *** [9c Jh 9d]
aaca7529: bets $0.19
14311dad: calls $0.19
*** TURN *** [9c Jh 9d] [Qc]
aaca7529: bets $0.47
14311dad: folds
Uncalled bet ($0.47) returned to aaca7529
aaca7529: shows [9h] (Three Nines)
*** SHOWDOWN ***
aaca7529 collected $0.89 from pot
*** SUMMARY ***
Total pot $0.93 | Rake $0.04 | Jackpot $0 | Bingo $0 | Fortune $0 | Tax $0
Board [9c Jh 9d Qc]
Seat 1: 14311dad (button) folded on the Turn
Seat 2: 481b7ef8 (small blind) folded before Flop
Seat 3: aaca7529 (big blind) showed [9h] and won ($0.89)
Seat 4: Hero folded before Flop (didn't bet)
Seat 5: 2db5d1cb folded before Flop (didn't bet)
Seat 6: b1f396f4 folded before Flop (didn't bet)


Poker Hand #RC3141669659: Hold'em No Limit ($0.05/$0.1) - 2024/12/12 12:43:41
Table 'RushAndCash22314919' 6-max Seat #1 is the button
Seat 1: Hero ($10.42 in chips)
Seat 2: 54d53a50 ($19.83 in chips)
Seat 3: 31e1f60f ($15.28 in chips)
Seat 4: 1fe7df8c ($13.65 in chips)
Seat 5: 101c026b ($24.64 in chips)
Seat 6: b053d810 ($11.65 in chips)
54d53a50: posts small blind $0.05
31e1f60f: posts big blind $0.1
*** HOLE CARDS ***
Dealt to Hero [3c Ac]
Dealt to 54d53a50 
Dealt to 31e1f60f 
Dealt to 1fe7df8c 
Dealt to 101c026b 
Dealt to b053d810 
1fe7df8c: folds
101c026b: folds
b053d810: folds
Hero: raises $0.15 to $0.25
54d53a50: folds
31e1f60f: folds
Uncalled bet ($0.15) returned to Hero
*** SHOWDOWN ***
Hero collected $0.25 from pot
*** SUMMARY ***
Total pot $0.25 | Rake $0 | Jackpot $0 | Bingo $0 | Fortune $0 | Tax $0
Seat 1: Hero (button) collected ($0.25)
Seat 2: 54d53a50 (small blind) folded before Flop
Seat 3: 31e1f60f (big blind) folded before Flop
Seat 4: 1fe7df8c folded before Flop (didn't bet)
Seat 5: 101c026b folded before Flop (didn't bet)
Seat 6: b053d810 folded before Flop (didn't bet)


Poker Hand #RC3141669624: Hold'em No Limit ($0.05/$0.1) - 2024/12/12 12:43:32
Table 'RushAndCash22314884' 6-max Seat #1 is the button
Seat 1: 5304ad76 ($10 in chips)
Seat 2: Hero ($10.47 in chips)
Seat 3: 4e5c7119 ($11.24 in chips)
Seat 4: 574859ba ($10.2 in chips)
Seat 5: 38992bb8 ($18.04 in chips)
Seat 6: f2ece23 ($14.44 in chips)
Hero: posts small blind $0.05
4e5c7119: posts big blind $0.1
*** HOLE CARDS ***
Dealt to 5304ad76 
Dealt to Hero [Qs 4c]
Dealt to 4e5c7119 
Dealt to 574859ba 
Dealt to 38992bb8 
Dealt to f2ece23 
574859ba: folds
38992bb8: folds
f2ece23: raises $0.1 to $0.2
5304ad76: folds
Hero: folds
4e5c7119: calls $0.1
*** FLOP *** [6h Kd 6s]
4e5c7119: checks
f2ece23: bets $0.12
4e5c7119: folds
Uncalled bet ($0.12) returned to f2ece23
*** SHOWDOWN ***
f2ece23 collected $0.43 from pot
*** SUMMARY ***
Total pot $0.45 | Rake $0.02 | Jackpot $0 | Bingo $0 | Fortune $0 | Tax $0
Board [6h Kd 6s]
Seat 1: 5304ad76 (button) folded before Flop (didn't bet)
Seat 2: Hero (small blind) folded before Flop
Seat 3: 4e5c7119 (big blind) folded on the Flop
Seat 4: 574859ba folded before Flop (didn't bet)
Seat 5: 38992bb8 folded before Flop (didn't bet)
Seat 6: f2ece23 won ($0.43)


Poker Hand #RC3141669587: Hold'em No Limit ($0.05/$0.1) - 2024/12/12 12:43:23
Table 'RushAndCash22314847' 6-max Seat #1 is the button
Seat 1: f1e9bea0 ($35.71 in chips)
Seat 2: 4cf42699 ($10.33 in chips)
Seat 3: Hero ($10.57 in chips)
Seat 4: 54a8e111 ($10 in chips)
Seat 5: a730cdce ($10 in chips)
Seat 6: 92e8bfbd ($26.08 in chips)
4cf42699: posts small blind $0.05
Hero: posts big blind $0.1
*** HOLE CARDS ***
Dealt to f1e9bea0 
Dealt to 4cf42699 
Dealt to Hero [8h 3d]
Dealt to 54a8e111 
Dealt to a730cdce 
Dealt to 92e8bfbd 
54a8e111: raises $0.1 to $0.2
a730cdce: folds
92e8bfbd: folds
f1e9bea0: folds
4cf42699: folds
Hero: folds
Uncalled bet ($0.1) returned to 54a8e111
*** SHOWDOWN ***
54a8e111 collected $0.25 from pot
*** SUMMARY ***
Total pot $0.25 | Rake $0 | Jackpot $0 | Bingo $0 | Fortune $0 | Tax $0
Seat 1: f1e9bea0 (button) folded before Flop (didn't bet)
Seat 2: 4cf42699 (small blind) folded before Flop
Seat 3: Hero (big blind) folded before Flop
Seat 4: 54a8e111 collected ($0.25)
Seat 5: a730cdce folded before Flop (didn't bet)
Seat 6: 92e8bfbd folded before Flop (didn't bet)


Poker Hand #RC3141669496: Hold'em No Limit ($0.05/$0.1) - 2024/12/12 12:43:03
Table 'RushAndCash22314756' 6-max Seat #1 is the button
Seat 1: d578ebdd ($10.29 in chips)
Seat 2: f4a0e033 ($10.36 in chips)
Seat 3: f347a136 ($10.47 in chips)
Seat 4: 556a8b26 ($10.15 in chips)
Seat 5: 1d8dcfab ($11.04 in chips)
Seat 6: Hero ($10.42 in chips)
f4a0e033: posts small blind $0.05
f347a136: posts big blind $0.1
*** HOLE CARDS ***
Dealt to d578ebdd 
Dealt to f4a0e033 
Dealt to f347a136 
Dealt to 556a8b26 
Dealt to 1d8dcfab 
Dealt to Hero [Ac 9s]
556a8b26: folds
1d8dcfab: folds
Hero: raises $0.15 to $0.25
d578ebdd: folds
f4a0e033: folds
f347a136: folds
Uncalled bet ($0.15) returned to Hero
*** SHOWDOWN ***
Hero collected $0.25 from pot
*** SUMMARY ***
Total pot $0.25 | Rake $0 | Jackpot $0 | Bingo $0 | Fortune $0 | Tax $0
Seat 1: d578ebdd (button) folded before Flop (didn't bet)
Seat 2: f4a0e033 (small blind) folded before Flop
Seat 3: f347a136 (big blind) folded before Flop
Seat 4: 556a8b26 folded before Flop (didn't bet)
Seat 5: 1d8dcfab folded before Flop (didn't bet)
Seat 6: Hero collected ($0.25)


Poker Hand #RC3141669481: Hold'em No Limit ($0.05/$0.1) - 2024/12/12 12:42:59
Table 'RushAndCash22314741' 6-max Seat #1 is the button
Seat 1: 1d8dcfab ($11.04 in chips)
Seat 2: f4a0e033 ($10.41 in chips)
Seat 3: 719fb29e ($14.37 in chips)
Seat 4: c199627b ($12.23 in chips)
Seat 5: 8ebad06f ($15.38 in chips)
Seat 6: Hero ($10.42 in chips)
f4a0e033: posts small blind $0.05
719fb29e: posts big blind $0.1
*** HOLE CARDS ***
Dealt to 1d8dcfab 
Dealt to f4a0e033 
Dealt to 719fb29e 
Dealt to c199627b 
Dealt to 8ebad06f 
Dealt to Hero [3d Qc]
c199627b: folds
8ebad06f: folds
Hero: folds
1d8dcfab: folds
f4a0e033: folds
Uncalled bet ($0.05) returned to 719fb29e
*** SHOWDOWN ***
719fb29e collected $0.1 from pot
*** SUMMARY ***
Total pot $0.1 | Rake $0 | Jackpot $0 | Bingo $0 | Fortune $0 | Tax $0
Seat 1: 1d8dcfab (button) folded before Flop (didn't bet)
Seat 2: f4a0e033 (small blind) folded before Flop
Seat 3: 719fb29e (big blind) collected ($0.1)
Seat 4: c199627b folded before Flop (didn't bet)
Seat 5: 8ebad06f folded before Flop (didn't bet)
Seat 6: Hero folded before Flop (didn't bet)


Poker Hand #RC3141669391: Hold'em No Limit ($0.05/$0.1) - 2024/12/12 12:42:38
Table 'RushAndCash22314651' 6-max Seat #1 is the button
Seat 1: 721d2ee6 ($12.81 in chips)
Seat 2: a0bab1fa ($10 in chips)
Seat 3: a35a0951 ($7.81 in chips)
Seat 4: Hero ($10.62 in chips)
Seat 5: 2e735933 ($12.8 in chips)
Seat 6: eb765b8f ($11.53 in chips)
a0bab1fa: posts small blind $0.05
a35a0951: posts big blind $0.1
*** HOLE CARDS ***
Dealt to 721d2ee6 
Dealt to a0bab1fa 
Dealt to a35a0951 
Dealt to Hero [7c 7s]
Dealt to 2e735933 
Dealt to eb765b8f 
Hero: raises $0.1 to $0.2
2e735933: folds
eb765b8f: folds
721d2ee6: folds
a0bab1fa: raises $0.6 to $0.8
a35a0951: folds
Hero: folds
Uncalled bet ($0.6) returned to a0bab1fa
*** SHOWDOWN ***
a0bab1fa collected $0.48 from pot
*** SUMMARY ***
Total pot $0.5 | Rake $0.02 | Jackpot $0 | Bingo $0 | Fortune $0 | Tax $0
Seat 1: 721d2ee6 (button) folded before Flop (didn't bet)
Seat 2: a0bab1fa (small blind) collected ($0.48)
Seat 3: a35a0951 (big blind) folded before Flop
Seat 4: Hero folded before Flop
Seat 5: 2e735933 folded before Flop (didn't bet)
Seat 6: eb765b8f folded before Flop (didn't bet)


Poker Hand #RC3141669374: Hold'em No Limit ($0.05/$0.1) - 2024/12/12 12:42:34
Table 'RushAndCash22314634' 6-max Seat #1 is the button
Seat 1: 673ecd77 ($22.6 in chips)
Seat 2: b053d810 ($11.8 in chips)
Seat 3: 5304ad76 ($10.05 in chips)
Seat 4: Hero ($10.62 in chips)
Seat 5: 24039de0 ($11.45 in chips)
Seat 6: 77162ce3 ($10.07 in chips)
b053d810: posts small blind $0.05
5304ad76: posts big blind $0.1
*** HOLE CARDS ***
Dealt to 673ecd77 
Dealt to b053d810 
Dealt to 5304ad76 
Dealt to Hero [Qh 8h]
Dealt to 24039de0 
Dealt to 77162ce3 
Hero: folds
24039de0: folds
77162ce3: folds
673ecd77: folds
b053d810: folds
Uncalled bet ($0.05) returned to 5304ad76
*** SHOWDOWN ***
5304ad76 collected $0.1 from pot
*** SUMMARY ***
Total pot $0.1 | Rake $0 | Jackpot $0 | Bingo $0 | Fortune $0 | Tax $0
Seat 1: 673ecd77 (button) folded before Flop (didn't bet)
Seat 2: b053d810 (small blind) folded before Flop
Seat 3: 5304ad76 (big blind) collected ($0.1)
Seat 4: Hero folded before Flop (didn't bet)
Seat 5: 24039de0 folded before Flop (didn't bet)
Seat 6: 77162ce3 folded before Flop (didn't bet)


Poker Hand #RC3141669198: Hold'em No Limit ($0.05/$0.1) - 2024/12/12 12:41:53
Table 'RushAndCash22314458' 6-max Seat #1 is the button
Seat 1: bc2007a2 ($15.42 in chips)
Seat 2: Hero ($10.92 in chips)
Seat 3: b053d810 ($11.53 in chips)
Seat 4: c8e1bfcc ($10.96 in chips)
Seat 5: cacc74b2 ($10.22 in chips)
Seat 6: 844091a0 ($10.33 in chips)
Hero: posts small blind $0.05
b053d810: posts big blind $0.1
*** HOLE CARDS ***
Dealt to bc2007a2 
Dealt to Hero [8h Kc]
Dealt to b053d810 
Dealt to c8e1bfcc 
Dealt to cacc74b2 
Dealt to 844091a0 
c8e1bfcc: folds
cacc74b2: folds
844091a0: folds
bc2007a2: folds
Hero: raises $0.2 to $0.3
b053d810: calls $0.2
*** FLOP *** [9h 4s Qh]
Hero: checks
b053d810: bets $0.3
Hero: folds
Uncalled bet ($0.3) returned to b053d810
*** SHOWDOWN ***
b053d810 collected $0.57 from pot
*** SUMMARY ***
Total pot $0.6 | Rake $0.03 | Jackpot $0 | Bingo $0 | Fortune $0 | Tax $0
Board [9h 4s Qh]
Seat 1: bc2007a2 (button) folded before Flop (didn't bet)
Seat 2: Hero (small blind) folded on the Flop
Seat 3: b053d810 (big blind) won ($0.57)
Seat 4: c8e1bfcc folded before Flop (didn't bet)
Seat 5: cacc74b2 folded before Flop (didn't bet)
Seat 6: 844091a0 folded before Flop (didn't bet)


Poker Hand #RC3141668897: Hold'em No Limit ($0.05/$0.1) - 2024/12/12 12:40:40
Table 'RushAndCash22314157' 6-max Seat #1 is the button
Seat 1: 24039de0 ($12.11 in chips)
Seat 2: 574859ba ($10.44 in chips)
Seat 3: Hero ($10.37 in chips)
Seat 4: 59307d25 ($14.31 in chips)
Seat 5: 4898aa10 ($18.13 in chips)
Seat 6: 81834a2f ($22.06 in chips)
574859ba: posts small blind $0.05
Hero: posts big blind $0.1
*** HOLE CARDS ***
Dealt to 24039de0 
Dealt to 574859ba 
Dealt to Hero [7c Ac]
Dealt to 59307d25 
Dealt to 4898aa10 
Dealt to 81834a2f 
59307d25: raises $0.1 to $0.2
4898aa10: folds
81834a2f: folds
24039de0: folds
574859ba: folds
Hero: calls $0.1
*** FLOP *** [Qs 6c 7h]
Hero: checks
59307d25: checks
*** TURN *** [Qs 6c 7h] [Kc]
Hero: checks
59307d25: bets $0.35
Hero: raises $0.87 to $1.22
59307d25: folds
Uncalled bet ($0.87) returned to Hero
*** SHOWDOWN ***
Hero collected $1.1 from pot
*** SUMMARY ***
Total pot $1.15 | Rake $0.05 | Jackpot $0 | Bingo $0 | Fortune $0 | Tax $0
Board [Qs 6c 7h Kc]
Seat 1: 24039de0 (button) folded before Flop (didn't bet)
Seat 2: 574859ba (small blind) folded before Flop
Seat 3: Hero (big blind) won ($1.1)
Seat 4: 59307d25 folded on the Turn
Seat 5: 4898aa10 folded before Flop (didn't bet)
Seat 6: 81834a2f folded before Flop (didn't bet)


Poker Hand #RC3141668883: Hold'em No Limit ($0.05/$0.1) - 2024/12/12 12:40:37
Table 'RushAndCash22314143' 6-max Seat #1 is the button
Seat 1: Hero ($10.37 in chips)
Seat 2: ead6156b ($10.85 in chips)
Seat 3: 31e1f60f ($14.96 in chips)
Seat 4: 65bfb346 ($19.88 in chips)
Seat 5: aee2ed20 ($10.67 in chips)
Seat 6: 4e5368fb ($11.39 in chips)
ead6156b: posts small blind $0.05
31e1f60f: posts big blind $0.1
*** HOLE CARDS ***
Dealt to Hero [2s 5s]
Dealt to ead6156b 
Dealt to 31e1f60f 
Dealt to 65bfb346 
Dealt to aee2ed20 
Dealt to 4e5368fb 
65bfb346: folds
aee2ed20: folds
4e5368fb: raises $0.2 to $0.3
Hero: folds
ead6156b: calls $0.25
31e1f60f: raises $14.66 to $14.96 and is all-in
4e5368fb: folds
ead6156b: folds
Uncalled bet ($14.66) returned to 31e1f60f
*** SHOWDOWN ***
31e1f60f collected $0.86 from pot
*** SUMMARY ***
Total pot $0.9 | Rake $0.04 | Jackpot $0 | Bingo $0 | Fortune $0 | Tax $0
Seat 1: Hero (button) folded before Flop (didn't bet)
Seat 2: ead6156b (small blind) folded before Flop
Seat 3: 31e1f60f (big blind) collected ($0.86)
Seat 4: 65bfb346 folded before Flop (didn't bet)
Seat 5: aee2ed20 folded before Flop (didn't bet)
Seat 6: 4e5368fb folded before Flop


Poker Hand #RC3141668619: Hold'em No Limit ($0.05/$0.1) - 2024/12/12 12:39:34
Table 'RushAndCash22313879' 6-max Seat #1 is the button
Seat 1: 2ad815d2 ($9.94 in chips)
Seat 2: 65bfb346 ($20.08 in chips)
Seat 3: ead6156b ($11.05 in chips)
Seat 4: Hero ($10 in chips)
Seat 5: b8e03e64 ($10 in chips)
Seat 6: 31e1f60f ($14.68 in chips)
65bfb346: posts small blind $0.05
ead6156b: posts big blind $0.1
*** HOLE CARDS ***
Dealt to 2ad815d2 
Dealt to 65bfb346 
Dealt to ead6156b 
Dealt to Hero [7h Ad]
Dealt to b8e03e64 
Dealt to 31e1f60f 
Hero: raises $0.1 to $0.2
b8e03e64: folds
31e1f60f: folds
2ad815d2: folds
65bfb346: calls $0.15
ead6156b: calls $0.1
*** FLOP *** [7c 6d Qd]
65bfb346: checks
ead6156b: checks
Hero: checks
*** TURN *** [7c 6d Qd] [Jc]
65bfb346: checks
ead6156b: checks
Hero: checks
*** RIVER *** [7c 6d Qd Jc] [Qc]
65bfb346: checks
ead6156b: checks
Hero: checks
65bfb346: shows [5h 5s] (Pair of Queens and Pair of Fives)
ead6156b: shows [Ts Ks] (Pair of Queens)
Hero: shows [7h Ad] (Pair of Queens and Pair of Sevens)
*** SHOWDOWN ***
Hero collected $0.57 from pot
*** SUMMARY ***
Total pot $0.6 | Rake $0.03 | Jackpot $0 | Bingo $0 | Fortune $0 | Tax $0
Board [7c 6d Qd Jc Qc]
Seat 1: 2ad815d2 (button) folded before Flop (didn't bet)
Seat 2: 65bfb346 (small blind) showed [5h 5s] and lost with Pair of Queens and Pair of Fives
Seat 3: ead6156b (big blind) showed [Ts Ks] and lost with Pair of Queens
Seat 4: Hero showed [7h Ad] and won ($0.57) with Pair of Queens and Pair of Sevens
Seat 5: b8e03e64 folded before Flop (didn't bet)
Seat 6: 31e1f60f folded before Flop (didn't bet)


Poker Hand #RC3141668580: Hold'em No Limit ($0.05/$0.1) - 2024/12/12 12:39:24
Table 'RushAndCash22313840' 6-max Seat #1 is the button
Seat 1: 80ebdd41 ($11.05 in chips)
Seat 2: 8fc49c26 ($43.18 in chips)
Seat 3: 84c34548 ($12.17 in chips)
Seat 4: cbe9a6a8 ($11 in chips)
Seat 5: a9eb45fc ($10.31 in chips)
Seat 6: Hero ($10 in chips)
8fc49c26: posts small blind $0.05
84c34548: posts big blind $0.1
*** HOLE CARDS ***
Dealt to 80ebdd41 
Dealt to 8fc49c26 
Dealt to 84c34548 
Dealt to cbe9a6a8 
Dealt to a9eb45fc 
Dealt to Hero [7s Js]
cbe9a6a8: folds
a9eb45fc: folds
Hero: folds
80ebdd41: raises $0.15 to $0.25
8fc49c26: folds
84c34548: calls $0.15
*** FLOP *** [6s Ah 6d]
84c34548: checks
80ebdd41: bets $0.16
84c34548: raises $0.54 to $0.7
80ebdd41: calls $0.54
*** TURN *** [6s Ah 6d] [8c]
84c34548: checks
80ebdd41: checks
*** RIVER *** [6s Ah 6d 8c] [3h]
84c34548: checks
80ebdd41: checks
84c34548: shows [Jh Qh] (Pair of Sixes)
80ebdd41: shows [Qc Qs] (Pair of Queens and Pair of Sixes)
*** SHOWDOWN ***
80ebdd41 collected $1.86 from pot
*** SUMMARY ***
Total pot $1.95 | Rake $0.09 | Jackpot $0 | Bingo $0 | Fortune $0 | Tax $0
Board [6s Ah 6d 8c 3h]
Seat 1: 80ebdd41 (button) showed [Qc Qs] and won ($1.86) with Pair of Queens and Pair of Sixes
Seat 2: 8fc49c26 (small blind) folded before Flop
Seat 3: 84c34548 (big blind) showed [Jh Qh] and lost with Pair of Sixes
Seat 4: cbe9a6a8 folded before Flop (didn't bet)
Seat 5: a9eb45fc folded before Flop (didn't bet)
Seat 6: Hero folded before Flop (didn't bet)


Poker Hand #RC3141668445: Hold'em No Limit ($0.05/$0.1) - 2024/12/12 12:38:51
Table 'RushAndCash22313705' 6-max Seat #1 is the button
Seat 1: a3382d82 ($22.1 in chips)
Seat 2: cfe70ef2 ($10 in chips)
Seat 3: 56ee5f48 ($17.66 in chips)
Seat 4: 3e330259 ($15.53 in chips)
Seat 5: bc8cb2ed ($9.92 in chips)
Seat 6: Hero ($10 in chips)
cfe70ef2: posts small blind $0.05
56ee5f48: posts big blind $0.1
*** HOLE CARDS ***
Dealt to a3382d82 
Dealt to cfe70ef2 
Dealt to 56ee5f48 
Dealt to 3e330259 
Dealt to bc8cb2ed 
Dealt to Hero [7h 8h]
3e330259: folds
bc8cb2ed: folds
Hero: raises $0.15 to $0.25
a3382d82: folds
cfe70ef2: raises $0.75 to $1
56ee5f48: folds
Hero: folds
Uncalled bet ($0.75) returned to cfe70ef2
*** SHOWDOWN ***
cfe70ef2 collected $0.57 from pot
*** SUMMARY ***
Total pot $0.6 | Rake $0.03 | Jackpot $0 | Bingo $0 | Fortune $0 | Tax $0
Seat 1: a3382d82 (button) folded before Flop (didn't bet)
Seat 2: cfe70ef2 (small blind) collected ($0.57)
Seat 3: 56ee5f48 (big blind) folded before Flop
Seat 4: 3e330259 folded before Flop (didn't bet)
Seat 5: bc8cb2ed folded before Flop (didn't bet)
Seat 6: Hero folded before Flop


Poker Hand #RC3141668429: Hold'em No Limit ($0.05/$0.1) - 2024/12/12 12:38:47
Table 'RushAndCash22313689' 6-max Seat #1 is the button
Seat 1: Hero ($10 in chips)
Seat 2: c2b852ae ($11.43 in chips)
Seat 3: c92ccc19 ($8.34 in chips)
Seat 4: 4b728c96 ($15.98 in chips)
Seat 5: 56ee5f48 ($17.66 in chips)
Seat 6: 5b982aa5 ($15.58 in chips)
c2b852ae: posts small blind $0.05
c92ccc19: posts big blind $0.1
*** HOLE CARDS ***
Dealt to Hero [7s 4d]
Dealt to c2b852ae 
Dealt to c92ccc19 
Dealt to 4b728c96 
Dealt to 56ee5f48 
Dealt to 5b982aa5 
4b728c96: raises $0.1 to $0.2
56ee5f48: folds
5b982aa5: folds
Hero: folds
c2b852ae: folds
c92ccc19: folds
Uncalled bet ($0.1) returned to 4b728c96
*** SHOWDOWN ***
4b728c96 collected $0.25 from pot
*** SUMMARY ***
Total pot $0.25 | Rake $0 | Jackpot $0 | Bingo $0 | Fortune $0 | Tax $0
Seat 1: Hero (button) folded before Flop (didn't bet)
Seat 2: c2b852ae (small blind) folded before Flop
Seat 3: c92ccc19 (big blind) folded before Flop
Seat 4: 4b728c96 collected ($0.25)
Seat 5: 56ee5f48 folded before Flop (didn't bet)
Seat 6: 5b982aa5 folded before Flop (didn't bet)


Poker Hand #RC3141668331: Hold'em No Limit ($0.05/$0.1) - 2024/12/12 12:38:21
Table 'RushAndCash22313591' 6-max Seat #1 is the button
Seat 1: a1f416c7 ($10.37 in chips)
Seat 2: 4746887d ($13.79 in chips)
Seat 3: Hero ($10 in chips)
Seat 4: 12b883d0 ($26.21 in chips)
Seat 5: bc2007a2 ($11.27 in chips)
Seat 6: 673ecd77 ($23.73 in chips)
4746887d: posts small blind $0.05
Hero: posts big blind $0.1
*** HOLE CARDS ***
Dealt to a1f416c7 
Dealt to 4746887d 
Dealt to Hero [Th Tc]
Dealt to 12b883d0 
Dealt to bc2007a2 
Dealt to 673ecd77 
12b883d0: folds
bc2007a2: raises $0.15 to $0.25
673ecd77: folds
a1f416c7: raises $0.49 to $0.74
4746887d: folds
Hero: folds
bc2007a2: raises $1.26 to $2
a1f416c7: calls $1.26
*** FLOP *** [6s 2c 7c]
bc2007a2: bets $1.58
a1f416c7: calls $1.58
*** TURN *** [6s 2c 7c] [3c]
bc2007a2: bets $7.31
a1f416c7: folds
Uncalled bet ($7.31) returned to bc2007a2
*** SHOWDOWN ***
bc2007a2 collected $6.86 from pot
*** SUMMARY ***
Total pot $7.31 | Rake $0.3 | Jackpot $0.15 | Bingo $0 | Fortune $0 | Tax $0
Board [6s 2c 7c 3c]
Seat 1: a1f416c7 (button) folded on the Turn
Seat 2: 4746887d (small blind) folded before Flop
Seat 3: Hero (big blind) folded before Flop
Seat 4: 12b883d0 folded before Flop (didn't bet)
Seat 5: bc2007a2 won ($6.86)
Seat 6: 673ecd77 folded before Flop (didn't bet)


Poker Hand #RC3141668303: Hold'em No Limit ($0.05/$0.1) - 2024/12/12 12:38:13
Table 'RushAndCash22313563' 6-max Seat #1 is the button
Seat 1: 4e5368fb ($10.49 in chips)
Seat 2: Hero ($10 in chips)
Seat 3: cc63da9c ($10.04 in chips)
Seat 4: b8e03e64 ($10.05 in chips)
Seat 5: a3382d82 ($21.83 in chips)
Seat 6: f91155b6 ($10.47 in chips)
Hero: posts small blind $0.05
cc63da9c: posts big blind $0.1
*** HOLE CARDS ***
Dealt to 4e5368fb 
Dealt to Hero [Qc 4s]
Dealt to cc63da9c 
Dealt to b8e03e64 
Dealt to a3382d82 
Dealt to f91155b6 
b8e03e64: raises $0.1 to $0.2
a3382d82: folds
f91155b6: folds
4e5368fb: calls $0.2
Hero: folds
cc63da9c: folds
*** FLOP *** [4c 6d Th]
b8e03e64: checks
4e5368fb: checks
*** TURN *** [4c 6d Th] [3h]
b8e03e64: checks
4e5368fb: bets $0.29
b8e03e64: folds
Uncalled bet ($0.29) returned to 4e5368fb
*** SHOWDOWN ***
4e5368fb collected $0.53 from pot
*** SUMMARY ***
Total pot $0.55 | Rake $0.02 | Jackpot $0 | Bingo $0 | Fortune $0 | Tax $0
Board [4c 6d Th 3h]
Seat 1: 4e5368fb (button) won ($0.53)
Seat 2: Hero (small blind) folded before Flop
Seat 3: cc63da9c (big blind) folded before Flop
Seat 4: b8e03e64 folded on the Turn
Seat 5: a3382d82 folded before Flop (didn't bet)
Seat 6: f91155b6 folded before Flop (didn't bet)


Poker Hand #RC3141668106: Hold'em No Limit ($0.05/$0.1) - 2024/12/12 12:37:21
Table 'RushAndCash22313366' 6-max Seat #1 is the button
Seat 1: d43f1d14 ($12.12 in chips)
Seat 2: 4e5368fb ($9.9 in chips)
Seat 3: 3c75bc00 ($32.79 in chips)
Seat 4: Hero ($10 in chips)
Seat 5: 4898aa10 ($18.6 in chips)
Seat 6: c2b852ae ($11.98 in chips)
4e5368fb: posts small blind $0.05
3c75bc00: posts big blind $0.1
*** HOLE CARDS ***
Dealt to d43f1d14 
Dealt to 4e5368fb 
Dealt to 3c75bc00 
Dealt to Hero [Tc Ts]
Dealt to 4898aa10 
Dealt to c2b852ae 
Hero: raises $0.1 to $0.2
4898aa10: folds
c2b852ae: folds
d43f1d14: folds
4e5368fb: raises $0.34 to $0.54
3c75bc00: folds
Hero: calls $0.34
*** FLOP *** [Ks 3c Ac]
4e5368fb: bets $0.7
Hero: folds
Uncalled bet ($0.7) returned to 4e5368fb
*** SHOWDOWN ***
4e5368fb collected $1.13 from pot
*** SUMMARY ***
Total pot $1.18 | Rake $0.05 | Jackpot $0 | Bingo $0 | Fortune $0 | Tax $0
Board [Ks 3c Ac]
Seat 1: d43f1d14 (button) folded before Flop (didn't bet)
Seat 2: 4e5368fb (small blind) won ($1.13)
Seat 3: 3c75bc00 (big blind) folded before Flop
Seat 4: Hero folded on the Flop
Seat 5: 4898aa10 folded before Flop (didn't bet)
Seat 6: c2b852ae folded before Flop (didn't bet)


Poker Hand #RC3141668008: Hold'em No Limit ($0.05/$0.1) - 2024/12/12 12:36:56
Table 'RushAndCash22313268' 6-max Seat #1 is the button
Seat 1: 6dcb955a ($11.28 in chips)
Seat 2: 727ed023 ($7.65 in chips)
Seat 3: fd36d45d ($8.47 in chips)
Seat 4: bf8dfa7d ($7.18 in chips)
Seat 5: Hero ($10 in chips)
Seat 6: 5b14e7af ($21.33 in chips)
727ed023: posts small blind $0.05
fd36d45d: posts big blind $0.1
*** HOLE CARDS ***
Dealt to 6dcb955a 
Dealt to 727ed023 
Dealt to fd36d45d 
Dealt to bf8dfa7d 
Dealt to Hero [4s As]
Dealt to 5b14e7af 
bf8dfa7d: raises $0.1 to $0.2
Hero: raises $0.1 to $0.3
5b14e7af: folds
6dcb955a: folds
727ed023: folds
fd36d45d: folds
bf8dfa7d: calls $0.1
*** FLOP *** [Tc 5d Td]
bf8dfa7d: bets $0.38
Hero: folds
Uncalled bet ($0.38) returned to bf8dfa7d
*** SHOWDOWN ***
bf8dfa7d collected $0.72 from pot
*** SUMMARY ***
Total pot $0.75 | Rake $0.03 | Jackpot $0 | Bingo $0 | Fortune $0 | Tax $0
Board [Tc 5d Td]
Seat 1: 6dcb955a (button) folded before Flop (didn't bet)
Seat 2: 727ed023 (small blind) folded before Flop
Seat 3: fd36d45d (big blind) folded before Flop
Seat 4: bf8dfa7d won ($0.72)
Seat 5: Hero folded on the Flop
Seat 6: 5b14e7af folded before Flop (didn't bet)


Poker Hand #RC3141667992: Hold'em No Limit ($0.05/$0.1) - 2024/12/12 12:36:52
Table 'RushAndCash22313252' 6-max Seat #1 is the button
Seat 1: 408d6706 ($47.18 in chips)
Seat 2: 266313ea ($10.98 in chips)
Seat 3: b82279c3 ($39.33 in chips)
Seat 4: Hero ($10 in chips)
Seat 5: 4b1c7e7e ($10.8 in chips)
Seat 6: 647dd971 ($3.31 in chips)
266313ea: posts small blind $0.05
b82279c3: posts big blind $0.1
*** HOLE CARDS ***
Dealt to 408d6706 
Dealt to 266313ea 
Dealt to b82279c3 
Dealt to Hero [6d 5d]
Dealt to 4b1c7e7e 
Dealt to 647dd971 
Hero: folds
4b1c7e7e: folds
647dd971: folds
408d6706: folds
266313ea: folds
Uncalled bet ($0.05) returned to b82279c3
*** SHOWDOWN ***
b82279c3 collected $0.1 from pot
*** SUMMARY ***
Total pot $0.1 | Rake $0 | Jackpot $0 | Bingo $0 | Fortune $0 | Tax $0
Seat 1: 408d6706 (button) folded before Flop (didn't bet)
Seat 2: 266313ea (small blind) folded before Flop
Seat 3: b82279c3 (big blind) collected ($0.1)
Seat 4: Hero folded before Flop (didn't bet)
Seat 5: 4b1c7e7e folded before Flop (didn't bet)
Seat 6: 647dd971 folded before Flop (didn't bet)


Poker Hand #RC3141667976: Hold'em No Limit ($0.05/$0.1) - 2024/12/12 12:36:48
Table 'RushAndCash22313236' 6-max Seat #1 is the button
Seat 1: Hero ($10 in chips)
Seat 2: 406f58e4 ($10.23 in chips)
Seat 3: 8424fd65 ($10 in chips)
Seat 4: 266313ea ($10.98 in chips)
Seat 5: 2a6446ed ($13.48 in chips)
Seat 6: 895d916a ($30.59 in chips)
406f58e4: posts small blind $0.05
8424fd65: posts big blind $0.1
*** HOLE CARDS ***
Dealt to Hero [Th 3d]
Dealt to 406f58e4 
Dealt to 8424fd65 
Dealt to 266313ea 
Dealt to 2a6446ed 
Dealt to 895d916a 
266313ea: folds
2a6446ed: raises $0.1 to $0.2
895d916a: folds
Hero: folds
406f58e4: folds
8424fd65: folds
Uncalled bet ($0.1) returned to 2a6446ed
*** SHOWDOWN ***
2a6446ed collected $0.25 from pot
*** SUMMARY ***
Total pot $0.25 | Rake $0 | Jackpot $0 | Bingo $0 | Fortune $0 | Tax $0
Seat 1: Hero (button) folded before Flop (didn't bet)
Seat 2: 406f58e4 (small blind) folded before Flop
Seat 3: 8424fd65 (big blind) folded before Flop
Seat 4: 266313ea folded before Flop (didn't bet)
Seat 5: 2a6446ed collected ($0.25)
Seat 6: 895d916a folded before Flop (didn't bet)


Poker Hand #RC3141667892: Hold'em No Limit ($0.05/$0.1) - 2024/12/12 12:36:29
Table 'RushAndCash22313152' 6-max Seat #1 is the button
Seat 1: fed024e0 ($10.45 in chips)
Seat 2: Hero ($10 in chips)
Seat 3: e3914f0b ($24.76 in chips)
Seat 4: b8e03e64 ($10 in chips)
Seat 5: f9dfc42a ($10.73 in chips)
Seat 6: 5ddf2544 ($10.12 in chips)
Hero: posts small blind $0.05
e3914f0b: posts big blind $0.1
*** HOLE CARDS ***
Dealt to fed024e0 
Dealt to Hero [5h 4h]
Dealt to e3914f0b 
Dealt to b8e03e64 
Dealt to f9dfc42a 
Dealt to 5ddf2544 
b8e03e64: folds
f9dfc42a: raises $0.15 to $0.25
5ddf2544: folds
fed024e0: folds
Hero: folds
e3914f0b: calls $0.15
*** FLOP *** [7h 7s Ts]
e3914f0b: checks
f9dfc42a: bets $0.28
e3914f0b: calls $0.28
*** TURN *** [7h 7s Ts] [Ac]
e3914f0b: checks
f9dfc42a: checks
*** RIVER *** [7h 7s Ts Ac] [7c]
e3914f0b: checks
f9dfc42a: checks
e3914f0b: shows [5c 5d] (Sevens Full over Fives)
f9dfc42a: shows [3h 3s] (Sevens Full over Treys)
*** SHOWDOWN ***
e3914f0b collected $1.06 from pot
*** SUMMARY ***
Total pot $1.11 | Rake $0.05 | Jackpot $0 | Bingo $0 | Fortune $0 | Tax $0
Board [7h 7s Ts Ac 7c]
Seat 1: fed024e0 (button) folded before Flop (didn't bet)
Seat 2: Hero (small blind) folded before Flop
Seat 3: e3914f0b (big blind) showed [5c 5d] and won ($1.06) with Sevens Full over Fives
Seat 4: b8e03e64 folded before Flop (didn't bet)
Seat 5: f9dfc42a showed [3h 3s] and lost with Sevens Full over Treys
Seat 6: 5ddf2544 folded before Flop (didn't bet)


Poker Hand #RC3141667773: Hold'em No Limit ($0.05/$0.1) - 2024/12/12 12:36:02
Table 'RushAndCash22313033' 6-max Seat #1 is the button
Seat 1: 916c6bd3 ($3.41 in chips)
Seat 2: 7ee23c5e ($12.6 in chips)
Seat 3: Hero ($10 in chips)
Seat 4: 65bfb346 ($12.29 in chips)
Seat 5: 493432cf ($14.39 in chips)
Seat 6: bb64ea0a ($8.26 in chips)
7ee23c5e: posts small blind $0.05
Hero: posts big blind $0.1
*** HOLE CARDS ***
Dealt to 916c6bd3 
Dealt to 7ee23c5e 
Dealt to Hero [As 8c]
Dealt to 65bfb346 
Dealt to 493432cf 
Dealt to bb64ea0a 
65bfb346: folds
493432cf: folds
bb64ea0a: raises $0.1 to $0.2
916c6bd3: folds
7ee23c5e: folds
Hero: calls $0.1
*** FLOP *** [6d Jc 9d]
Hero: checks
bb64ea0a: checks
*** TURN *** [6d Jc 9d] [Kd]
Hero: checks
bb64ea0a: bets $0.2
Hero: folds
Uncalled bet ($0.2) returned to bb64ea0a
*** SHOWDOWN ***
bb64ea0a collected $0.43 from pot
*** SUMMARY ***
Total pot $0.45 | Rake $0.02 | Jackpot $0 | Bingo $0 | Fortune $0 | Tax $0
Board [6d Jc 9d Kd]
Seat 1: 916c6bd3 (button) folded before Flop (didn't bet)
Seat 2: 7ee23c5e (small blind) folded before Flop
Seat 3: Hero (big blind) folded on the Turn
Seat 4: 65bfb346 folded before Flop (didn't bet)
Seat 5: 493432cf folded before Flop (didn't bet)
Seat 6: bb64ea0a won ($0.43)


