Poker Hand #RC3141728576: Hold'em No Limit ($0.05/$0.1) - 2024/12/12 13:20:13
Table 'RushAndCash22323836' 6-max Seat #1 is the button
Seat 1: 727f0a35 ($13.75 in chips)
Seat 2: Hero ($10.54 in chips)
Seat 3: 73154d50 ($10 in chips)
Seat 4: ae2a34aa ($10.24 in chips)
Seat 5: 2746c1f0 ($23.84 in chips)
Seat 6: c2b852ae ($6.58 in chips)
Hero: posts small blind $0.05
73154d50: posts big blind $0.1
*** HOLE CARDS ***
Dealt to 727f0a35 
Dealt to Hero [Tc Qh]
Dealt to 73154d50 
Dealt to ae2a34aa 
Dealt to 2746c1f0 
Dealt to c2b852ae 
ae2a34aa: folds
2746c1f0: folds
c2b852ae: folds
727f0a35: folds
Hero: raises $0.2 to $0.3
73154d50: calls $0.2
*** FLOP *** [9d Qs 7c]
Hero: checks
73154d50: checks
*** TURN *** [9d Qs 7c] [Kc]
Hero: checks
73154d50: checks
*** RIVER *** [9d Qs 7c Kc] [5d]
Hero: bets $0.45
73154d50: folds
Uncalled bet ($0.45) returned to Hero
*** SHOWDOWN ***
Hero collected $0.57 from pot
*** SUMMARY ***
Total pot $0.6 | Rake $0.03 | Jackpot $0 | Bingo $0 | Fortune $0 | Tax $0
Board [9d Qs 7c Kc 5d]
Seat 1: 727f0a35 (button) folded before Flop (didn't bet)
Seat 2: Hero (small blind) won ($0.57)
Seat 3: 73154d50 (big blind) folded on the River
Seat 4: ae2a34aa folded before Flop (didn't bet)
Seat 5: 2746c1f0 folded before Flop (didn't bet)
Seat 6: c2b852ae folded before Flop (didn't bet)


Poker Hand #RC3141728561: Hold'em No Limit ($0.05/$0.1) - 2024/12/12 13:20:10
Table 'RushAndCash22323821' 6-max Seat #1 is the button
Seat 1: Hero ($10.54 in chips)
Seat 2: f1e9bea0 ($37.56 in chips)
Seat 3: 226dbbb0 ($12.97 in chips)
Seat 4: ca83e1cd ($11.78 in chips)
Seat 5: f323cdf3 ($13.62 in chips)
Seat 6: c2b852ae ($6.58 in chips)
f1e9bea0: posts small blind $0.05
226dbbb0: posts big blind $0.1
*** HOLE CARDS ***
Dealt to Hero [3h 8h]
Dealt to f1e9bea0 
Dealt to 226dbbb0 
Dealt to ca83e1cd 
Dealt to f323cdf3 
Dealt to c2b852ae 
ca83e1cd: raises $0.1 to $0.2
f323cdf3: folds
c2b852ae: folds
Hero: folds
f1e9bea0: folds
226dbbb0: folds
Uncalled bet ($0.1) returned to ca83e1cd
*** SHOWDOWN ***
ca83e1cd collected $0.25 from pot
*** SUMMARY ***
Total pot $0.25 | Rake $0 | Jackpot $0 | Bingo $0 | Fortune $0 | Tax $0
Seat 1: Hero (button) folded before Flop (didn't bet)
Seat 2: f1e9bea0 (small blind) folded before Flop
Seat 3: 226dbbb0 (big blind) folded before Flop
Seat 4: ca83e1cd collected ($0.25)
Seat 5: f323cdf3 folded before Flop (didn't bet)
Seat 6: c2b852ae folded before Flop (didn't bet)


Poker Hand #RC3141728545: Hold'em No Limit ($0.05/$0.1) - 2024/12/12 13:20:06
Table 'RushAndCash22323805' 6-max Seat #1 is the button
Seat 1: 1a8ef95a ($10.41 in chips)
Seat 2: 767c6b86 ($10.59 in chips)
Seat 3: 41ad32d3 ($17.79 in chips)
Seat 4: 7dcec562 ($10.63 in chips)
Seat 5: 661d577b ($10 in chips)
Seat 6: Hero ($10.54 in chips)
767c6b86: posts small blind $0.05
41ad32d3: posts big blind $0.1
*** HOLE CARDS ***
Dealt to 1a8ef95a 
Dealt to 767c6b86 
Dealt to 41ad32d3 
Dealt to 7dcec562 
Dealt to 661d577b 
Dealt to Hero [7h 5c]
7dcec562: raises $0.1 to $0.2
661d577b: folds
Hero: folds
1a8ef95a: folds
767c6b86: folds
41ad32d3: folds
Uncalled bet ($0.1) returned to 7dcec562
*** SHOWDOWN ***
7dcec562 collected $0.25 from pot
*** SUMMARY ***
Total pot $0.25 | Rake $0 | Jackpot $0 | Bingo $0 | Fortune $0 | Tax $0
Seat 1: 1a8ef95a (button) folded before Flop (didn't bet)
Seat 2: 767c6b86 (small blind) folded before Flop
Seat 3: 41ad32d3 (big blind) folded before Flop
Seat 4: 7dcec562 collected ($0.25)
Seat 5: 661d577b folded before Flop (didn't bet)
Seat 6: Hero folded before Flop (didn't bet)


Poker Hand #RC3141728040: Hold'em No Limit ($0.05/$0.1) - 2024/12/12 13:18:19
Table 'RushAndCash22323300' 6-max Seat #1 is the button
Seat 1: 1a8ef95a ($11.15 in chips)
Seat 2: ebfcde93 ($11.97 in chips)
Seat 3: 661d577b ($10 in chips)
Seat 4: 90062cb6 ($8.58 in chips)
Seat 5: Hero ($10 in chips)
Seat 6: 902b9d1a ($15.38 in chips)
ebfcde93: posts small blind $0.05
661d577b: posts big blind $0.1
*** HOLE CARDS ***
Dealt to 1a8ef95a 
Dealt to ebfcde93 
Dealt to 661d577b 
Dealt to 90062cb6 
Dealt to Hero [Qs Kh]
Dealt to 902b9d1a 
90062cb6: folds
Hero: raises $0.1 to $0.2
902b9d1a: folds
1a8ef95a: folds
ebfcde93: folds
661d577b: calls $0.1
*** FLOP *** [4h Js 7d]
661d577b: checks
Hero: checks
*** TURN *** [4h Js 7d] [Ts]
661d577b: checks
Hero: bets $0.34
661d577b: calls $0.34
*** RIVER *** [4h Js 7d Ts] [7s]
661d577b: checks
Hero: bets $0.85
661d577b: folds
Uncalled bet ($0.85) returned to Hero
*** SHOWDOWN ***
Hero collected $1.08 from pot
*** SUMMARY ***
Total pot $1.13 | Rake $0.05 | Jackpot $0 | Bingo $0 | Fortune $0 | Tax $0
Board [4h Js 7d Ts 7s]
Seat 1: 1a8ef95a (button) folded before Flop (didn't bet)
Seat 2: ebfcde93 (small blind) folded before Flop
Seat 3: 661d577b (big blind) folded on the River
Seat 4: 90062cb6 folded before Flop (didn't bet)
Seat 5: Hero won ($1.08)
Seat 6: 902b9d1a folded before Flop (didn't bet)


Poker Hand #RC3141728024: Hold'em No Limit ($0.05/$0.1) - 2024/12/12 13:18:15
Table 'RushAndCash22323284' 6-max Seat #1 is the button
Seat 1: 7ec40c0d ($19.85 in chips)
Seat 2: d827b781 ($10.37 in chips)
Seat 3: Hero ($10 in chips)
Seat 4: 51c5666 ($28.14 in chips)
Seat 5: bb2b7f75 ($10.46 in chips)
Seat 6: 7ee23c5e ($11.84 in chips)
d827b781: posts small blind $0.05
Hero: posts big blind $0.1
*** HOLE CARDS ***
Dealt to 7ec40c0d 
Dealt to d827b781 
Dealt to Hero [3s 2s]
Dealt to 51c5666 
Dealt to bb2b7f75 
Dealt to 7ee23c5e 
51c5666: folds
bb2b7f75: folds
7ee23c5e: folds
7ec40c0d: folds
d827b781: raises $0.15 to $0.25
Hero: folds
Uncalled bet ($0.15) returned to d827b781
*** SHOWDOWN ***
d827b781 collected $0.2 from pot
*** SUMMARY ***
Total pot $0.2 | Rake $0 | Jackpot $0 | Bingo $0 | Fortune $0 | Tax $0
Seat 1: 7ec40c0d (button) folded before Flop (didn't bet)
Seat 2: d827b781 (small blind) collected ($0.2)
Seat 3: Hero (big blind) folded before Flop
Seat 4: 51c5666 folded before Flop (didn't bet)
Seat 5: bb2b7f75 folded before Flop (didn't bet)
Seat 6: 7ee23c5e folded before Flop (didn't bet)


Poker Hand #RC3141728009: Hold'em No Limit ($0.05/$0.1) - 2024/12/12 13:18:12
Table 'RushAndCash22323269' 6-max Seat #1 is the button
Seat 1: 86ee8e36 ($34.35 in chips)
Seat 2: a699d2de ($17.07 in chips)
Seat 3: 36e85ed3 ($12.25 in chips)
Seat 4: 74788949 ($10.15 in chips)
Seat 5: 4b71434f ($12.76 in chips)
Seat 6: Hero ($10 in chips)
a699d2de: posts small blind $0.05
36e85ed3: posts big blind $0.1
*** HOLE CARDS ***
Dealt to 86ee8e36 
Dealt to a699d2de 
Dealt to 36e85ed3 
Dealt to 74788949 
Dealt to 4b71434f 
Dealt to Hero [8s 5c]
74788949: raises $0.15 to $0.25
4b71434f: folds
Hero: folds
86ee8e36: folds
a699d2de: folds
36e85ed3: folds
Uncalled bet ($0.15) returned to 74788949
*** SHOWDOWN ***
74788949 collected $0.25 from pot
*** SUMMARY ***
Total pot $0.25 | Rake $0 | Jackpot $0 | Bingo $0 | Fortune $0 | Tax $0
Seat 1: 86ee8e36 (button) folded before Flop (didn't bet)
Seat 2: a699d2de (small blind) folded before Flop
Seat 3: 36e85ed3 (big blind) folded before Flop
Seat 4: 74788949 collected ($0.25)
Seat 5: 4b71434f folded before Flop (didn't bet)
Seat 6: Hero folded before Flop (didn't bet)


Poker Hand #RC3141727996: Hold'em No Limit ($0.05/$0.1) - 2024/12/12 13:18:09
Table 'RushAndCash22323256' 6-max Seat #1 is the button
Seat 1: 61709362 ($12.33 in chips)
Seat 2: a6717311 ($10 in chips)
Seat 3: e34de8ec ($5.5 in chips)
Seat 4: 8a55880e ($18.18 in chips)
Seat 5: a699d2de ($17.07 in chips)
Seat 6: Hero ($10 in chips)
a6717311: posts small blind $0.05
e34de8ec: posts big blind $0.1
*** HOLE CARDS ***
Dealt to 61709362 
Dealt to a6717311 
Dealt to e34de8ec 
Dealt to 8a55880e 
Dealt to a699d2de 
Dealt to Hero [4s 9d]
8a55880e: folds
a699d2de: folds
Hero: folds
61709362: raises $0.1 to $0.2
a6717311: raises $0.8 to $1
e34de8ec: folds
61709362: folds
Uncalled bet ($0.8) returned to a6717311
*** SHOWDOWN ***
a6717311 collected $0.48 from pot
*** SUMMARY ***
Total pot $0.5 | Rake $0.02 | Jackpot $0 | Bingo $0 | Fortune $0 | Tax $0
Seat 1: 61709362 (button) folded before Flop
Seat 2: a6717311 (small blind) collected ($0.48)
Seat 3: e34de8ec (big blind) folded before Flop
Seat 4: 8a55880e folded before Flop (didn't bet)
Seat 5: a699d2de folded before Flop (didn't bet)
Seat 6: Hero folded before Flop (didn't bet)


Poker Hand #RC3141727982: Hold'em No Limit ($0.05/$0.1) - 2024/12/12 13:18:05
Table 'RushAndCash22323242' 6-max Seat #1 is the button
Seat 1: Hero ($10 in chips)
Seat 2: 61709362 ($12.38 in chips)
Seat 3: afe10f69 ($10.57 in chips)
Seat 4: a699d2de ($17.07 in chips)
Seat 5: 73df44d1 ($10 in chips)
Seat 6: 8a55880e ($18.18 in chips)
61709362: posts small blind $0.05
afe10f69: posts big blind $0.1
*** HOLE CARDS ***
Dealt to Hero [6d 8s]
Dealt to 61709362 
Dealt to afe10f69 
Dealt to a699d2de 
Dealt to 73df44d1 
Dealt to 8a55880e 
a699d2de: folds
73df44d1: folds
8a55880e: folds
Hero: folds
61709362: folds
Uncalled bet ($0.05) returned to afe10f69
*** SHOWDOWN ***
afe10f69 collected $0.1 from pot
*** SUMMARY ***
Total pot $0.1 | Rake $0 | Jackpot $0 | Bingo $0 | Fortune $0 | Tax $0
Seat 1: Hero (button) folded before Flop (didn't bet)
Seat 2: 61709362 (small blind) folded before Flop
Seat 3: afe10f69 (big blind) collected ($0.1)
Seat 4: a699d2de folded before Flop (didn't bet)
Seat 5: 73df44d1 folded before Flop (didn't bet)
Seat 6: 8a55880e folded before Flop (didn't bet)


Poker Hand #RC3141727969: Hold'em No Limit ($0.05/$0.1) - 2024/12/12 13:18:02
Table 'RushAndCash22323229' 6-max Seat #1 is the button
Seat 1: 61709362 ($12.38 in chips)
Seat 2: aecd8c87 ($21.04 in chips)
Seat 3: 6d840025 ($10.03 in chips)
Seat 4: 41ad32d3 ($18.52 in chips)
Seat 5: 8e70d9ee ($5.33 in chips)
Seat 6: Hero ($10 in chips)
aecd8c87: posts small blind $0.05
6d840025: posts big blind $0.1
*** HOLE CARDS ***
Dealt to 61709362 
Dealt to aecd8c87 
Dealt to 6d840025 
Dealt to 41ad32d3 
Dealt to 8e70d9ee 
Dealt to Hero [4c 2d]
41ad32d3: folds
8e70d9ee: raises $0.2 to $0.3
Hero: folds
61709362: folds
aecd8c87: folds
6d840025: folds
Uncalled bet ($0.2) returned to 8e70d9ee
*** SHOWDOWN ***
8e70d9ee collected $0.25 from pot
*** SUMMARY ***
Total pot $0.25 | Rake $0 | Jackpot $0 | Bingo $0 | Fortune $0 | Tax $0
Seat 1: 61709362 (button) folded before Flop (didn't bet)
Seat 2: aecd8c87 (small blind) folded before Flop
Seat 3: 6d840025 (big blind) folded before Flop
Seat 4: 41ad32d3 folded before Flop (didn't bet)
Seat 5: 8e70d9ee collected ($0.25)
Seat 6: Hero folded before Flop (didn't bet)


Poker Hand #RC3141727953: Hold'em No Limit ($0.05/$0.1) - 2024/12/12 13:17:58
Table 'RushAndCash22323213' 6-max Seat #1 is the button
Seat 1: 3ff4efa1 ($18.88 in chips)
Seat 2: 1c087ec5 ($43.05 in chips)
Seat 3: Hero ($10 in chips)
Seat 4: 9a915048 ($10 in chips)
Seat 5: d8ef6e0b ($13.34 in chips)
Seat 6: b15bbba6 ($11.26 in chips)
1c087ec5: posts small blind $0.05
Hero: posts big blind $0.1
*** HOLE CARDS ***
Dealt to 3ff4efa1 
Dealt to 1c087ec5 
Dealt to Hero [Qs 2h]
Dealt to 9a915048 
Dealt to d8ef6e0b 
Dealt to b15bbba6 
9a915048: folds
d8ef6e0b: folds
b15bbba6: folds
3ff4efa1: raises $0.15 to $0.25
1c087ec5: folds
Hero: folds
Uncalled bet ($0.15) returned to 3ff4efa1
*** SHOWDOWN ***
3ff4efa1 collected $0.25 from pot
*** SUMMARY ***
Total pot $0.25 | Rake $0 | Jackpot $0 | Bingo $0 | Fortune $0 | Tax $0
Seat 1: 3ff4efa1 (button) collected ($0.25)
Seat 2: 1c087ec5 (small blind) folded before Flop
Seat 3: Hero (big blind) folded before Flop
Seat 4: 9a915048 folded before Flop (didn't bet)
Seat 5: d8ef6e0b folded before Flop (didn't bet)
Seat 6: b15bbba6 folded before Flop (didn't bet)


Poker Hand #RC3141727905: Hold'em No Limit ($0.05/$0.1) - 2024/12/12 13:17:48
Table 'RushAndCash22323165' 6-max Seat #1 is the button
Seat 1: 175b201a ($3.14 in chips)
Seat 2: Hero ($10 in chips)
Seat 3: 54d53a50 ($28.44 in chips)
Seat 4: 78854bfa ($7.18 in chips)
Seat 5: 593f64c7 ($7.78 in chips)
Seat 6: 9a76e865 ($10 in chips)
Hero: posts small blind $0.05
54d53a50: posts big blind $0.1
*** HOLE CARDS ***
Dealt to 175b201a 
Dealt to Hero [Tc Ah]
Dealt to 54d53a50 
Dealt to 78854bfa 
Dealt to 593f64c7 
Dealt to 9a76e865 
78854bfa: folds
593f64c7: folds
9a76e865: raises $0.1 to $0.2
175b201a: folds
Hero: folds
54d53a50: calls $0.1
*** FLOP *** [6h 5h 8h]
54d53a50: bets $0.15
9a76e865: folds
Uncalled bet ($0.15) returned to 54d53a50
*** SHOWDOWN ***
54d53a50 collected $0.43 from pot
*** SUMMARY ***
Total pot $0.45 | Rake $0.02 | Jackpot $0 | Bingo $0 | Fortune $0 | Tax $0
Board [6h 5h 8h]
Seat 1: 175b201a (button) folded before Flop (didn't bet)
Seat 2: Hero (small blind) folded before Flop
Seat 3: 54d53a50 (big blind) won ($0.43)
Seat 4: 78854bfa folded before Flop (didn't bet)
Seat 5: 593f64c7 folded before Flop (didn't bet)
Seat 6: 9a76e865 folded on the Flop


Poker Hand #RC3141727709: Hold'em No Limit ($0.05/$0.1) - 2024/12/12 13:17:07
Table 'RushAndCash22322969' 6-max Seat #1 is the button
Seat 1: b863ea8c ($30.7 in chips)
Seat 2: 77be01b1 ($11.55 in chips)
Seat 3: a6fdbe1b ($12.95 in chips)
Seat 4: Hero ($10.1 in chips)
Seat 5: eb12374a ($11.18 in chips)
Seat 6: c8c2a1e ($11.86 in chips)
77be01b1: posts small blind $0.05
a6fdbe1b: posts big blind $0.1
*** HOLE CARDS ***
Dealt to b863ea8c 
Dealt to 77be01b1 
Dealt to a6fdbe1b 
Dealt to Hero [Ks Kd]
Dealt to eb12374a 
Dealt to c8c2a1e 
Hero: raises $0.1 to $0.2
eb12374a: folds
c8c2a1e: folds
b863ea8c: raises $0.43 to $0.63
77be01b1: folds
a6fdbe1b: folds
Hero: raises $1.37 to $2
b863ea8c: raises $28.7 to $30.7 and is all-in
Hero: calls $8.1 and is all-in
Uncalled bet ($20.6) returned to b863ea8c
b863ea8c: shows [Kh Kc]
Hero: shows [Ks Kd]
*** FLOP *** [Ts 3s 9d]
*** TURN *** [Ts 3s 9d] [2c]
*** RIVER *** [Ts 3s 9d 2c] [3h]
*** SHOWDOWN ***
Hero collected $9.95 from pot
b863ea8c collected $9.95 from pot
*** SUMMARY ***
Total pot $20.35 | Rake $0.3 | Jackpot $0.15 | Bingo $0 | Fortune $0 | Tax $0
Board [Ts 3s 9d 2c 3h]
Seat 1: b863ea8c (button) showed [Kh Kc] and won ($9.95) with Pair of Kings and Pair of Treys
Seat 2: 77be01b1 (small blind) folded before Flop
Seat 3: a6fdbe1b (big blind) folded before Flop
Seat 4: Hero showed [Ks Kd] and won ($9.95) with Pair of Kings and Pair of Treys
Seat 5: eb12374a folded before Flop (didn't bet)
Seat 6: c8c2a1e folded before Flop (didn't bet)


Poker Hand #RC3141727668: Hold'em No Limit ($0.05/$0.1) - 2024/12/12 13:16:59
Table 'RushAndCash22322928' 6-max Seat #1 is the button
Seat 1: Hero ($10.1 in chips)
Seat 2: 406f58e4 ($10.05 in chips)
Seat 3: afe10f69 ($10.42 in chips)
Seat 4: 78854bfa ($6.66 in chips)
Seat 5: ed71d8f3 ($6.82 in chips)
Seat 6: 3b12e634 ($12.88 in chips)
406f58e4: posts small blind $0.05
afe10f69: posts big blind $0.1
*** HOLE CARDS ***
Dealt to Hero [Qc Js]
Dealt to 406f58e4 
Dealt to afe10f69 
Dealt to 78854bfa 
Dealt to ed71d8f3 
Dealt to 3b12e634 
78854bfa: raises $0.12 to $0.22
ed71d8f3: folds
3b12e634: folds
Hero: folds
406f58e4: folds
afe10f69: folds
Uncalled bet ($0.12) returned to 78854bfa
*** SHOWDOWN ***
78854bfa collected $0.25 from pot
*** SUMMARY ***
Total pot $0.25 | Rake $0 | Jackpot $0 | Bingo $0 | Fortune $0 | Tax $0
Seat 1: Hero (button) folded before Flop (didn't bet)
Seat 2: 406f58e4 (small blind) folded before Flop
Seat 3: afe10f69 (big blind) folded before Flop
Seat 4: 78854bfa collected ($0.25)
Seat 5: ed71d8f3 folded before Flop (didn't bet)
Seat 6: 3b12e634 folded before Flop (didn't bet)


Poker Hand #RC3141727610: Hold'em No Limit ($0.05/$0.1) - 2024/12/12 13:16:47
Table 'RushAndCash22322870' 6-max Seat #1 is the button
Seat 1: f46ae9b2 ($5.38 in chips)
Seat 2: Hero ($10 in chips)
Seat 3: 9dd76deb ($10.33 in chips)
Seat 4: e12528c0 ($29.7 in chips)
Seat 5: b82279c3 ($28.97 in chips)
Seat 6: c1314f29 ($10.03 in chips)
Hero: posts small blind $0.05
9dd76deb: posts big blind $0.1
*** HOLE CARDS ***
Dealt to f46ae9b2 
Dealt to Hero [Js 7s]
Dealt to 9dd76deb 
Dealt to e12528c0 
Dealt to b82279c3 
Dealt to c1314f29 
e12528c0: folds
b82279c3: folds
c1314f29: folds
f46ae9b2: folds
Hero: raises $0.2 to $0.3
9dd76deb: folds
Uncalled bet ($0.2) returned to Hero
*** SHOWDOWN ***
Hero collected $0.2 from pot
*** SUMMARY ***
Total pot $0.2 | Rake $0 | Jackpot $0 | Bingo $0 | Fortune $0 | Tax $0
Seat 1: f46ae9b2 (button) folded before Flop (didn't bet)
Seat 2: Hero (small blind) collected ($0.2)
Seat 3: 9dd76deb (big blind) folded before Flop
Seat 4: e12528c0 folded before Flop (didn't bet)
Seat 5: b82279c3 folded before Flop (didn't bet)
Seat 6: c1314f29 folded before Flop (didn't bet)


Poker Hand #RC3141727569: Hold'em No Limit ($0.05/$0.1) - 2024/12/12 13:16:38
Table 'RushAndCash22322829' 6-max Seat #1 is the button
Seat 1: a3d9ddb9 ($15.59 in chips)
Seat 2: 37fb9df ($10 in chips)
Seat 3: f44841fc ($12.46 in chips)
Seat 4: 3f7822ab ($20.06 in chips)
Seat 5: 661d577b ($10.15 in chips)
Seat 6: Hero ($10 in chips)
37fb9df: posts small blind $0.05
f44841fc: posts big blind $0.1
*** HOLE CARDS ***
Dealt to a3d9ddb9 
Dealt to 37fb9df 
Dealt to f44841fc 
Dealt to 3f7822ab 
Dealt to 661d577b 
Dealt to Hero [7d As]
3f7822ab: folds
661d577b: raises $0.1 to $0.2
Hero: folds
a3d9ddb9: folds
37fb9df: folds
f44841fc: folds
Uncalled bet ($0.1) returned to 661d577b
*** SHOWDOWN ***
661d577b collected $0.25 from pot
*** SUMMARY ***
Total pot $0.25 | Rake $0 | Jackpot $0 | Bingo $0 | Fortune $0 | Tax $0
Seat 1: a3d9ddb9 (button) folded before Flop (didn't bet)
Seat 2: 37fb9df (small blind) folded before Flop
Seat 3: f44841fc (big blind) folded before Flop
Seat 4: 3f7822ab folded before Flop (didn't bet)
Seat 5: 661d577b collected ($0.25)
Seat 6: Hero folded before Flop (didn't bet)


Poker Hand #RC3141727427: Hold'em No Limit ($0.05/$0.1) - 2024/12/12 13:16:06
Table 'RushAndCash22322687' 6-max Seat #1 is the button
Seat 1: cf2fd778 ($10 in chips)
Seat 2: a19f63e0 ($10.39 in chips)
Seat 3: Hero ($10 in chips)
Seat 4: fed024e0 ($11.4 in chips)
Seat 5: cb8dca6d ($11.48 in chips)
Seat 6: b738541f ($8.76 in chips)
a19f63e0: posts small blind $0.05
Hero: posts big blind $0.1
*** HOLE CARDS ***
Dealt to cf2fd778 
Dealt to a19f63e0 
Dealt to Hero [8d 7d]
Dealt to fed024e0 
Dealt to cb8dca6d 
Dealt to b738541f 
fed024e0: raises $0.1 to $0.2
cb8dca6d: folds
b738541f: folds
cf2fd778: folds
a19f63e0: folds
Hero: calls $0.1
*** FLOP *** [Tc 5c 2c]
Hero: checks
fed024e0: bets $0.1
Hero: folds
Uncalled bet ($0.1) returned to fed024e0
*** SHOWDOWN ***
fed024e0 collected $0.43 from pot
*** SUMMARY ***
Total pot $0.45 | Rake $0.02 | Jackpot $0 | Bingo $0 | Fortune $0 | Tax $0
Board [Tc 5c 2c]
Seat 1: cf2fd778 (button) folded before Flop (didn't bet)
Seat 2: a19f63e0 (small blind) folded before Flop
Seat 3: Hero (big blind) folded on the Flop
Seat 4: fed024e0 won ($0.43)
Seat 5: cb8dca6d folded before Flop (didn't bet)
Seat 6: b738541f folded before Flop (didn't bet)


Poker Hand #RC3141727406: Hold'em No Limit ($0.05/$0.1) - 2024/12/12 13:16:01
Table 'RushAndCash22322666' 6-max Seat #1 is the button
Seat 1: 56e396a1 ($10 in chips)
Seat 2: 334d3992 ($10 in chips)
Seat 3: 101c026b ($34.58 in chips)
Seat 4: b17f5bfe ($6.62 in chips)
Seat 5: Hero ($10 in chips)
Seat 6: 8a55880e ($17.97 in chips)
334d3992: posts small blind $0.05
101c026b: posts big blind $0.1
*** HOLE CARDS ***
Dealt to 56e396a1 
Dealt to 334d3992 
Dealt to 101c026b 
Dealt to b17f5bfe 
Dealt to Hero [6c 7c]
Dealt to 8a55880e 
b17f5bfe: folds
Hero: folds
8a55880e: folds
56e396a1: folds
334d3992: raises $0.15 to $0.25
101c026b: calls $0.15
*** FLOP *** [3s Jh 9d]
334d3992: bets $0.2
101c026b: calls $0.2
*** TURN *** [3s Jh 9d] [9h]
334d3992: checks
101c026b: checks
*** RIVER *** [3s Jh 9d 9h] [Kc]
334d3992: bets $0.7
101c026b: raises $2.3 to $3
334d3992: folds
Uncalled bet ($2.3) returned to 101c026b
*** SHOWDOWN ***
101c026b collected $2.19 from pot
*** SUMMARY ***
Total pot $2.3 | Rake $0.11 | Jackpot $0 | Bingo $0 | Fortune $0 | Tax $0
Board [3s Jh 9d 9h Kc]
Seat 1: 56e396a1 (button) folded before Flop (didn't bet)
Seat 2: 334d3992 (small blind) folded on the River
Seat 3: 101c026b (big blind) won ($2.19)
Seat 4: b17f5bfe folded before Flop (didn't bet)
Seat 5: Hero folded before Flop (didn't bet)
Seat 6: 8a55880e folded before Flop (didn't bet)


Poker Hand #RC3141727385: Hold'em No Limit ($0.05/$0.1) - 2024/12/12 13:15:56
Table 'RushAndCash22322645' 6-max Seat #1 is the button
Seat 1: 9cfbee05 ($10.28 in chips)
Seat 2: Hero ($10 in chips)
Seat 3: c1314f29 ($9.85 in chips)
Seat 4: 26abca60 ($10.05 in chips)
Seat 5: 26077f2f ($10.23 in chips)
Seat 6: 295cc1bc ($12.24 in chips)
Hero: posts small blind $0.05
c1314f29: posts big blind $0.1
*** HOLE CARDS ***
Dealt to 9cfbee05 
Dealt to Hero [3d Ts]
Dealt to c1314f29 
Dealt to 26abca60 
Dealt to 26077f2f 
Dealt to 295cc1bc 
26abca60: folds
26077f2f: folds
295cc1bc: folds
9cfbee05: raises $0.1 to $0.2
Hero: folds
c1314f29: raises $0.4 to $0.6
9cfbee05: folds
Uncalled bet ($0.4) returned to c1314f29
*** SHOWDOWN ***
c1314f29 collected $0.43 from pot
*** SUMMARY ***
Total pot $0.45 | Rake $0.02 | Jackpot $0 | Bingo $0 | Fortune $0 | Tax $0
Seat 1: 9cfbee05 (button) folded before Flop
Seat 2: Hero (small blind) folded before Flop
Seat 3: c1314f29 (big blind) collected ($0.43)
Seat 4: 26abca60 folded before Flop (didn't bet)
Seat 5: 26077f2f folded before Flop (didn't bet)
Seat 6: 295cc1bc folded before Flop (didn't bet)


Poker Hand #RC3141727366: Hold'em No Limit ($0.05/$0.1) - 2024/12/12 13:15:52
Table 'RushAndCash22322626' 6-max Seat #1 is the button
Seat 1: c113e767 ($5.2 in chips)
Seat 2: df82aa12 ($11.32 in chips)
Seat 3: 37fb9df ($10 in chips)
Seat 4: 1036e403 ($11.88 in chips)
Seat 5: Hero ($10 in chips)
Seat 6: 88133657 ($10.37 in chips)
df82aa12: posts small blind $0.05
37fb9df: posts big blind $0.1
*** HOLE CARDS ***
Dealt to c113e767 
Dealt to df82aa12 
Dealt to 37fb9df 
Dealt to 1036e403 
Dealt to Hero [8d 9h]
Dealt to 88133657 
1036e403: raises $0.1 to $0.2
Hero: folds
88133657: folds
c113e767: folds
df82aa12: folds
37fb9df: folds
Uncalled bet ($0.1) returned to 1036e403
*** SHOWDOWN ***
1036e403 collected $0.25 from pot
*** SUMMARY ***
Total pot $0.25 | Rake $0 | Jackpot $0 | Bingo $0 | Fortune $0 | Tax $0
Seat 1: c113e767 (button) folded before Flop (didn't bet)
Seat 2: df82aa12 (small blind) folded before Flop
Seat 3: 37fb9df (big blind) folded before Flop
Seat 4: 1036e403 collected ($0.25)
Seat 5: Hero folded before Flop (didn't bet)
Seat 6: 88133657 folded before Flop (didn't bet)


Poker Hand #RC3141727287: Hold'em No Limit ($0.05/$0.1) - 2024/12/12 13:15:37
Table 'RushAndCash22322547' 6-max Seat #1 is the button
Seat 1: bb2b7f75 ($10 in chips)
Seat 2: 73d90cc7 ($10 in chips)
Seat 3: Hero ($10 in chips)
Seat 4: e12528c0 ($29.43 in chips)
Seat 5: b828e7ee ($11.8 in chips)
Seat 6: ca83e1cd ($10.1 in chips)
73d90cc7: posts small blind $0.05
Hero: posts big blind $0.1
*** HOLE CARDS ***
Dealt to bb2b7f75 
Dealt to 73d90cc7 
Dealt to Hero [Th 9c]
Dealt to e12528c0 
Dealt to b828e7ee 
Dealt to ca83e1cd 
e12528c0: folds
b828e7ee: folds
ca83e1cd: folds
bb2b7f75: raises $0.15 to $0.25
73d90cc7: folds
Hero: folds
Uncalled bet ($0.15) returned to bb2b7f75
*** SHOWDOWN ***
bb2b7f75 collected $0.25 from pot
*** SUMMARY ***
Total pot $0.25 | Rake $0 | Jackpot $0 | Bingo $0 | Fortune $0 | Tax $0
Seat 1: bb2b7f75 (button) collected ($0.25)
Seat 2: 73d90cc7 (small blind) folded before Flop
Seat 3: Hero (big blind) folded before Flop
Seat 4: e12528c0 folded before Flop (didn't bet)
Seat 5: b828e7ee folded before Flop (didn't bet)
Seat 6: ca83e1cd folded before Flop (didn't bet)


Poker Hand #RC3141727271: Hold'em No Limit ($0.05/$0.1) - 2024/12/12 13:15:34
Table 'RushAndCash22322531' 6-max Seat #1 is the button
Seat 1: ce410800 ($23.96 in chips)
Seat 2: b614d7f1 ($10.04 in chips)
Seat 3: 22222ecf ($10 in chips)
Seat 4: b828e7ee ($11.8 in chips)
Seat 5: afe10f69 ($10.27 in chips)
Seat 6: Hero ($10 in chips)
b614d7f1: posts small blind $0.05
22222ecf: posts big blind $0.1
*** HOLE CARDS ***
Dealt to ce410800 
Dealt to b614d7f1 
Dealt to 22222ecf 
Dealt to b828e7ee 
Dealt to afe10f69 
Dealt to Hero [Jh 3c]
b828e7ee: folds
afe10f69: folds
Hero: folds
ce410800: folds
b614d7f1: folds
Uncalled bet ($0.05) returned to 22222ecf
*** SHOWDOWN ***
22222ecf collected $0.1 from pot
*** SUMMARY ***
Total pot $0.1 | Rake $0 | Jackpot $0 | Bingo $0 | Fortune $0 | Tax $0
Seat 1: ce410800 (button) folded before Flop (didn't bet)
Seat 2: b614d7f1 (small blind) folded before Flop
Seat 3: 22222ecf (big blind) collected ($0.1)
Seat 4: b828e7ee folded before Flop (didn't bet)
Seat 5: afe10f69 folded before Flop (didn't bet)
Seat 6: Hero folded before Flop (didn't bet)


Poker Hand #RC3141727232: Hold'em No Limit ($0.05/$0.1) - 2024/12/12 13:15:25
Table 'RushAndCash22322492' 6-max Seat #1 is the button
Seat 1: Hero ($10 in chips)
Seat 2: 701f843f ($10.74 in chips)
Seat 3: 1d2dacdf ($10.49 in chips)
Seat 4: 74788949 ($10.01 in chips)
Seat 5: 607eb8c2 ($12.71 in chips)
Seat 6: ebfcde93 ($11.15 in chips)
701f843f: posts small blind $0.05
1d2dacdf: posts big blind $0.1
*** HOLE CARDS ***
Dealt to Hero [Qs 9s]
Dealt to 701f843f 
Dealt to 1d2dacdf 
Dealt to 74788949 
Dealt to 607eb8c2 
Dealt to ebfcde93 
74788949: folds
607eb8c2: folds
ebfcde93: raises $0.12 to $0.22
Hero: folds
701f843f: folds
1d2dacdf: folds
Uncalled bet ($0.12) returned to ebfcde93
*** SHOWDOWN ***
ebfcde93 collected $0.25 from pot
*** SUMMARY ***
Total pot $0.25 | Rake $0 | Jackpot $0 | Bingo $0 | Fortune $0 | Tax $0
Seat 1: Hero (button) folded before Flop (didn't bet)
Seat 2: 701f843f (small blind) folded before Flop
Seat 3: 1d2dacdf (big blind) folded before Flop
Seat 4: 74788949 folded before Flop (didn't bet)
Seat 5: 607eb8c2 folded before Flop (didn't bet)
Seat 6: ebfcde93 collected ($0.25)


Poker Hand #RC3141727218: Hold'em No Limit ($0.05/$0.1) - 2024/12/12 13:15:22
Table 'RushAndCash22322478' 6-max Seat #1 is the button
Seat 1: 111c75 ($10.33 in chips)
Seat 2: 1eed6c31 ($8.87 in chips)
Seat 3: Hero ($10 in chips)
Seat 4: 701f843f ($10.74 in chips)
Seat 5: 4ff8a7e0 ($4.46 in chips)
Seat 6: e60f3780 ($16.34 in chips)
1eed6c31: posts small blind $0.05
Hero: posts big blind $0.1
*** HOLE CARDS ***
Dealt to 111c75 
Dealt to 1eed6c31 
Dealt to Hero [2h 9c]
Dealt to 701f843f 
Dealt to 4ff8a7e0 
Dealt to e60f3780 
701f843f: folds
4ff8a7e0: calls $0.1
e60f3780: folds
111c75: folds
1eed6c31: folds
Hero: checks
*** FLOP *** [7s 4s 5h]
Hero: checks
4ff8a7e0: checks
*** TURN *** [7s 4s 5h] [Ks]
Hero: checks
4ff8a7e0: bets $0.13
Hero: folds
Uncalled bet ($0.13) returned to 4ff8a7e0
*** SHOWDOWN ***
4ff8a7e0 collected $0.24 from pot
*** SUMMARY ***
Total pot $0.25 | Rake $0.01 | Jackpot $0 | Bingo $0 | Fortune $0 | Tax $0
Board [7s 4s 5h Ks]
Seat 1: 111c75 (button) folded before Flop (didn't bet)
Seat 2: 1eed6c31 (small blind) folded before Flop
Seat 3: Hero (big blind) folded on the Turn
Seat 4: 701f843f folded before Flop (didn't bet)
Seat 5: 4ff8a7e0 won ($0.24)
Seat 6: e60f3780 folded before Flop (didn't bet)


Poker Hand #RC3141727202: Hold'em No Limit ($0.05/$0.1) - 2024/12/12 13:15:19
Table 'RushAndCash22322462' 6-max Seat #1 is the button
Seat 1: 88a9583f ($47.14 in chips)
Seat 2: b0559006 ($3.97 in chips)
Seat 3: cc07b659 ($10.78 in chips)
Seat 4: 1eed6c31 ($8.87 in chips)
Seat 5: 3b12e634 ($11.89 in chips)
Seat 6: Hero ($10 in chips)
b0559006: posts small blind $0.05
cc07b659: posts big blind $0.1
*** HOLE CARDS ***
Dealt to 88a9583f 
Dealt to b0559006 
Dealt to cc07b659 
Dealt to 1eed6c31 
Dealt to 3b12e634 
Dealt to Hero [Td 2d]
1eed6c31: folds
3b12e634: folds
Hero: folds
88a9583f: folds
b0559006: folds
Uncalled bet ($0.05) returned to cc07b659
*** SHOWDOWN ***
cc07b659 collected $0.1 from pot
*** SUMMARY ***
Total pot $0.1 | Rake $0 | Jackpot $0 | Bingo $0 | Fortune $0 | Tax $0
Seat 1: 88a9583f (button) folded before Flop (didn't bet)
Seat 2: b0559006 (small blind) folded before Flop
Seat 3: cc07b659 (big blind) collected ($0.1)
Seat 4: 1eed6c31 folded before Flop (didn't bet)
Seat 5: 3b12e634 folded before Flop (didn't bet)
Seat 6: Hero folded before Flop (didn't bet)


Poker Hand #RC3141727189: Hold'em No Limit ($0.05/$0.1) - 2024/12/12 13:15:16
Table 'RushAndCash22322449' 6-max Seat #1 is the button
Seat 1: b0559006 ($3.97 in chips)
Seat 2: 6b0057b1 ($10.05 in chips)
Seat 3: 175b201a ($2.05 in chips)
Seat 4: Hero ($10 in chips)
Seat 5: b738541f ($8.76 in chips)
Seat 6: d6b17ac7 ($12.29 in chips)
6b0057b1: posts small blind $0.05
175b201a: posts big blind $0.1
*** HOLE CARDS ***
Dealt to b0559006 
Dealt to 6b0057b1 
Dealt to 175b201a 
Dealt to Hero [7s Ts]
Dealt to b738541f 
Dealt to d6b17ac7 
Hero: folds
b738541f: folds
d6b17ac7: folds
b0559006: folds
6b0057b1: raises $0.2 to $0.3
175b201a: folds
Uncalled bet ($0.2) returned to 6b0057b1
*** SHOWDOWN ***
6b0057b1 collected $0.2 from pot
*** SUMMARY ***
Total pot $0.2 | Rake $0 | Jackpot $0 | Bingo $0 | Fortune $0 | Tax $0
Seat 1: b0559006 (button) folded before Flop (didn't bet)
Seat 2: 6b0057b1 (small blind) collected ($0.2)
Seat 3: 175b201a (big blind) folded before Flop
Seat 4: Hero folded before Flop (didn't bet)
Seat 5: b738541f folded before Flop (didn't bet)
Seat 6: d6b17ac7 folded before Flop (didn't bet)


Poker Hand #RC3141727100: Hold'em No Limit ($0.05/$0.1) - 2024/12/12 13:14:56
Table 'RushAndCash22322360' 6-max Seat #1 is the button
Seat 1: b51a8683 ($10 in chips)
Seat 2: Hero ($10 in chips)
Seat 3: 974940e1 ($18.31 in chips)
Seat 4: 6b0057b1 ($10 in chips)
Seat 5: 22e8274e ($25.37 in chips)
Seat 6: 4dd7bc95 ($13.1 in chips)
Hero: posts small blind $0.05
974940e1: posts big blind $0.1
*** HOLE CARDS ***
Dealt to b51a8683 
Dealt to Hero [Ac 2s]
Dealt to 974940e1 
Dealt to 6b0057b1 
Dealt to 22e8274e 
Dealt to 4dd7bc95 
6b0057b1: folds
22e8274e: folds
4dd7bc95: folds
b51a8683: raises $0.15 to $0.25
Hero: folds
974940e1: folds
Uncalled bet ($0.15) returned to b51a8683
*** SHOWDOWN ***
b51a8683 collected $0.25 from pot
*** SUMMARY ***
Total pot $0.25 | Rake $0 | Jackpot $0 | Bingo $0 | Fortune $0 | Tax $0
Seat 1: b51a8683 (button) collected ($0.25)
Seat 2: Hero (small blind) folded before Flop
Seat 3: 974940e1 (big blind) folded before Flop
Seat 4: 6b0057b1 folded before Flop (didn't bet)
Seat 5: 22e8274e folded before Flop (didn't bet)
Seat 6: 4dd7bc95 folded before Flop (didn't bet)


Poker Hand #RC3141726909: Hold'em No Limit ($0.05/$0.1) - 2024/12/12 13:14:10
Table 'RushAndCash22322169' 6-max Seat #1 is the button
Seat 1: Hero ($10.05 in chips)
Seat 2: b15bbba6 ($10.05 in chips)
Seat 3: 916c6bd3 ($9.75 in chips)
Seat 4: d25ababb ($9.88 in chips)
Seat 5: 5f7772c4 ($8.28 in chips)
Seat 6: 83a198b3 ($10.96 in chips)
b15bbba6: posts small blind $0.05
916c6bd3: posts big blind $0.1
*** HOLE CARDS ***
Dealt to Hero [5s 5h]
Dealt to b15bbba6 
Dealt to 916c6bd3 
Dealt to d25ababb 
Dealt to 5f7772c4 
Dealt to 83a198b3 
d25ababb: folds
5f7772c4: folds
83a198b3: folds
Hero: raises $0.15 to $0.25
b15bbba6: folds
916c6bd3: calls $0.15
*** FLOP *** [9c 8s Js]
916c6bd3: checks
Hero: checks
*** TURN *** [9c 8s Js] [6h]
916c6bd3: checks
Hero: checks
*** RIVER *** [9c 8s Js 6h] [7h]
916c6bd3: checks
Hero: bets $0.2
916c6bd3: raises $0.72 to $0.92
Hero: folds
Uncalled bet ($0.72) returned to 916c6bd3
*** SHOWDOWN ***
916c6bd3 collected $0.91 from pot
*** SUMMARY ***
Total pot $0.95 | Rake $0.04 | Jackpot $0 | Bingo $0 | Fortune $0 | Tax $0
Board [9c 8s Js 6h 7h]
Seat 1: Hero (button) folded on the River
Seat 2: b15bbba6 (small blind) folded before Flop
Seat 3: 916c6bd3 (big blind) won ($0.91)
Seat 4: d25ababb folded before Flop (didn't bet)
Seat 5: 5f7772c4 folded before Flop (didn't bet)
Seat 6: 83a198b3 folded before Flop (didn't bet)


Poker Hand #RC3141726896: Hold'em No Limit ($0.05/$0.1) - 2024/12/12 13:14:07
Table 'RushAndCash22322156' 6-max Seat #1 is the button
Seat 1: d19ee248 ($7.56 in chips)
Seat 2: d1122f42 ($11 in chips)
Seat 3: 73154d50 ($10 in chips)
Seat 4: 4d3004b8 ($13.33 in chips)
Seat 5: Hero ($10.05 in chips)
Seat 6: b17f5bfe ($6.52 in chips)
d1122f42: posts small blind $0.05
73154d50: posts big blind $0.1
*** HOLE CARDS ***
Dealt to d19ee248 
Dealt to d1122f42 
Dealt to 73154d50 
Dealt to 4d3004b8 
Dealt to Hero [8d Qs]
Dealt to b17f5bfe 
4d3004b8: folds
Hero: folds
b17f5bfe: folds
d19ee248: raises $0.2 to $0.3
d1122f42: folds
73154d50: calls $0.2
*** FLOP *** [Jh Jd Ah]
73154d50: checks
d19ee248: bets $0.25
73154d50: calls $0.25
*** TURN *** [Jh Jd Ah] [7d]
73154d50: checks
d19ee248: bets $0.5
73154d50: folds
Uncalled bet ($0.5) returned to d19ee248
*** SHOWDOWN ***
d19ee248 collected $1.1 from pot
*** SUMMARY ***
Total pot $1.15 | Rake $0.05 | Jackpot $0 | Bingo $0 | Fortune $0 | Tax $0
Board [Jh Jd Ah 7d]
Seat 1: d19ee248 (button) won ($1.1)
Seat 2: d1122f42 (small blind) folded before Flop
Seat 3: 73154d50 (big blind) folded on the Turn
Seat 4: 4d3004b8 folded before Flop (didn't bet)
Seat 5: Hero folded before Flop (didn't bet)
Seat 6: b17f5bfe folded before Flop (didn't bet)


Poker Hand #RC3141726871: Hold'em No Limit ($0.05/$0.1) - 2024/12/12 13:14:00
Table 'RushAndCash22322131' 6-max Seat #1 is the button
Seat 1: 88133657 ($10 in chips)
Seat 2: f383ae87 ($25.6 in chips)
Seat 3: af208717 ($10.38 in chips)
Seat 4: b51a8683 ($10 in chips)
Seat 5: 72f58f29 ($10 in chips)
Seat 6: Hero ($10.05 in chips)
f383ae87: posts small blind $0.05
af208717: posts big blind $0.1
*** HOLE CARDS ***
Dealt to 88133657 
Dealt to f383ae87 
Dealt to af208717 
Dealt to b51a8683 
Dealt to 72f58f29 
Dealt to Hero [2h Ah]
b51a8683: raises $0.15 to $0.25
72f58f29: folds
Hero: folds
88133657: folds
f383ae87: raises $0.65 to $0.9
af208717: folds
b51a8683: folds
Uncalled bet ($0.65) returned to f383ae87
*** SHOWDOWN ***
f383ae87 collected $0.57 from pot
*** SUMMARY ***
Total pot $0.6 | Rake $0.03 | Jackpot $0 | Bingo $0 | Fortune $0 | Tax $0
Seat 1: 88133657 (button) folded before Flop (didn't bet)
Seat 2: f383ae87 (small blind) collected ($0.57)
Seat 3: af208717 (big blind) folded before Flop
Seat 4: b51a8683 folded before Flop
Seat 5: 72f58f29 folded before Flop (didn't bet)
Seat 6: Hero folded before Flop (didn't bet)


Poker Hand #RC3141726709: Hold'em No Limit ($0.05/$0.1) - 2024/12/12 13:13:20
Table 'RushAndCash22321969' 6-max Seat #1 is the button
Seat 1: dea77808 ($14.14 in chips)
Seat 2: Hero ($10.35 in chips)
Seat 3: 51acfaf6 ($19.8 in chips)
Seat 4: 2441c176 ($11.21 in chips)
Seat 5: d8699a3 ($11 in chips)
Seat 6: fd36d45d ($12.16 in chips)
Hero: posts small blind $0.05
51acfaf6: posts big blind $0.1
*** HOLE CARDS ***
Dealt to dea77808 
Dealt to Hero [2s As]
Dealt to 51acfaf6 
Dealt to 2441c176 
Dealt to d8699a3 
Dealt to fd36d45d 
2441c176: folds
d8699a3: folds
fd36d45d: folds
dea77808: folds
Hero: raises $0.2 to $0.3
51acfaf6: calls $0.2
*** FLOP *** [8c Td 2h]
Hero: checks
51acfaf6: bets $0.4
Hero: folds
Uncalled bet ($0.4) returned to 51acfaf6
*** SHOWDOWN ***
51acfaf6 collected $0.57 from pot
*** SUMMARY ***
Total pot $0.6 | Rake $0.03 | Jackpot $0 | Bingo $0 | Fortune $0 | Tax $0
Board [8c Td 2h]
Seat 1: dea77808 (button) folded before Flop (didn't bet)
Seat 2: Hero (small blind) folded on the Flop
Seat 3: 51acfaf6 (big blind) won ($0.57)
Seat 4: 2441c176 folded before Flop (didn't bet)
Seat 5: d8699a3 folded before Flop (didn't bet)
Seat 6: fd36d45d folded before Flop (didn't bet)


Poker Hand #RC3141726693: Hold'em No Limit ($0.05/$0.1) - 2024/12/12 13:13:17
Table 'RushAndCash22321953' 6-max Seat #1 is the button
Seat 1: 3e729116 ($13.04 in chips)
Seat 2: 4cf26e8f ($12.89 in chips)
Seat 3: 78428b92 ($78.24 in chips)
Seat 4: Hero ($10.35 in chips)
Seat 5: 643f85e7 ($9.38 in chips)
Seat 6: e2a23377 ($10 in chips)
4cf26e8f: posts small blind $0.05
78428b92: posts big blind $0.1
*** HOLE CARDS ***
Dealt to 3e729116 
Dealt to 4cf26e8f 
Dealt to 78428b92 
Dealt to Hero [4s 5h]
Dealt to 643f85e7 
Dealt to e2a23377 
Hero: folds
643f85e7: folds
e2a23377: folds
3e729116: raises $0.1 to $0.2
4cf26e8f: folds
78428b92: folds
Uncalled bet ($0.1) returned to 3e729116
*** SHOWDOWN ***
3e729116 collected $0.25 from pot
*** SUMMARY ***
Total pot $0.25 | Rake $0 | Jackpot $0 | Bingo $0 | Fortune $0 | Tax $0
Seat 1: 3e729116 (button) collected ($0.25)
Seat 2: 4cf26e8f (small blind) folded before Flop
Seat 3: 78428b92 (big blind) folded before Flop
Seat 4: Hero folded before Flop (didn't bet)
Seat 5: 643f85e7 folded before Flop (didn't bet)
Seat 6: e2a23377 folded before Flop (didn't bet)


Poker Hand #RC3141726676: Hold'em No Limit ($0.05/$0.1) - 2024/12/12 13:13:13
Table 'RushAndCash22321936' 6-max Seat #1 is the button
Seat 1: 8a31e4cb ($10.4 in chips)
Seat 2: d8ef6e0b ($10.05 in chips)
Seat 3: 2441c176 ($11.16 in chips)
Seat 4: fe1a2d61 ($10 in chips)
Seat 5: Hero ($10.35 in chips)
Seat 6: 8d92b14e ($10 in chips)
d8ef6e0b: posts small blind $0.05
2441c176: posts big blind $0.1
*** HOLE CARDS ***
Dealt to 8a31e4cb 
Dealt to d8ef6e0b 
Dealt to 2441c176 
Dealt to fe1a2d61 
Dealt to Hero [Js 2s]
Dealt to 8d92b14e 
fe1a2d61: folds
Hero: folds
8d92b14e: folds
8a31e4cb: folds
d8ef6e0b: folds
Uncalled bet ($0.05) returned to 2441c176
*** SHOWDOWN ***
2441c176 collected $0.1 from pot
*** SUMMARY ***
Total pot $0.1 | Rake $0 | Jackpot $0 | Bingo $0 | Fortune $0 | Tax $0
Seat 1: 8a31e4cb (button) folded before Flop (didn't bet)
Seat 2: d8ef6e0b (small blind) folded before Flop
Seat 3: 2441c176 (big blind) collected ($0.1)
Seat 4: fe1a2d61 folded before Flop (didn't bet)
Seat 5: Hero folded before Flop (didn't bet)
Seat 6: 8d92b14e folded before Flop (didn't bet)


Poker Hand #RC3141726657: Hold'em No Limit ($0.05/$0.1) - 2024/12/12 13:13:09
Table 'RushAndCash22321917' 6-max Seat #1 is the button
Seat 1: 6b0057b1 ($10 in chips)
Seat 2: 67137cdb ($10.26 in chips)
Seat 3: Hero ($10.45 in chips)
Seat 4: 5b32d7fc ($13.13 in chips)
Seat 5: 5b982aa5 ($9.54 in chips)
Seat 6: 1c087ec5 ($43.7 in chips)
67137cdb: posts small blind $0.05
Hero: posts big blind $0.1
*** HOLE CARDS ***
Dealt to 6b0057b1 
Dealt to 67137cdb 
Dealt to Hero [2h Jc]
Dealt to 5b32d7fc 
Dealt to 5b982aa5 
Dealt to 1c087ec5 
5b32d7fc: folds
5b982aa5: folds
1c087ec5: folds
6b0057b1: folds
67137cdb: raises $0.2 to $0.3
Hero: folds
Uncalled bet ($0.2) returned to 67137cdb
*** SHOWDOWN ***
67137cdb collected $0.2 from pot
*** SUMMARY ***
Total pot $0.2 | Rake $0 | Jackpot $0 | Bingo $0 | Fortune $0 | Tax $0
Seat 1: 6b0057b1 (button) folded before Flop (didn't bet)
Seat 2: 67137cdb (small blind) collected ($0.2)
Seat 3: Hero (big blind) folded before Flop
Seat 4: 5b32d7fc folded before Flop (didn't bet)
Seat 5: 5b982aa5 folded before Flop (didn't bet)
Seat 6: 1c087ec5 folded before Flop (didn't bet)


Poker Hand #RC3141726640: Hold'em No Limit ($0.05/$0.1) - 2024/12/12 13:13:06
Table 'RushAndCash22321900' 6-max Seat #1 is the button
Seat 1: Hero ($10.45 in chips)
Seat 2: 566d8ba0 ($35.87 in chips)
Seat 3: 88133657 ($10.3 in chips)
Seat 4: e3914f0b ($32.12 in chips)
Seat 5: 1036e403 ($12.3 in chips)
Seat 6: d19ee248 ($7.81 in chips)
566d8ba0: posts small blind $0.05
88133657: posts big blind $0.1
*** HOLE CARDS ***
Dealt to Hero [8h 2d]
Dealt to 566d8ba0 
Dealt to 88133657 
Dealt to e3914f0b 
Dealt to 1036e403 
Dealt to d19ee248 
e3914f0b: raises $0.1 to $0.2
1036e403: folds
d19ee248: folds
Hero: folds
566d8ba0: folds
88133657: folds
Uncalled bet ($0.1) returned to e3914f0b
*** SHOWDOWN ***
e3914f0b collected $0.25 from pot
*** SUMMARY ***
Total pot $0.25 | Rake $0 | Jackpot $0 | Bingo $0 | Fortune $0 | Tax $0
Seat 1: Hero (button) folded before Flop (didn't bet)
Seat 2: 566d8ba0 (small blind) folded before Flop
Seat 3: 88133657 (big blind) folded before Flop
Seat 4: e3914f0b collected ($0.25)
Seat 5: 1036e403 folded before Flop (didn't bet)
Seat 6: d19ee248 folded before Flop (didn't bet)


Poker Hand #RC3141726616: Hold'em No Limit ($0.05/$0.1) - 2024/12/12 13:13:00
Table 'RushAndCash22321876' 6-max Seat #1 is the button
Seat 1: 718b4a9 ($11.75 in chips)
Seat 2: ff1406c1 ($13.97 in chips)
Seat 3: 67137cdb ($10.21 in chips)
Seat 4: 7f65d70 ($11.52 in chips)
Seat 5: Hero ($10.45 in chips)
Seat 6: 4e5c7119 ($13.71 in chips)
ff1406c1: posts small blind $0.05
67137cdb: posts big blind $0.1
*** HOLE CARDS ***
Dealt to 718b4a9 
Dealt to ff1406c1 
Dealt to 67137cdb 
Dealt to 7f65d70 
Dealt to Hero [Ah 2h]
Dealt to 4e5c7119 
7f65d70: folds
Hero: folds
4e5c7119: folds
718b4a9: folds
ff1406c1: folds
Uncalled bet ($0.05) returned to 67137cdb
*** SHOWDOWN ***
67137cdb collected $0.1 from pot
*** SUMMARY ***
Total pot $0.1 | Rake $0 | Jackpot $0 | Bingo $0 | Fortune $0 | Tax $0
Seat 1: 718b4a9 (button) folded before Flop (didn't bet)
Seat 2: ff1406c1 (small blind) folded before Flop
Seat 3: 67137cdb (big blind) collected ($0.1)
Seat 4: 7f65d70 folded before Flop (didn't bet)
Seat 5: Hero folded before Flop (didn't bet)
Seat 6: 4e5c7119 folded before Flop (didn't bet)


Poker Hand #RC3141726603: Hold'em No Limit ($0.05/$0.1) - 2024/12/12 13:12:57
Table 'RushAndCash22321863' 6-max Seat #1 is the button
Seat 1: b51a8683 ($10 in chips)
Seat 2: a6717311 ($10.05 in chips)
Seat 3: 16994a2d ($14.03 in chips)
Seat 4: ff1406c1 ($13.97 in chips)
Seat 5: bc46bb6c ($12.2 in chips)
Seat 6: Hero ($10.45 in chips)
a6717311: posts small blind $0.05
16994a2d: posts big blind $0.1
*** HOLE CARDS ***
Dealt to b51a8683 
Dealt to a6717311 
Dealt to 16994a2d 
Dealt to ff1406c1 
Dealt to bc46bb6c 
Dealt to Hero [As 2c]
ff1406c1: folds
bc46bb6c: folds
Hero: folds
b51a8683: folds
a6717311: folds
Uncalled bet ($0.05) returned to 16994a2d
*** SHOWDOWN ***
16994a2d collected $0.1 from pot
*** SUMMARY ***
Total pot $0.1 | Rake $0 | Jackpot $0 | Bingo $0 | Fortune $0 | Tax $0
Seat 1: b51a8683 (button) folded before Flop (didn't bet)
Seat 2: a6717311 (small blind) folded before Flop
Seat 3: 16994a2d (big blind) collected ($0.1)
Seat 4: ff1406c1 folded before Flop (didn't bet)
Seat 5: bc46bb6c folded before Flop (didn't bet)
Seat 6: Hero folded before Flop (didn't bet)


Poker Hand #RC3141726591: Hold'em No Limit ($0.05/$0.1) - 2024/12/12 13:12:53
Table 'RushAndCash22321851' 6-max Seat #1 is the button
Seat 1: d037fd58 ($12.82 in chips)
Seat 2: 54d53a50 ($29.18 in chips)
Seat 3: ff1406c1 ($14.07 in chips)
Seat 4: 468bfba8 ($10.94 in chips)
Seat 5: aecd8c87 ($20.03 in chips)
Seat 6: Hero ($10.45 in chips)
54d53a50: posts small blind $0.05
ff1406c1: posts big blind $0.1
*** HOLE CARDS ***
Dealt to d037fd58 
Dealt to 54d53a50 
Dealt to ff1406c1 
Dealt to 468bfba8 
Dealt to aecd8c87 
Dealt to Hero [Kd 2s]
468bfba8: raises $0.1 to $0.2
aecd8c87: folds
Hero: folds
d037fd58: folds
54d53a50: folds
ff1406c1: folds
Uncalled bet ($0.1) returned to 468bfba8
*** SHOWDOWN ***
468bfba8 collected $0.25 from pot
*** SUMMARY ***
Total pot $0.25 | Rake $0 | Jackpot $0 | Bingo $0 | Fortune $0 | Tax $0
Seat 1: d037fd58 (button) folded before Flop (didn't bet)
Seat 2: 54d53a50 (small blind) folded before Flop
Seat 3: ff1406c1 (big blind) folded before Flop
Seat 4: 468bfba8 collected ($0.25)
Seat 5: aecd8c87 folded before Flop (didn't bet)
Seat 6: Hero folded before Flop (didn't bet)


Poker Hand #RC3141726486: Hold'em No Limit ($0.05/$0.1) - 2024/12/12 13:12:25
Table 'RushAndCash22321746' 6-max Seat #1 is the button
Seat 1: 4d3004b8 ($13.63 in chips)
Seat 2: aaca7529 ($5.56 in chips)
Seat 3: 1d2be4c9 ($9.98 in chips)
Seat 4: 340255c5 ($11.31 in chips)
Seat 5: Hero ($10.65 in chips)
Seat 6: d1764387 ($23.14 in chips)
aaca7529: posts small blind $0.05
1d2be4c9: posts big blind $0.1
*** HOLE CARDS ***
Dealt to 4d3004b8 
Dealt to aaca7529 
Dealt to 1d2be4c9 
Dealt to 340255c5 
Dealt to Hero [As Qh]
Dealt to d1764387 
340255c5: folds
Hero: raises $0.1 to $0.2
d1764387: folds
4d3004b8: calls $0.2
aaca7529: calls $0.15
1d2be4c9: raises $0.27 to $0.47
Hero: folds
4d3004b8: calls $0.27
aaca7529: calls $0.27
*** FLOP *** [2c 4s 4h]
aaca7529: checks
1d2be4c9: bets $1.21
4d3004b8: folds
aaca7529: folds
Uncalled bet ($1.21) returned to 1d2be4c9
*** SHOWDOWN ***
1d2be4c9 collected $1.53 from pot
*** SUMMARY ***
Total pot $1.61 | Rake $0.08 | Jackpot $0 | Bingo $0 | Fortune $0 | Tax $0
Board [2c 4s 4h]
Seat 1: 4d3004b8 (button) folded on the Flop
Seat 2: aaca7529 (small blind) folded on the Flop
Seat 3: 1d2be4c9 (big blind) won ($1.53)
Seat 4: 340255c5 folded before Flop (didn't bet)
Seat 5: Hero folded before Flop
Seat 6: d1764387 folded before Flop (didn't bet)


Poker Hand #RC3141726472: Hold'em No Limit ($0.05/$0.1) - 2024/12/12 13:12:22
Table 'RushAndCash22321732' 6-max Seat #1 is the button
Seat 1: Hero ($10.65 in chips)
Seat 2: b73105eb ($10.2 in chips)
Seat 3: 506e90c1 ($10 in chips)
Seat 4: d515d6ec ($11.78 in chips)
Seat 5: 430d588 ($8.55 in chips)
Seat 6: a6717311 ($10 in chips)
b73105eb: posts small blind $0.05
506e90c1: posts big blind $0.1
*** HOLE CARDS ***
Dealt to Hero [3d 7d]
Dealt to b73105eb 
Dealt to 506e90c1 
Dealt to d515d6ec 
Dealt to 430d588 
Dealt to a6717311 
d515d6ec: folds
430d588: folds
a6717311: raises $0.12 to $0.22
Hero: folds
b73105eb: folds
506e90c1: folds
Uncalled bet ($0.12) returned to a6717311
*** SHOWDOWN ***
a6717311 collected $0.25 from pot
*** SUMMARY ***
Total pot $0.25 | Rake $0 | Jackpot $0 | Bingo $0 | Fortune $0 | Tax $0
Seat 1: Hero (button) folded before Flop (didn't bet)
Seat 2: b73105eb (small blind) folded before Flop
Seat 3: 506e90c1 (big blind) folded before Flop
Seat 4: d515d6ec folded before Flop (didn't bet)
Seat 5: 430d588 folded before Flop (didn't bet)
Seat 6: a6717311 collected ($0.25)


Poker Hand #RC3141726458: Hold'em No Limit ($0.05/$0.1) - 2024/12/12 13:12:18
Table 'RushAndCash22321718' 6-max Seat #1 is the button
Seat 1: 78854bfa ($7.95 in chips)
Seat 2: 7d40d863 ($10.79 in chips)
Seat 3: Hero ($10.75 in chips)
Seat 4: 17798854 ($9.85 in chips)
Seat 5: d515d6ec ($11.78 in chips)
Seat 6: 1d2be4c9 ($9.98 in chips)
7d40d863: posts small blind $0.05
Hero: posts big blind $0.1
*** HOLE CARDS ***
Dealt to 78854bfa 
Dealt to 7d40d863 
Dealt to Hero [2s 8d]
Dealt to 17798854 
Dealt to d515d6ec 
Dealt to 1d2be4c9 
17798854: folds
d515d6ec: folds
1d2be4c9: folds
78854bfa: raises $0.12 to $0.22
7d40d863: calls $0.17
Hero: folds
*** FLOP *** [8h 5d 4h]
7d40d863: checks
78854bfa: checks
*** TURN *** [8h 5d 4h] [9d]
7d40d863: bets $0.18
78854bfa: calls $0.18
*** RIVER *** [8h 5d 4h 9d] [5s]
7d40d863: bets $0.45
78854bfa: folds
Uncalled bet ($0.45) returned to 7d40d863
*** SHOWDOWN ***
7d40d863 collected $0.86 from pot
*** SUMMARY ***
Total pot $0.9 | Rake $0.04 | Jackpot $0 | Bingo $0 | Fortune $0 | Tax $0
Board [8h 5d 4h 9d 5s]
Seat 1: 78854bfa (button) folded on the River
Seat 2: 7d40d863 (small blind) won ($0.86)
Seat 3: Hero (big blind) folded before Flop
Seat 4: 17798854 folded before Flop (didn't bet)
Seat 5: d515d6ec folded before Flop (didn't bet)
Seat 6: 1d2be4c9 folded before Flop (didn't bet)


Poker Hand #RC3141726445: Hold'em No Limit ($0.05/$0.1) - 2024/12/12 13:12:15
Table 'RushAndCash22321705' 6-max Seat #1 is the button
Seat 1: f32585e5 ($10.72 in chips)
Seat 2: 2ffa3e66 ($10.13 in chips)
Seat 3: 974f52 ($32.78 in chips)
Seat 4: 893fb5b9 ($10.46 in chips)
Seat 5: d27812f5 ($10.29 in chips)
Seat 6: Hero ($10.75 in chips)
2ffa3e66: posts small blind $0.05
974f52: posts big blind $0.1
*** HOLE CARDS ***
Dealt to f32585e5 
Dealt to 2ffa3e66 
Dealt to 974f52 
Dealt to 893fb5b9 
Dealt to d27812f5 
Dealt to Hero [5c 9d]
893fb5b9: raises $0.1 to $0.2
d27812f5: folds
Hero: folds
f32585e5: folds
2ffa3e66: folds
974f52: folds
Uncalled bet ($0.1) returned to 893fb5b9
*** SHOWDOWN ***
893fb5b9 collected $0.25 from pot
*** SUMMARY ***
Total pot $0.25 | Rake $0 | Jackpot $0 | Bingo $0 | Fortune $0 | Tax $0
Seat 1: f32585e5 (button) folded before Flop (didn't bet)
Seat 2: 2ffa3e66 (small blind) folded before Flop
Seat 3: 974f52 (big blind) folded before Flop
Seat 4: 893fb5b9 collected ($0.25)
Seat 5: d27812f5 folded before Flop (didn't bet)
Seat 6: Hero folded before Flop (didn't bet)


Poker Hand #RC3141726395: Hold'em No Limit ($0.05/$0.1) - 2024/12/12 13:12:00
Table 'RushAndCash22321655' 6-max Seat #1 is the button
Seat 1: 72f58f29 ($10.61 in chips)
Seat 2: Hero ($10.8 in chips)
Seat 3: 3606b70a ($11.18 in chips)
Seat 4: 4de3c51 ($10.86 in chips)
Seat 5: e0a099ae ($11.99 in chips)
Seat 6: 593f64c7 ($5.69 in chips)
Hero: posts small blind $0.05
3606b70a: posts big blind $0.1
*** HOLE CARDS ***
Dealt to 72f58f29 
Dealt to Hero [6s Js]
Dealt to 3606b70a 
Dealt to 4de3c51 
Dealt to e0a099ae 
Dealt to 593f64c7 
4de3c51: raises $0.1 to $0.2
e0a099ae: raises $0.5 to $0.7
593f64c7: folds
72f58f29: folds
Hero: folds
3606b70a: folds
4de3c51: calls $0.5
*** FLOP *** [7s 4h 9h]
4de3c51: checks
e0a099ae: checks
*** TURN *** [7s 4h 9h] [3c]
4de3c51: checks
e0a099ae: checks
*** RIVER *** [7s 4h 9h 3c] [Td]
4de3c51: checks
e0a099ae: checks
4de3c51: shows [2s 2c] (Pair of Twos)
e0a099ae: shows [Ad Ks] (Ace-High)
*** SHOWDOWN ***
4de3c51 collected $1.48 from pot
*** SUMMARY ***
Total pot $1.55 | Rake $0.07 | Jackpot $0 | Bingo $0 | Fortune $0 | Tax $0
Board [7s 4h 9h 3c Td]
Seat 1: 72f58f29 (button) folded before Flop (didn't bet)
Seat 2: Hero (small blind) folded before Flop
Seat 3: 3606b70a (big blind) folded before Flop
Seat 4: 4de3c51 showed [2s 2c] and won ($1.48) with Pair of Twos
Seat 5: e0a099ae showed [Ad Ks] and lost with Ace-High
Seat 6: 593f64c7 folded before Flop (didn't bet)


Poker Hand #RC3141726233: Hold'em No Limit ($0.05/$0.1) - 2024/12/12 13:11:16
Table 'RushAndCash22321493' 6-max Seat #1 is the button
Seat 1: a9eb45fc ($10.52 in chips)
Seat 2: ceedbd4f ($10.8 in chips)
Seat 3: 66a73913 ($16.93 in chips)
Seat 4: Hero ($11 in chips)
Seat 5: 88133657 ($10.22 in chips)
Seat 6: 3ff4efa1 ($20.07 in chips)
ceedbd4f: posts small blind $0.05
66a73913: posts big blind $0.1
*** HOLE CARDS ***
Dealt to a9eb45fc 
Dealt to ceedbd4f 
Dealt to 66a73913 
Dealt to Hero [As Kd]
Dealt to 88133657 
Dealt to 3ff4efa1 
Hero: raises $0.1 to $0.2
88133657: folds
3ff4efa1: folds
a9eb45fc: calls $0.2
ceedbd4f: calls $0.15
66a73913: folds
*** FLOP *** [8s Jc Ac]
ceedbd4f: checks
Hero: checks
a9eb45fc: bets $0.35
ceedbd4f: raises $0.7 to $1.05
Hero: folds
a9eb45fc: calls $0.7
*** TURN *** [8s Jc Ac] [6h]
ceedbd4f: bets $4.2
a9eb45fc: calls $4.2
*** RIVER *** [8s Jc Ac 6h] [Ts]
ceedbd4f: checks
a9eb45fc: checks
ceedbd4f: shows [8c 9c] (Pair of Eights)
a9eb45fc: shows [Kc 7c] (Ace-High)
*** SHOWDOWN ***
ceedbd4f collected $10.75 from pot
*** SUMMARY ***
Total pot $11.2 | Rake $0.3 | Jackpot $0.15 | Bingo $0 | Fortune $0 | Tax $0
Board [8s Jc Ac 6h Ts]
Seat 1: a9eb45fc (button) showed [Kc 7c] and lost with Ace-High
Seat 2: ceedbd4f (small blind) showed [8c 9c] and won ($10.75) with Pair of Eights
Seat 3: 66a73913 (big blind) folded before Flop
Seat 4: Hero folded on the Flop
Seat 5: 88133657 folded before Flop (didn't bet)
Seat 6: 3ff4efa1 folded before Flop (didn't bet)


Poker Hand #RC3141726154: Hold'em No Limit ($0.05/$0.1) - 2024/12/12 13:10:55
Table 'RushAndCash22321414' 6-max Seat #1 is the button
Seat 1: c6352e1c ($11.88 in chips)
Seat 2: 42c70f64 ($8.7 in chips)
Seat 3: a2fc0fa3 ($13.51 in chips)
Seat 4: cc07b659 ($10.15 in chips)
Seat 5: 974f52 ($32.83 in chips)
Seat 6: Hero ($10.85 in chips)
42c70f64: posts small blind $0.05
a2fc0fa3: posts big blind $0.1
*** HOLE CARDS ***
Dealt to c6352e1c 
Dealt to 42c70f64 
Dealt to a2fc0fa3 
Dealt to cc07b659 
Dealt to 974f52 
Dealt to Hero [Qs Js]
cc07b659: folds
974f52: folds
Hero: raises $0.15 to $0.25
c6352e1c: folds
42c70f64: folds
a2fc0fa3: folds
Uncalled bet ($0.15) returned to Hero
*** SHOWDOWN ***
Hero collected $0.25 from pot
*** SUMMARY ***
Total pot $0.25 | Rake $0 | Jackpot $0 | Bingo $0 | Fortune $0 | Tax $0
Seat 1: c6352e1c (button) folded before Flop (didn't bet)
Seat 2: 42c70f64 (small blind) folded before Flop
Seat 3: a2fc0fa3 (big blind) folded before Flop
Seat 4: cc07b659 folded before Flop (didn't bet)
Seat 5: 974f52 folded before Flop (didn't bet)
Seat 6: Hero collected ($0.25)


Poker Hand #RC3141726126: Hold'em No Limit ($0.05/$0.1) - 2024/12/12 13:10:46
Table 'RushAndCash22321386' 6-max Seat #1 is the button
Seat 1: Hero ($10.85 in chips)
Seat 2: b73105eb ($10.1 in chips)
Seat 3: 3fb0fb21 ($10.2 in chips)
Seat 4: 22ee6f58 ($10 in chips)
Seat 5: 41ef6e45 ($7.29 in chips)
Seat 6: 7bad2adb ($10.4 in chips)
b73105eb: posts small blind $0.05
3fb0fb21: posts big blind $0.1
*** HOLE CARDS ***
Dealt to Hero [3h 3d]
Dealt to b73105eb 
Dealt to 3fb0fb21 
Dealt to 22ee6f58 
Dealt to 41ef6e45 
Dealt to 7bad2adb 
22ee6f58: folds
41ef6e45: raises $0.1 to $0.2
7bad2adb: folds
Hero: folds
b73105eb: folds
3fb0fb21: calls $0.1
*** FLOP *** [Ac 9c Jd]
3fb0fb21: checks
41ef6e45: checks
*** TURN *** [Ac 9c Jd] [7d]
3fb0fb21: bets $0.23
41ef6e45: folds
Uncalled bet ($0.23) returned to 3fb0fb21
*** SHOWDOWN ***
3fb0fb21 collected $0.43 from pot
*** SUMMARY ***
Total pot $0.45 | Rake $0.02 | Jackpot $0 | Bingo $0 | Fortune $0 | Tax $0
Board [Ac 9c Jd 7d]
Seat 1: Hero (button) folded before Flop (didn't bet)
Seat 2: b73105eb (small blind) folded before Flop
Seat 3: 3fb0fb21 (big blind) won ($0.43)
Seat 4: 22ee6f58 folded before Flop (didn't bet)
Seat 5: 41ef6e45 folded on the Turn
Seat 6: 7bad2adb folded before Flop (didn't bet)


Poker Hand #RC3141726112: Hold'em No Limit ($0.05/$0.1) - 2024/12/12 13:10:42
Table 'RushAndCash22321372' 6-max Seat #1 is the button
Seat 1: b614d7f1 ($10 in chips)
Seat 2: 1dc50d10 ($10.55 in chips)
Seat 3: b828e7ee ($10 in chips)
Seat 4: d07ab82c ($11.87 in chips)
Seat 5: 727f0a35 ($10.42 in chips)
Seat 6: Hero ($10.85 in chips)
1dc50d10: posts small blind $0.05
b828e7ee: posts big blind $0.1
*** HOLE CARDS ***
Dealt to b614d7f1 
Dealt to 1dc50d10 
Dealt to b828e7ee 
Dealt to d07ab82c 
Dealt to 727f0a35 
Dealt to Hero [Qd 3c]
d07ab82c: raises $0.1 to $0.2
727f0a35: folds
Hero: folds
b614d7f1: folds
1dc50d10: folds
b828e7ee: calls $0.1
*** FLOP *** [Kc Ah 9d]
b828e7ee: checks
d07ab82c: bets $0.34
b828e7ee: calls $0.34
*** TURN *** [Kc Ah 9d] [As]
b828e7ee: checks
d07ab82c: checks
*** RIVER *** [Kc Ah 9d As] [7c]
b828e7ee: bets $0.84
d07ab82c: folds
Uncalled bet ($0.84) returned to b828e7ee
*** SHOWDOWN ***
b828e7ee collected $1.08 from pot
*** SUMMARY ***
Total pot $1.13 | Rake $0.05 | Jackpot $0 | Bingo $0 | Fortune $0 | Tax $0
Board [Kc Ah 9d As 7c]
Seat 1: b614d7f1 (button) folded before Flop (didn't bet)
Seat 2: 1dc50d10 (small blind) folded before Flop
Seat 3: b828e7ee (big blind) won ($1.08)
Seat 4: d07ab82c folded on the River
Seat 5: 727f0a35 folded before Flop (didn't bet)
Seat 6: Hero folded before Flop (didn't bet)


Poker Hand #RC3141726066: Hold'em No Limit ($0.05/$0.1) - 2024/12/12 13:10:30
Table 'RushAndCash22321326' 6-max Seat #1 is the button
Seat 1: dd68a104 ($17.65 in chips)
Seat 2: Hero ($10.9 in chips)
Seat 3: bc092e13 ($11.22 in chips)
Seat 4: 6904b57e ($18.5 in chips)
Seat 5: 48f3df37 ($21.2 in chips)
Seat 6: d515d6ec ($11.63 in chips)
Hero: posts small blind $0.05
bc092e13: posts big blind $0.1
*** HOLE CARDS ***
Dealt to dd68a104 
Dealt to Hero [Ac Qh]
Dealt to bc092e13 
Dealt to 6904b57e 
Dealt to 48f3df37 
Dealt to d515d6ec 
6904b57e: raises $0.15 to $0.25
48f3df37: folds
d515d6ec: folds
dd68a104: calls $0.25
Hero: folds
bc092e13: folds
*** FLOP *** [4h Td 7s]
6904b57e: bets $0.22
dd68a104: calls $0.22
*** TURN *** [4h Td 7s] [6d]
6904b57e: checks
dd68a104: checks
*** RIVER *** [4h Td 7s 6d] [Jd]
6904b57e: checks
dd68a104: checks
6904b57e: shows [Ks Ts] (Pair of Tens)
dd68a104: shows [8h Jh] (Pair of Jacks)
*** SHOWDOWN ***
dd68a104 collected $1.04 from pot
*** SUMMARY ***
Total pot $1.09 | Rake $0.05 | Jackpot $0 | Bingo $0 | Fortune $0 | Tax $0
Board [4h Td 7s 6d Jd]
Seat 1: dd68a104 (button) showed [8h Jh] and won ($1.04) with Pair of Jacks
Seat 2: Hero (small blind) folded before Flop
Seat 3: bc092e13 (big blind) folded before Flop
Seat 4: 6904b57e showed [Ks Ts] and lost with Pair of Tens
Seat 5: 48f3df37 folded before Flop (didn't bet)
Seat 6: d515d6ec folded before Flop (didn't bet)


Poker Hand #RC3141726050: Hold'em No Limit ($0.05/$0.1) - 2024/12/12 13:10:26
Table 'RushAndCash22321310' 6-max Seat #1 is the button
Seat 1: c8c2a1e ($10 in chips)
Seat 2: 3f5e12f8 ($10.71 in chips)
Seat 3: Hero ($11 in chips)
Seat 4: 7f65d70 ($10.8 in chips)
Seat 5: 340255c5 ($11.72 in chips)
Seat 6: 83a198b3 ($10 in chips)
3f5e12f8: posts small blind $0.05
Hero: posts big blind $0.1
*** HOLE CARDS ***
Dealt to c8c2a1e 
Dealt to 3f5e12f8 
Dealt to Hero [6s Kh]
Dealt to 7f65d70 
Dealt to 340255c5 
Dealt to 83a198b3 
7f65d70: folds
340255c5: raises $0.15 to $0.25
83a198b3: folds
c8c2a1e: folds
3f5e12f8: raises $0.9 to $1.15
Hero: folds
340255c5: folds
Uncalled bet ($0.9) returned to 3f5e12f8
*** SHOWDOWN ***
3f5e12f8 collected $0.57 from pot
*** SUMMARY ***
Total pot $0.6 | Rake $0.03 | Jackpot $0 | Bingo $0 | Fortune $0 | Tax $0
Seat 1: c8c2a1e (button) folded before Flop (didn't bet)
Seat 2: 3f5e12f8 (small blind) collected ($0.57)
Seat 3: Hero (big blind) folded before Flop
Seat 4: 7f65d70 folded before Flop (didn't bet)
Seat 5: 340255c5 folded before Flop
Seat 6: 83a198b3 folded before Flop (didn't bet)


Poker Hand #RC3141725860: Hold'em No Limit ($0.05/$0.1) - 2024/12/12 13:09:44
Table 'RushAndCash22321120' 6-max Seat #1 is the button
Seat 1: Hero ($10.05 in chips)
Seat 2: 340255c5 ($12.67 in chips)
Seat 3: 8fc49c26 ($44.75 in chips)
Seat 4: 671b32fd ($14.31 in chips)
Seat 5: 88133657 ($10.37 in chips)
Seat 6: cb8dca6d ($10.05 in chips)
340255c5: posts small blind $0.05
8fc49c26: posts big blind $0.1
*** HOLE CARDS ***
Dealt to Hero [Ac Kd]
Dealt to 340255c5 
Dealt to 8fc49c26 
Dealt to 671b32fd 
Dealt to 88133657 
Dealt to cb8dca6d 
671b32fd: folds
88133657: folds
cb8dca6d: folds
Hero: raises $0.15 to $0.25
340255c5: raises $0.7 to $0.95
8fc49c26: folds
Hero: raises $1.5 to $2.45
340255c5: folds
Uncalled bet ($1.5) returned to Hero
*** SHOWDOWN ***
Hero collected $1.9 from pot
*** SUMMARY ***
Total pot $2 | Rake $0.1 | Jackpot $0 | Bingo $0 | Fortune $0 | Tax $0
Seat 1: Hero (button) collected ($1.9)
Seat 2: 340255c5 (small blind) folded before Flop
Seat 3: 8fc49c26 (big blind) folded before Flop
Seat 4: 671b32fd folded before Flop (didn't bet)
Seat 5: 88133657 folded before Flop (didn't bet)
Seat 6: cb8dca6d folded before Flop (didn't bet)


Poker Hand #RC3141725817: Hold'em No Limit ($0.05/$0.1) - 2024/12/12 13:09:34
Table 'RushAndCash22321077' 6-max Seat #1 is the button
Seat 1: 1036e403 ($12.9 in chips)
Seat 2: e60f3780 ($13.45 in chips)
Seat 3: Hero ($10 in chips)
Seat 4: aa6f9192 ($10.1 in chips)
Seat 5: 8424fd65 ($15.6 in chips)
Seat 6: 902b9d1a ($9.66 in chips)
e60f3780: posts small blind $0.05
Hero: posts big blind $0.1
*** HOLE CARDS ***
Dealt to 1036e403 
Dealt to e60f3780 
Dealt to Hero [Kh Th]
Dealt to aa6f9192 
Dealt to 8424fd65 
Dealt to 902b9d1a 
aa6f9192: folds
8424fd65: folds
902b9d1a: folds
1036e403: folds
e60f3780: folds
Uncalled bet ($0.05) returned to Hero
*** SHOWDOWN ***
Hero collected $0.1 from pot
*** SUMMARY ***
Total pot $0.1 | Rake $0 | Jackpot $0 | Bingo $0 | Fortune $0 | Tax $0
Seat 1: 1036e403 (button) folded before Flop (didn't bet)
Seat 2: e60f3780 (small blind) folded before Flop
Seat 3: Hero (big blind) collected ($0.1)
Seat 4: aa6f9192 folded before Flop (didn't bet)
Seat 5: 8424fd65 folded before Flop (didn't bet)
Seat 6: 902b9d1a folded before Flop (didn't bet)


Poker Hand #RC3141725801: Hold'em No Limit ($0.05/$0.1) - 2024/12/12 13:09:30
Table 'RushAndCash22321061' 6-max Seat #1 is the button
Seat 1: b614d7f1 ($10 in chips)
Seat 2: Hero ($10 in chips)
Seat 3: 1e0385e8 ($10.33 in chips)
Seat 4: e4fc8b12 ($13.5 in chips)
Seat 5: c2b852ae ($7.7 in chips)
Seat 6: 3fb0fb21 ($10.15 in chips)
Hero: posts small blind $0.05
1e0385e8: posts big blind $0.1
*** HOLE CARDS ***
Dealt to b614d7f1 
Dealt to Hero [4c 2h]
Dealt to 1e0385e8 
Dealt to e4fc8b12 
Dealt to c2b852ae 
Dealt to 3fb0fb21 
e4fc8b12: folds
c2b852ae: folds
3fb0fb21: folds
b614d7f1: folds
Hero: folds
Uncalled bet ($0.05) returned to 1e0385e8
*** SHOWDOWN ***
1e0385e8 collected $0.1 from pot
*** SUMMARY ***
Total pot $0.1 | Rake $0 | Jackpot $0 | Bingo $0 | Fortune $0 | Tax $0
Seat 1: b614d7f1 (button) folded before Flop (didn't bet)
Seat 2: Hero (small blind) folded before Flop
Seat 3: 1e0385e8 (big blind) collected ($0.1)
Seat 4: e4fc8b12 folded before Flop (didn't bet)
Seat 5: c2b852ae folded before Flop (didn't bet)
Seat 6: 3fb0fb21 folded before Flop (didn't bet)


Poker Hand #RC3141725787: Hold'em No Limit ($0.05/$0.1) - 2024/12/12 13:09:26
Table 'RushAndCash22321047' 6-max Seat #1 is the button
Seat 1: 1e0385e8 ($10.33 in chips)
Seat 2: afe10f69 ($11.01 in chips)
Seat 3: a9eb45fc ($11.73 in chips)
Seat 4: c2b852ae ($7.7 in chips)
Seat 5: Hero ($10 in chips)
Seat 6: e4fc8b12 ($13.5 in chips)
afe10f69: posts small blind $0.05
a9eb45fc: posts big blind $0.1
*** HOLE CARDS ***
Dealt to 1e0385e8 
Dealt to afe10f69 
Dealt to a9eb45fc 
Dealt to c2b852ae 
Dealt to Hero [Tc 8s]
Dealt to e4fc8b12 
c2b852ae: folds
Hero: folds
e4fc8b12: folds
1e0385e8: folds
afe10f69: folds
Uncalled bet ($0.05) returned to a9eb45fc
*** SHOWDOWN ***
a9eb45fc collected $0.1 from pot
*** SUMMARY ***
Total pot $0.1 | Rake $0 | Jackpot $0 | Bingo $0 | Fortune $0 | Tax $0
Seat 1: 1e0385e8 (button) folded before Flop (didn't bet)
Seat 2: afe10f69 (small blind) folded before Flop
Seat 3: a9eb45fc (big blind) collected ($0.1)
Seat 4: c2b852ae folded before Flop (didn't bet)
Seat 5: Hero folded before Flop (didn't bet)
Seat 6: e4fc8b12 folded before Flop (didn't bet)


Poker Hand #RC3141725772: Hold'em No Limit ($0.05/$0.1) - 2024/12/12 13:09:23
Table 'RushAndCash22321032' 6-max Seat #1 is the button
Seat 1: 66a73913 ($16.69 in chips)
Seat 2: b614d7f1 ($10 in chips)
Seat 3: e60f3780 ($13.55 in chips)
Seat 4: aecd8c87 ($10.89 in chips)
Seat 5: Hero ($10 in chips)
Seat 6: e4fc8b12 ($13.5 in chips)
b614d7f1: posts small blind $0.05
e60f3780: posts big blind $0.1
*** HOLE CARDS ***
Dealt to 66a73913 
Dealt to b614d7f1 
Dealt to e60f3780 
Dealt to aecd8c87 
Dealt to Hero [Kc 2s]
Dealt to e4fc8b12 
aecd8c87: calls $0.1
Hero: folds
e4fc8b12: folds
66a73913: raises $0.44 to $0.54
b614d7f1: folds
e60f3780: folds
aecd8c87: folds
Uncalled bet ($0.44) returned to 66a73913
*** SHOWDOWN ***
66a73913 collected $0.34 from pot
*** SUMMARY ***
Total pot $0.35 | Rake $0.01 | Jackpot $0 | Bingo $0 | Fortune $0 | Tax $0
Seat 1: 66a73913 (button) collected ($0.34)
Seat 2: b614d7f1 (small blind) folded before Flop
Seat 3: e60f3780 (big blind) folded before Flop
Seat 4: aecd8c87 folded before Flop
Seat 5: Hero folded before Flop (didn't bet)
Seat 6: e4fc8b12 folded before Flop (didn't bet)


Poker Hand #RC3141725757: Hold'em No Limit ($0.05/$0.1) - 2024/12/12 13:09:19
Table 'RushAndCash22321017' 6-max Seat #1 is the button
Seat 1: 52c6c741 ($10 in chips)
Seat 2: b17913e8 ($10 in chips)
Seat 3: 3b12e634 ($11.51 in chips)
Seat 4: 6a806110 ($10.69 in chips)
Seat 5: Hero ($10 in chips)
Seat 6: e60f3780 ($13.55 in chips)
b17913e8: posts small blind $0.05
3b12e634: posts big blind $0.1
*** HOLE CARDS ***
Dealt to 52c6c741 
Dealt to b17913e8 
Dealt to 3b12e634 
Dealt to 6a806110 
Dealt to Hero [8c 7s]
Dealt to e60f3780 
6a806110: raises $0.15 to $0.25
Hero: folds
e60f3780: folds
52c6c741: raises $0.55 to $0.8
b17913e8: folds
3b12e634: calls $0.7
6a806110: calls $0.55
*** FLOP *** [Qd 3c Kh]
3b12e634: checks
6a806110: checks
52c6c741: bets $0.81
3b12e634: calls $0.81
6a806110: folds
*** TURN *** [Qd 3c Kh] [Kc]
3b12e634: checks
52c6c741: bets $4.07
3b12e634: folds
Uncalled bet ($4.07) returned to 52c6c741
*** SHOWDOWN ***
52c6c741 collected $3.73 from pot
*** SUMMARY ***
Total pot $4.07 | Rake $0.19 | Jackpot $0.15 | Bingo $0 | Fortune $0 | Tax $0
Board [Qd 3c Kh Kc]
Seat 1: 52c6c741 (button) won ($3.73)
Seat 2: b17913e8 (small blind) folded before Flop
Seat 3: 3b12e634 (big blind) folded on the Turn
Seat 4: 6a806110 folded on the Flop
Seat 5: Hero folded before Flop (didn't bet)
Seat 6: e60f3780 folded before Flop (didn't bet)


Poker Hand #RC3141725739: Hold'em No Limit ($0.05/$0.1) - 2024/12/12 13:09:16
Table 'RushAndCash22320999' 6-max Seat #1 is the button
Seat 1: Hero ($10 in chips)
Seat 2: 84849e11 ($88.97 in chips)
Seat 3: d1122f42 ($11.64 in chips)
Seat 4: 6c4ba3fb ($18.6 in chips)
Seat 5: 5f7772c4 ($4.03 in chips)
Seat 6: af0fe6b0 ($10.35 in chips)
84849e11: posts small blind $0.05
d1122f42: posts big blind $0.1
*** HOLE CARDS ***
Dealt to Hero [4d 9s]
Dealt to 84849e11 
Dealt to d1122f42 
Dealt to 6c4ba3fb 
Dealt to 5f7772c4 
Dealt to af0fe6b0 
6c4ba3fb: folds
5f7772c4: folds
af0fe6b0: folds
Hero: folds
84849e11: raises $0.2 to $0.3
d1122f42: folds
Uncalled bet ($0.2) returned to 84849e11
*** SHOWDOWN ***
84849e11 collected $0.2 from pot
*** SUMMARY ***
Total pot $0.2 | Rake $0 | Jackpot $0 | Bingo $0 | Fortune $0 | Tax $0
Seat 1: Hero (button) folded before Flop (didn't bet)
Seat 2: 84849e11 (small blind) collected ($0.2)
Seat 3: d1122f42 (big blind) folded before Flop
Seat 4: 6c4ba3fb folded before Flop (didn't bet)
Seat 5: 5f7772c4 folded before Flop (didn't bet)
Seat 6: af0fe6b0 folded before Flop (didn't bet)


Poker Hand #RC3141725722: Hold'em No Limit ($0.05/$0.1) - 2024/12/12 13:09:13
Table 'RushAndCash22320982' 6-max Seat #1 is the button
Seat 1: f44841fc ($10 in chips)
Seat 2: ceedbd4f ($10.53 in chips)
Seat 3: a699d2de ($9.67 in chips)
Seat 4: af0fe6b0 ($10.35 in chips)
Seat 5: Hero ($10 in chips)
Seat 6: 4f76bae1 ($11.96 in chips)
ceedbd4f: posts small blind $0.05
a699d2de: posts big blind $0.1
*** HOLE CARDS ***
Dealt to f44841fc 
Dealt to ceedbd4f 
Dealt to a699d2de 
Dealt to af0fe6b0 
Dealt to Hero [Tc 2s]
Dealt to 4f76bae1 
af0fe6b0: folds
Hero: folds
4f76bae1: folds
f44841fc: raises $0.15 to $0.25
ceedbd4f: folds
a699d2de: calls $0.15
*** FLOP *** [Ks Qd 8s]
a699d2de: checks
f44841fc: bets $0.28
a699d2de: folds
Uncalled bet ($0.28) returned to f44841fc
*** SHOWDOWN ***
f44841fc collected $0.53 from pot
*** SUMMARY ***
Total pot $0.55 | Rake $0.02 | Jackpot $0 | Bingo $0 | Fortune $0 | Tax $0
Board [Ks Qd 8s]
Seat 1: f44841fc (button) won ($0.53)
Seat 2: ceedbd4f (small blind) folded before Flop
Seat 3: a699d2de (big blind) folded on the Flop
Seat 4: af0fe6b0 folded before Flop (didn't bet)
Seat 5: Hero folded before Flop (didn't bet)
Seat 6: 4f76bae1 folded before Flop (didn't bet)


Poker Hand #RC3141725708: Hold'em No Limit ($0.05/$0.1) - 2024/12/12 13:09:09
Table 'RushAndCash22320968' 6-max Seat #1 is the button
Seat 1: 639a9874 ($10 in chips)
Seat 2: a6fdbe1b ($11.43 in chips)
Seat 3: Hero ($10.1 in chips)
Seat 4: 73e84fa ($29.76 in chips)
Seat 5: 661d577b ($11.91 in chips)
Seat 6: aaca7529 ($6.65 in chips)
a6fdbe1b: posts small blind $0.05
Hero: posts big blind $0.1
*** HOLE CARDS ***
Dealt to 639a9874 
Dealt to a6fdbe1b 
Dealt to Hero [6c 5s]
Dealt to 73e84fa 
Dealt to 661d577b 
Dealt to aaca7529 
73e84fa: raises $0.15 to $0.25
661d577b: calls $0.25
aaca7529: calls $0.25
639a9874: folds
a6fdbe1b: folds
Hero: folds
*** FLOP *** [Kc 3d 4d]
73e84fa: bets $0.29
661d577b: calls $0.29
aaca7529: folds
*** TURN *** [Kc 3d 4d] [6h]
73e84fa: bets $0.77
661d577b: folds
Uncalled bet ($0.77) returned to 73e84fa
*** SHOWDOWN ***
73e84fa collected $1.41 from pot
*** SUMMARY ***
Total pot $1.48 | Rake $0.07 | Jackpot $0 | Bingo $0 | Fortune $0 | Tax $0
Board [Kc 3d 4d 6h]
Seat 1: 639a9874 (button) folded before Flop (didn't bet)
Seat 2: a6fdbe1b (small blind) folded before Flop
Seat 3: Hero (big blind) folded before Flop
Seat 4: 73e84fa won ($1.41)
Seat 5: 661d577b folded on the Turn
Seat 6: aaca7529 folded on the Flop


Poker Hand #RC3141725639: Hold'em No Limit ($0.05/$0.1) - 2024/12/12 13:08:51
Table 'RushAndCash22320899' 6-max Seat #1 is the button
Seat 1: afe10f69 ($11.01 in chips)
Seat 2: Hero ($10 in chips)
Seat 3: 661d577b ($12.06 in chips)
Seat 4: 41ad32d3 ($22.2 in chips)
Seat 5: b4bc8071 ($12.39 in chips)
Seat 6: a9eb45fc ($11.43 in chips)
Hero: posts small blind $0.05
661d577b: posts big blind $0.1
*** HOLE CARDS ***
Dealt to afe10f69 
Dealt to Hero [9h 7h]
Dealt to 661d577b 
Dealt to 41ad32d3 
Dealt to b4bc8071 
Dealt to a9eb45fc 
41ad32d3: folds
b4bc8071: folds
a9eb45fc: folds
afe10f69: folds
Hero: raises $0.2 to $0.3
661d577b: folds
Uncalled bet ($0.2) returned to Hero
*** SHOWDOWN ***
Hero collected $0.2 from pot
*** SUMMARY ***
Total pot $0.2 | Rake $0 | Jackpot $0 | Bingo $0 | Fortune $0 | Tax $0
Seat 1: afe10f69 (button) folded before Flop (didn't bet)
Seat 2: Hero (small blind) collected ($0.2)
Seat 3: 661d577b (big blind) folded before Flop
Seat 4: 41ad32d3 folded before Flop (didn't bet)
Seat 5: b4bc8071 folded before Flop (didn't bet)
Seat 6: a9eb45fc folded before Flop (didn't bet)


Poker Hand #RC3141725622: Hold'em No Limit ($0.05/$0.1) - 2024/12/12 13:08:47
Table 'RushAndCash22320882' 6-max Seat #1 is the button
Seat 1: Hero ($10 in chips)
Seat 2: b0559006 ($4.73 in chips)
Seat 3: 844091a0 ($10.55 in chips)
Seat 4: cc0ee7ad ($9.06 in chips)
Seat 5: 4f76bae1 ($12.11 in chips)
Seat 6: 2edfec7c ($8.43 in chips)
b0559006: posts small blind $0.05
844091a0: posts big blind $0.1
*** HOLE CARDS ***
Dealt to Hero [5h Qd]
Dealt to b0559006 
Dealt to 844091a0 
Dealt to cc0ee7ad 
Dealt to 4f76bae1 
Dealt to 2edfec7c 
cc0ee7ad: folds
4f76bae1: folds
2edfec7c: folds
Hero: folds
b0559006: folds
Uncalled bet ($0.05) returned to 844091a0
*** SHOWDOWN ***
844091a0 collected $0.1 from pot
*** SUMMARY ***
Total pot $0.1 | Rake $0 | Jackpot $0 | Bingo $0 | Fortune $0 | Tax $0
Seat 1: Hero (button) folded before Flop (didn't bet)
Seat 2: b0559006 (small blind) folded before Flop
Seat 3: 844091a0 (big blind) collected ($0.1)
Seat 4: cc0ee7ad folded before Flop (didn't bet)
Seat 5: 4f76bae1 folded before Flop (didn't bet)
Seat 6: 2edfec7c folded before Flop (didn't bet)


Poker Hand #RC3141725566: Hold'em No Limit ($0.05/$0.1) - 2024/12/12 13:08:33
Table 'RushAndCash22320826' 6-max Seat #1 is the button
Seat 1: fe38852f ($10 in chips)
Seat 2: 5f7772c4 ($3.9 in chips)
Seat 3: 1eed6c31 ($8.1 in chips)
Seat 4: 701f843f ($6.88 in chips)
Seat 5: 7b43c302 ($10.27 in chips)
Seat 6: Hero ($10 in chips)
5f7772c4: posts small blind $0.05
1eed6c31: posts big blind $0.1
*** HOLE CARDS ***
Dealt to fe38852f 
Dealt to 5f7772c4 
Dealt to 1eed6c31 
Dealt to 701f843f 
Dealt to 7b43c302 
Dealt to Hero [4d Ah]
701f843f: folds
7b43c302: folds
Hero: folds
fe38852f: folds
5f7772c4: folds
Uncalled bet ($0.05) returned to 1eed6c31
*** SHOWDOWN ***
1eed6c31 collected $0.1 from pot
*** SUMMARY ***
Total pot $0.1 | Rake $0 | Jackpot $0 | Bingo $0 | Fortune $0 | Tax $0
Seat 1: fe38852f (button) folded before Flop (didn't bet)
Seat 2: 5f7772c4 (small blind) folded before Flop
Seat 3: 1eed6c31 (big blind) collected ($0.1)
Seat 4: 701f843f folded before Flop (didn't bet)
Seat 5: 7b43c302 folded before Flop (didn't bet)
Seat 6: Hero folded before Flop (didn't bet)


Poker Hand #RC3141725508: Hold'em No Limit ($0.05/$0.1) - 2024/12/12 13:08:18
Table 'RushAndCash22320768' 6-max Seat #1 is the button
Seat 1: d8699a3 ($10.23 in chips)
Seat 2: 204f692c ($20.48 in chips)
Seat 3: Hero ($10 in chips)
Seat 4: 418b0280 ($10 in chips)
Seat 5: cf64da1a ($36.18 in chips)
Seat 6: 316b7313 ($9.85 in chips)
204f692c: posts small blind $0.05
Hero: posts big blind $0.1
*** HOLE CARDS ***
Dealt to d8699a3 
Dealt to 204f692c 
Dealt to Hero [Jd Ad]
Dealt to 418b0280 
Dealt to cf64da1a 
Dealt to 316b7313 
418b0280: raises $0.1 to $0.2
cf64da1a: raises $0.43 to $0.63
316b7313: folds
d8699a3: folds
204f692c: folds
Hero: folds
418b0280: calls $0.43
*** FLOP *** [6c 5d 4h]
418b0280: checks
cf64da1a: checks
*** TURN *** [6c 5d 4h] [Qh]
418b0280: checks
cf64da1a: bets $0.71
418b0280: calls $0.71
*** RIVER *** [6c 5d 4h Qh] [2d]
418b0280: checks
cf64da1a: bets $1.7
418b0280: calls $1.7
cf64da1a: shows [Qd Qc] (Three Queens)
418b0280: shows [Td Tc] (Pair of Tens)
*** SHOWDOWN ***
cf64da1a collected $5.78 from pot
*** SUMMARY ***
Total pot $6.23 | Rake $0.3 | Jackpot $0.15 | Bingo $0 | Fortune $0 | Tax $0
Board [6c 5d 4h Qh 2d]
Seat 1: d8699a3 (button) folded before Flop (didn't bet)
Seat 2: 204f692c (small blind) folded before Flop
Seat 3: Hero (big blind) folded before Flop
Seat 4: 418b0280 showed [Td Tc] and lost with Pair of Tens
Seat 5: cf64da1a showed [Qd Qc] and won ($5.78) with Three Queens
Seat 6: 316b7313 folded before Flop (didn't bet)


Poker Hand #RC3141725486: Hold'em No Limit ($0.05/$0.1) - 2024/12/12 13:08:13
Table 'RushAndCash22320746' 6-max Seat #1 is the button
Seat 1: eb12374a ($10.38 in chips)
Seat 2: f1e9bea0 ($39.89 in chips)
Seat 3: c7bc4949 ($7.77 in chips)
Seat 4: 16994a2d ($11.52 in chips)
Seat 5: Hero ($10 in chips)
Seat 6: 11a00985 ($18.01 in chips)
f1e9bea0: posts small blind $0.05
c7bc4949: posts big blind $0.1
*** HOLE CARDS ***
Dealt to eb12374a 
Dealt to f1e9bea0 
Dealt to c7bc4949 
Dealt to 16994a2d 
Dealt to Hero [7h Th]
Dealt to 11a00985 
16994a2d: folds
Hero: folds
11a00985: folds
eb12374a: folds
f1e9bea0: folds
Uncalled bet ($0.05) returned to c7bc4949
*** SHOWDOWN ***
c7bc4949 collected $0.1 from pot
*** SUMMARY ***
Total pot $0.1 | Rake $0 | Jackpot $0 | Bingo $0 | Fortune $0 | Tax $0
Seat 1: eb12374a (button) folded before Flop (didn't bet)
Seat 2: f1e9bea0 (small blind) folded before Flop
Seat 3: c7bc4949 (big blind) collected ($0.1)
Seat 4: 16994a2d folded before Flop (didn't bet)
Seat 5: Hero folded before Flop (didn't bet)
Seat 6: 11a00985 folded before Flop (didn't bet)


Poker Hand #RC3141725472: Hold'em No Limit ($0.05/$0.1) - 2024/12/12 13:08:09
Table 'RushAndCash22320732' 6-max Seat #1 is the button
Seat 1: 8a55880e ($17.82 in chips)
Seat 2: a212e67a ($10.23 in chips)
Seat 3: 55e95fce ($10.44 in chips)
Seat 4: e04e7077 ($10.52 in chips)
Seat 5: 721d2ee6 ($13.69 in chips)
Seat 6: Hero ($10 in chips)
a212e67a: posts small blind $0.05
55e95fce: posts big blind $0.1
*** HOLE CARDS ***
Dealt to 8a55880e 
Dealt to a212e67a 
Dealt to 55e95fce 
Dealt to e04e7077 
Dealt to 721d2ee6 
Dealt to Hero [8c 7d]
e04e7077: raises $0.15 to $0.25
721d2ee6: folds
Hero: folds
8a55880e: folds
a212e67a: calls $0.2
55e95fce: folds
*** FLOP *** [2h Th 4d]
a212e67a: checks
e04e7077: checks
*** TURN *** [2h Th 4d] [9h]
a212e67a: checks
e04e7077: bets $0.46
a212e67a: folds
Uncalled bet ($0.46) returned to e04e7077
*** SHOWDOWN ***
e04e7077 collected $0.57 from pot
*** SUMMARY ***
Total pot $0.6 | Rake $0.03 | Jackpot $0 | Bingo $0 | Fortune $0 | Tax $0
Board [2h Th 4d 9h]
Seat 1: 8a55880e (button) folded before Flop (didn't bet)
Seat 2: a212e67a (small blind) folded on the Turn
Seat 3: 55e95fce (big blind) folded before Flop
Seat 4: e04e7077 won ($0.57)
Seat 5: 721d2ee6 folded before Flop (didn't bet)
Seat 6: Hero folded before Flop (didn't bet)


Poker Hand #RC3141725456: Hold'em No Limit ($0.05/$0.1) - 2024/12/12 13:08:05
Table 'RushAndCash22320716' 6-max Seat #1 is the button
Seat 1: e04e7077 ($10.52 in chips)
Seat 2: Hero ($10 in chips)
Seat 3: 637471ad ($10.42 in chips)
Seat 4: c7bc4949 ($7.77 in chips)
Seat 5: b1f396f4 ($20.77 in chips)
Seat 6: bc092e13 ($10.1 in chips)
Hero: posts small blind $0.05
637471ad: posts big blind $0.1
*** HOLE CARDS ***
Dealt to e04e7077 
Dealt to Hero [8s Jh]
Dealt to 637471ad 
Dealt to c7bc4949 
Dealt to b1f396f4 
Dealt to bc092e13 
c7bc4949: folds
b1f396f4: folds
bc092e13: folds
e04e7077: folds
Hero: folds
Uncalled bet ($0.05) returned to 637471ad
*** SHOWDOWN ***
637471ad collected $0.1 from pot
*** SUMMARY ***
Total pot $0.1 | Rake $0 | Jackpot $0 | Bingo $0 | Fortune $0 | Tax $0
Seat 1: e04e7077 (button) folded before Flop (didn't bet)
Seat 2: Hero (small blind) folded before Flop
Seat 3: 637471ad (big blind) collected ($0.1)
Seat 4: c7bc4949 folded before Flop (didn't bet)
Seat 5: b1f396f4 folded before Flop (didn't bet)
Seat 6: bc092e13 folded before Flop (didn't bet)


Poker Hand #RC3141725442: Hold'em No Limit ($0.05/$0.1) - 2024/12/12 13:08:02
Table 'RushAndCash22320702' 6-max Seat #1 is the button
Seat 1: afe10f69 ($10.86 in chips)
Seat 2: 41ef6e45 ($7.01 in chips)
Seat 3: 3c7f222d ($11.61 in chips)
Seat 4: c7bc4949 ($7.77 in chips)
Seat 5: 51c5666 ($13.19 in chips)
Seat 6: Hero ($10 in chips)
41ef6e45: posts small blind $0.05
3c7f222d: posts big blind $0.1
*** HOLE CARDS ***
Dealt to afe10f69 
Dealt to 41ef6e45 
Dealt to 3c7f222d 
Dealt to c7bc4949 
Dealt to 51c5666 
Dealt to Hero [2d Jc]
c7bc4949: folds
51c5666: folds
Hero: folds
afe10f69: folds
41ef6e45: calls $0.05
3c7f222d: checks
*** FLOP *** [8c 7d Jh]
41ef6e45: checks
3c7f222d: checks
*** TURN *** [8c 7d Jh] [7h]
41ef6e45: bets $0.1
3c7f222d: calls $0.1
*** RIVER *** [8c 7d Jh 7h] [3h]
41ef6e45: checks
3c7f222d: bets $0.4
41ef6e45: folds
Uncalled bet ($0.4) returned to 3c7f222d
*** SHOWDOWN ***
3c7f222d collected $0.38 from pot
*** SUMMARY ***
Total pot $0.4 | Rake $0.02 | Jackpot $0 | Bingo $0 | Fortune $0 | Tax $0
Board [8c 7d Jh 7h 3h]
Seat 1: afe10f69 (button) folded before Flop (didn't bet)
Seat 2: 41ef6e45 (small blind) folded on the River
Seat 3: 3c7f222d (big blind) won ($0.38)
Seat 4: c7bc4949 folded before Flop (didn't bet)
Seat 5: 51c5666 folded before Flop (didn't bet)
Seat 6: Hero folded before Flop (didn't bet)


Poker Hand #RC3141725425: Hold'em No Limit ($0.05/$0.1) - 2024/12/12 13:07:58
Table 'RushAndCash22320685' 6-max Seat #1 is the button
Seat 1: ff1406c1 ($15.56 in chips)
Seat 2: a0f1bc98 ($11.13 in chips)
Seat 3: 70f16de6 ($10.53 in chips)
Seat 4: f383ae87 ($24.52 in chips)
Seat 5: Hero ($10 in chips)
Seat 6: bb09d73b ($4.43 in chips)
a0f1bc98: posts small blind $0.05
70f16de6: posts big blind $0.1
*** HOLE CARDS ***
Dealt to ff1406c1 
Dealt to a0f1bc98 
Dealt to 70f16de6 
Dealt to f383ae87 
Dealt to Hero [Ts Qh]
Dealt to bb09d73b 
f383ae87: raises $0.1 to $0.2
Hero: folds
bb09d73b: folds
ff1406c1: folds
a0f1bc98: calls $0.15
70f16de6: calls $0.1
*** FLOP *** [8d Ah Kh]
a0f1bc98: checks
70f16de6: checks
f383ae87: checks
*** TURN *** [8d Ah Kh] [Jd]
a0f1bc98: checks
70f16de6: checks
f383ae87: checks
*** RIVER *** [8d Ah Kh Jd] [9c]
a0f1bc98: checks
70f16de6: checks
f383ae87: checks
a0f1bc98: shows [8s 6s] (Pair of Eights)
70f16de6: shows [4s 7d] (Ace-High)
f383ae87: shows [4d 4c] (Pair of Fours)
*** SHOWDOWN ***
a0f1bc98 collected $0.57 from pot
*** SUMMARY ***
Total pot $0.6 | Rake $0.03 | Jackpot $0 | Bingo $0 | Fortune $0 | Tax $0
Board [8d Ah Kh Jd 9c]
Seat 1: ff1406c1 (button) folded before Flop (didn't bet)
Seat 2: a0f1bc98 (small blind) showed [8s 6s] and won ($0.57) with Pair of Eights
Seat 3: 70f16de6 (big blind) showed [4s 7d] and lost with Ace-High
Seat 4: f383ae87 showed [4d 4c] and lost with Pair of Fours
Seat 5: Hero folded before Flop (didn't bet)
Seat 6: bb09d73b folded before Flop (didn't bet)


Poker Hand #RC3141725401: Hold'em No Limit ($0.05/$0.1) - 2024/12/12 13:07:52
Table 'RushAndCash22320661' 6-max Seat #1 is the button
Seat 1: 8499417 ($11.44 in chips)
Seat 2: Hero ($10 in chips)
Seat 3: e04e7077 ($10.52 in chips)
Seat 4: 204f692c ($20.63 in chips)
Seat 5: 593f64c7 ($2.42 in chips)
Seat 6: 54a8e111 ($12.91 in chips)
Hero: posts small blind $0.05
e04e7077: posts big blind $0.1
*** HOLE CARDS ***
Dealt to 8499417 
Dealt to Hero [2d 7c]
Dealt to e04e7077 
Dealt to 204f692c 
Dealt to 593f64c7 
Dealt to 54a8e111 
204f692c: folds
593f64c7: folds
54a8e111: folds
8499417: folds
Hero: folds
Uncalled bet ($0.05) returned to e04e7077
*** SHOWDOWN ***
e04e7077 collected $0.1 from pot
*** SUMMARY ***
Total pot $0.1 | Rake $0 | Jackpot $0 | Bingo $0 | Fortune $0 | Tax $0
Seat 1: 8499417 (button) folded before Flop (didn't bet)
Seat 2: Hero (small blind) folded before Flop
Seat 3: e04e7077 (big blind) collected ($0.1)
Seat 4: 204f692c folded before Flop (didn't bet)
Seat 5: 593f64c7 folded before Flop (didn't bet)
Seat 6: 54a8e111 folded before Flop (didn't bet)


Poker Hand #RC3141725388: Hold'em No Limit ($0.05/$0.1) - 2024/12/12 13:07:49
Table 'RushAndCash22320648' 6-max Seat #1 is the button
Seat 1: Hero ($10 in chips)
Seat 2: 84cc5caa ($10.36 in chips)
Seat 3: bc092e13 ($10 in chips)
Seat 4: 2a6446ed ($11.3 in chips)
Seat 5: 78854bfa ($8.98 in chips)
Seat 6: 8499417 ($11.44 in chips)
84cc5caa: posts small blind $0.05
bc092e13: posts big blind $0.1
*** HOLE CARDS ***
Dealt to Hero [3s Kd]
Dealt to 84cc5caa 
Dealt to bc092e13 
Dealt to 2a6446ed 
Dealt to 78854bfa 
Dealt to 8499417 
2a6446ed: folds
78854bfa: folds
8499417: folds
Hero: folds
84cc5caa: folds
Uncalled bet ($0.05) returned to bc092e13
*** SHOWDOWN ***
bc092e13 collected $0.1 from pot
*** SUMMARY ***
Total pot $0.1 | Rake $0 | Jackpot $0 | Bingo $0 | Fortune $0 | Tax $0
Seat 1: Hero (button) folded before Flop (didn't bet)
Seat 2: 84cc5caa (small blind) folded before Flop
Seat 3: bc092e13 (big blind) collected ($0.1)
Seat 4: 2a6446ed folded before Flop (didn't bet)
Seat 5: 78854bfa folded before Flop (didn't bet)
Seat 6: 8499417 folded before Flop (didn't bet)


Poker Hand #RC3141725238: Hold'em No Limit ($0.05/$0.1) - 2024/12/12 13:07:11
Table 'RushAndCash22320498' 6-max Seat #1 is the button
Seat 1: ae47099b ($8.19 in chips)
Seat 2: 78854bfa ($9.03 in chips)
Seat 3: Hero ($10.17 in chips)
Seat 4: 25c1f7d7 ($10.06 in chips)
Seat 5: 4859226e ($8.8 in chips)
Seat 6: 4b9faa96 ($10.05 in chips)
78854bfa: posts small blind $0.05
Hero: posts big blind $0.1
*** HOLE CARDS ***
Dealt to ae47099b 
Dealt to 78854bfa 
Dealt to Hero [4h 5h]
Dealt to 25c1f7d7 
Dealt to 4859226e 
Dealt to 4b9faa96 
25c1f7d7: raises $0.15 to $0.25
4859226e: folds
4b9faa96: folds
ae47099b: folds
78854bfa: folds
Hero: calls $0.15
*** FLOP *** [7s 8h 7c]
Hero: checks
25c1f7d7: bets $0.28
Hero: raises $0.82 to $1.1
25c1f7d7: raises $2.07 to $3.17
Hero: folds
Uncalled bet ($2.07) returned to 25c1f7d7
*** SHOWDOWN ***
25c1f7d7 collected $2.62 from pot
*** SUMMARY ***
Total pot $2.75 | Rake $0.13 | Jackpot $0 | Bingo $0 | Fortune $0 | Tax $0
Board [7s 8h 7c]
Seat 1: ae47099b (button) folded before Flop (didn't bet)
Seat 2: 78854bfa (small blind) folded before Flop
Seat 3: Hero (big blind) folded on the Flop
Seat 4: 25c1f7d7 won ($2.62)
Seat 5: 4859226e folded before Flop (didn't bet)
Seat 6: 4b9faa96 folded before Flop (didn't bet)


Poker Hand #RC3141725222: Hold'em No Limit ($0.05/$0.1) - 2024/12/12 13:07:07
Table 'RushAndCash22320482' 6-max Seat #1 is the button
Seat 1: b9ea8dd9 ($5.41 in chips)
Seat 2: c2b852ae ($8.25 in chips)
Seat 3: 4b9faa96 ($10.15 in chips)
Seat 4: Hero ($10.17 in chips)
Seat 5: 1dc50d10 ($10 in chips)
Seat 6: ce410800 ($22.12 in chips)
c2b852ae: posts small blind $0.05
4b9faa96: posts big blind $0.1
*** HOLE CARDS ***
Dealt to b9ea8dd9 
Dealt to c2b852ae 
Dealt to 4b9faa96 
Dealt to Hero [6c 5h]
Dealt to 1dc50d10 
Dealt to ce410800 
Hero: folds
1dc50d10: folds
ce410800: raises $0.13 to $0.23
b9ea8dd9: calls $0.23
c2b852ae: folds
4b9faa96: folds
*** FLOP *** [5d Kh As]
ce410800: bets $0.21
b9ea8dd9: calls $0.21
*** TURN *** [5d Kh As] [7h]
ce410800: checks
b9ea8dd9: bets $0.34
ce410800: calls $0.34
*** RIVER *** [5d Kh As 7h] [2c]
ce410800: checks
b9ea8dd9: checks
ce410800: shows [Ah 2h] (Pair of Aces and Pair of Twos)
b9ea8dd9: shows [4c 4h] (Pair of Fours)
*** SHOWDOWN ***
ce410800 collected $1.63 from pot
*** SUMMARY ***
Total pot $1.71 | Rake $0.08 | Jackpot $0 | Bingo $0 | Fortune $0 | Tax $0
Board [5d Kh As 7h 2c]
Seat 1: b9ea8dd9 (button) showed [4c 4h] and lost with Pair of Fours
Seat 2: c2b852ae (small blind) folded before Flop
Seat 3: 4b9faa96 (big blind) folded before Flop
Seat 4: Hero folded before Flop (didn't bet)
Seat 5: 1dc50d10 folded before Flop (didn't bet)
Seat 6: ce410800 showed [Ah 2h] and won ($1.63) with Pair of Aces and Pair of Twos


Poker Hand #RC3141725210: Hold'em No Limit ($0.05/$0.1) - 2024/12/12 13:07:04
Table 'RushAndCash22320470' 6-max Seat #1 is the button
Seat 1: 4b9faa96 ($10.15 in chips)
Seat 2: 88133657 ($10 in chips)
Seat 3: bc641322 ($5.06 in chips)
Seat 4: ce410800 ($22.12 in chips)
Seat 5: 84cc5caa ($10.61 in chips)
Seat 6: Hero ($10.17 in chips)
88133657: posts small blind $0.05
bc641322: posts big blind $0.1
*** HOLE CARDS ***
Dealt to 4b9faa96 
Dealt to 88133657 
Dealt to bc641322 
Dealt to ce410800 
Dealt to 84cc5caa 
Dealt to Hero [Ts 7h]
ce410800: folds
84cc5caa: folds
Hero: folds
4b9faa96: folds
88133657: raises $0.2 to $0.3
bc641322: folds
Uncalled bet ($0.2) returned to 88133657
*** SHOWDOWN ***
88133657 collected $0.2 from pot
*** SUMMARY ***
Total pot $0.2 | Rake $0 | Jackpot $0 | Bingo $0 | Fortune $0 | Tax $0
Seat 1: 4b9faa96 (button) folded before Flop (didn't bet)
Seat 2: 88133657 (small blind) collected ($0.2)
Seat 3: bc641322 (big blind) folded before Flop
Seat 4: ce410800 folded before Flop (didn't bet)
Seat 5: 84cc5caa folded before Flop (didn't bet)
Seat 6: Hero folded before Flop (didn't bet)


Poker Hand #RC3141725197: Hold'em No Limit ($0.05/$0.1) - 2024/12/12 13:07:01
Table 'RushAndCash22320457' 6-max Seat #1 is the button
Seat 1: fd36d45d ($11.11 in chips)
Seat 2: 77907fc4 ($16.28 in chips)
Seat 3: e896e324 ($10.13 in chips)
Seat 4: Hero ($10.17 in chips)
Seat 5: 4b9faa96 ($10 in chips)
Seat 6: f5628a04 ($15.64 in chips)
77907fc4: posts small blind $0.05
e896e324: posts big blind $0.1
*** HOLE CARDS ***
Dealt to fd36d45d 
Dealt to 77907fc4 
Dealt to e896e324 
Dealt to Hero [7s Th]
Dealt to 4b9faa96 
Dealt to f5628a04 
Hero: folds
4b9faa96: folds
f5628a04: raises $0.14 to $0.24
fd36d45d: calls $0.24
77907fc4: folds
e896e324: folds
*** FLOP *** [Kd 2d 6h]
f5628a04: checks
fd36d45d: checks
*** TURN *** [Kd 2d 6h] [3h]
f5628a04: bets $0.48
fd36d45d: calls $0.48
*** RIVER *** [Kd 2d 6h 3h] [6c]
f5628a04: bets $1.2
fd36d45d: calls $1.2
f5628a04: shows [7c 4c] (Pair of Sixes)
fd36d45d: shows [4s Ks] (Pair of Kings and Pair of Sixes)
*** SHOWDOWN ***
fd36d45d collected $3.65 from pot
*** SUMMARY ***
Total pot $3.99 | Rake $0.19 | Jackpot $0.15 | Bingo $0 | Fortune $0 | Tax $0
Board [Kd 2d 6h 3h 6c]
Seat 1: fd36d45d (button) showed [4s Ks] and won ($3.65) with Pair of Kings and Pair of Sixes
Seat 2: 77907fc4 (small blind) folded before Flop
Seat 3: e896e324 (big blind) folded before Flop
Seat 4: Hero folded before Flop (didn't bet)
Seat 5: 4b9faa96 folded before Flop (didn't bet)
Seat 6: f5628a04 showed [7c 4c] and lost with Pair of Sixes


Poker Hand #RC3141725179: Hold'em No Limit ($0.05/$0.1) - 2024/12/12 13:06:56
Table 'RushAndCash22320439' 6-max Seat #1 is the button
Seat 1: Hero ($10.17 in chips)
Seat 2: 661d577b ($12.46 in chips)
Seat 3: ed5370bd ($10 in chips)
Seat 4: 8a31e4cb ($9.92 in chips)
Seat 5: e896e324 ($10.13 in chips)
Seat 6: 77907fc4 ($16.28 in chips)
661d577b: posts small blind $0.05
ed5370bd: posts big blind $0.1
*** HOLE CARDS ***
Dealt to Hero [Td 5h]
Dealt to 661d577b 
Dealt to ed5370bd 
Dealt to 8a31e4cb 
Dealt to e896e324 
Dealt to 77907fc4 
8a31e4cb: folds
e896e324: folds
77907fc4: folds
Hero: folds
661d577b: raises $0.2 to $0.3
ed5370bd: folds
Uncalled bet ($0.2) returned to 661d577b
*** SHOWDOWN ***
661d577b collected $0.2 from pot
*** SUMMARY ***
Total pot $0.2 | Rake $0 | Jackpot $0 | Bingo $0 | Fortune $0 | Tax $0
Seat 1: Hero (button) folded before Flop (didn't bet)
Seat 2: 661d577b (small blind) collected ($0.2)
Seat 3: ed5370bd (big blind) folded before Flop
Seat 4: 8a31e4cb folded before Flop (didn't bet)
Seat 5: e896e324 folded before Flop (didn't bet)
Seat 6: 77907fc4 folded before Flop (didn't bet)


Poker Hand #RC3141725163: Hold'em No Limit ($0.05/$0.1) - 2024/12/12 13:06:53
Table 'RushAndCash22320423' 6-max Seat #1 is the button
Seat 1: 42c70f64 ($10 in chips)
Seat 2: 4b9faa96 ($10 in chips)
Seat 3: Hero ($10.27 in chips)
Seat 4: b8e03e64 ($10.69 in chips)
Seat 5: 81834a2f ($17.24 in chips)
Seat 6: 7f65d70 ($10.15 in chips)
4b9faa96: posts small blind $0.05
Hero: posts big blind $0.1
*** HOLE CARDS ***
Dealt to 42c70f64 
Dealt to 4b9faa96 
Dealt to Hero [Jc 3h]
Dealt to b8e03e64 
Dealt to 81834a2f 
Dealt to 7f65d70 
b8e03e64: folds
81834a2f: folds
7f65d70: folds
42c70f64: raises $0.2 to $0.3
4b9faa96: folds
Hero: folds
Uncalled bet ($0.2) returned to 42c70f64
*** SHOWDOWN ***
42c70f64 collected $0.25 from pot
*** SUMMARY ***
Total pot $0.25 | Rake $0 | Jackpot $0 | Bingo $0 | Fortune $0 | Tax $0
Seat 1: 42c70f64 (button) collected ($0.25)
Seat 2: 4b9faa96 (small blind) folded before Flop
Seat 3: Hero (big blind) folded before Flop
Seat 4: b8e03e64 folded before Flop (didn't bet)
Seat 5: 81834a2f folded before Flop (didn't bet)
Seat 6: 7f65d70 folded before Flop (didn't bet)


Poker Hand #RC3141725145: Hold'em No Limit ($0.05/$0.1) - 2024/12/12 13:06:49
Table 'RushAndCash22320405' 6-max Seat #1 is the button
Seat 1: 727f0a35 ($10.47 in chips)
Seat 2: Hero ($10.32 in chips)
Seat 3: 2769a057 ($10 in chips)
Seat 4: 256d4298 ($9.8 in chips)
Seat 5: 661d577b ($12.56 in chips)
Seat 6: 84849e11 ($90.38 in chips)
Hero: posts small blind $0.05
2769a057: posts big blind $0.1
*** HOLE CARDS ***
Dealt to 727f0a35 
Dealt to Hero [2d Qc]
Dealt to 2769a057 
Dealt to 256d4298 
Dealt to 661d577b 
Dealt to 84849e11 
256d4298: folds
661d577b: folds
84849e11: raises $0.15 to $0.25
727f0a35: folds
Hero: folds
2769a057: calls $0.15
*** FLOP *** [8s Qs Kc]
2769a057: checks
84849e11: bets $0.31
2769a057: calls $0.31
*** TURN *** [8s Qs Kc] [3s]
2769a057: checks
84849e11: checks
*** RIVER *** [8s Qs Kc 3s] [2c]
2769a057: checks
84849e11: checks
2769a057: shows [Qh Jh] (Pair of Queens)
84849e11: shows [9c Jc] (King-High)
*** SHOWDOWN ***
2769a057 collected $1.12 from pot
*** SUMMARY ***
Total pot $1.17 | Rake $0.05 | Jackpot $0 | Bingo $0 | Fortune $0 | Tax $0
Board [8s Qs Kc 3s 2c]
Seat 1: 727f0a35 (button) folded before Flop (didn't bet)
Seat 2: Hero (small blind) folded before Flop
Seat 3: 2769a057 (big blind) showed [Qh Jh] and won ($1.12) with Pair of Queens
Seat 4: 256d4298 folded before Flop (didn't bet)
Seat 5: 661d577b folded before Flop (didn't bet)
Seat 6: 84849e11 showed [9c Jc] and lost with King-High


Poker Hand #RC3141725129: Hold'em No Limit ($0.05/$0.1) - 2024/12/12 13:06:46
Table 'RushAndCash22320389' 6-max Seat #1 is the button
Seat 1: c2b852ae ($8.4 in chips)
Seat 2: 84849e11 ($90.43 in chips)
Seat 3: 1d2dacdf ($11.51 in chips)
Seat 4: 2769a057 ($10 in chips)
Seat 5: d037fd58 ($12.48 in chips)
Seat 6: Hero ($10.32 in chips)
84849e11: posts small blind $0.05
1d2dacdf: posts big blind $0.1
*** HOLE CARDS ***
Dealt to c2b852ae 
Dealt to 84849e11 
Dealt to 1d2dacdf 
Dealt to 2769a057 
Dealt to d037fd58 
Dealt to Hero [4d 2c]
2769a057: folds
d037fd58: folds
Hero: folds
c2b852ae: folds
84849e11: folds
Uncalled bet ($0.05) returned to 1d2dacdf
*** SHOWDOWN ***
1d2dacdf collected $0.1 from pot
*** SUMMARY ***
Total pot $0.1 | Rake $0 | Jackpot $0 | Bingo $0 | Fortune $0 | Tax $0
Seat 1: c2b852ae (button) folded before Flop (didn't bet)
Seat 2: 84849e11 (small blind) folded before Flop
Seat 3: 1d2dacdf (big blind) collected ($0.1)
Seat 4: 2769a057 folded before Flop (didn't bet)
Seat 5: d037fd58 folded before Flop (didn't bet)
Seat 6: Hero folded before Flop (didn't bet)


Poker Hand #RC3141725107: Hold'em No Limit ($0.05/$0.1) - 2024/12/12 13:06:41
Table 'RushAndCash22320367' 6-max Seat #1 is the button
Seat 1: Hero ($10.32 in chips)
Seat 2: 29559048 ($10.65 in chips)
Seat 3: 81834a2f ($17.24 in chips)
Seat 4: c5141ec9 ($14.45 in chips)
Seat 5: fd36d45d ($11.16 in chips)
Seat 6: 48f3df37 ($22.63 in chips)
29559048: posts small blind $0.05
81834a2f: posts big blind $0.1
*** HOLE CARDS ***
Dealt to Hero [6d 2s]
Dealt to 29559048 
Dealt to 81834a2f 
Dealt to c5141ec9 
Dealt to fd36d45d 
Dealt to 48f3df37 
c5141ec9: folds
fd36d45d: folds
48f3df37: folds
Hero: folds
29559048: folds
Uncalled bet ($0.05) returned to 81834a2f
*** SHOWDOWN ***
81834a2f collected $0.1 from pot
*** SUMMARY ***
Total pot $0.1 | Rake $0 | Jackpot $0 | Bingo $0 | Fortune $0 | Tax $0
Seat 1: Hero (button) folded before Flop (didn't bet)
Seat 2: 29559048 (small blind) folded before Flop
Seat 3: 81834a2f (big blind) collected ($0.1)
Seat 4: c5141ec9 folded before Flop (didn't bet)
Seat 5: fd36d45d folded before Flop (didn't bet)
Seat 6: 48f3df37 folded before Flop (didn't bet)


Poker Hand #RC3141725091: Hold'em No Limit ($0.05/$0.1) - 2024/12/12 13:06:38
Table 'RushAndCash22320351' 6-max Seat #1 is the button
Seat 1: a212e67a ($10 in chips)
Seat 2: dea1301e ($34.59 in chips)
Seat 3: 1d8dcfab ($33.54 in chips)
Seat 4: 84c13d8 ($27.5 in chips)
Seat 5: 11a00985 ($17.82 in chips)
Seat 6: Hero ($10.32 in chips)
dea1301e: posts small blind $0.05
1d8dcfab: posts big blind $0.1
*** HOLE CARDS ***
Dealt to a212e67a 
Dealt to dea1301e 
Dealt to 1d8dcfab 
Dealt to 84c13d8 
Dealt to 11a00985 
Dealt to Hero [5h 6h]
84c13d8: raises $0.1 to $0.2
11a00985: folds
Hero: folds
a212e67a: folds
dea1301e: folds
1d8dcfab: folds
Uncalled bet ($0.1) returned to 84c13d8
*** SHOWDOWN ***
84c13d8 collected $0.25 from pot
*** SUMMARY ***
Total pot $0.25 | Rake $0 | Jackpot $0 | Bingo $0 | Fortune $0 | Tax $0
Seat 1: a212e67a (button) folded before Flop (didn't bet)
Seat 2: dea1301e (small blind) folded before Flop
Seat 3: 1d8dcfab (big blind) folded before Flop
Seat 4: 84c13d8 collected ($0.25)
Seat 5: 11a00985 folded before Flop (didn't bet)
Seat 6: Hero folded before Flop (didn't bet)


Poker Hand #RC3141725079: Hold'em No Limit ($0.05/$0.1) - 2024/12/12 13:06:35
Table 'RushAndCash22320339' 6-max Seat #1 is the button
Seat 1: 37686872 ($14.84 in chips)
Seat 2: 5c1d4f73 ($10.01 in chips)
Seat 3: Hero ($10.42 in chips)
Seat 4: 6a8aff3d ($38.92 in chips)
Seat 5: 1c087ec5 ($43.32 in chips)
Seat 6: 902b9d1a ($9.53 in chips)
5c1d4f73: posts small blind $0.05
Hero: posts big blind $0.1
*** HOLE CARDS ***
Dealt to 37686872 
Dealt to 5c1d4f73 
Dealt to Hero [5d Qc]
Dealt to 6a8aff3d 
Dealt to 1c087ec5 
Dealt to 902b9d1a 
6a8aff3d: folds
1c087ec5: folds
902b9d1a: raises $0.1 to $0.2
37686872: folds
5c1d4f73: folds
Hero: folds
Uncalled bet ($0.1) returned to 902b9d1a
*** SHOWDOWN ***
902b9d1a collected $0.25 from pot
*** SUMMARY ***
Total pot $0.25 | Rake $0 | Jackpot $0 | Bingo $0 | Fortune $0 | Tax $0
Seat 1: 37686872 (button) folded before Flop (didn't bet)
Seat 2: 5c1d4f73 (small blind) folded before Flop
Seat 3: Hero (big blind) folded before Flop
Seat 4: 6a8aff3d folded before Flop (didn't bet)
Seat 5: 1c087ec5 folded before Flop (didn't bet)
Seat 6: 902b9d1a collected ($0.25)


Poker Hand #RC3141725052: Hold'em No Limit ($0.05/$0.1) - 2024/12/12 13:06:28
Table 'RushAndCash22320312' 6-max Seat #1 is the button
Seat 1: d7f68c0e ($10 in chips)
Seat 2: Hero ($10.47 in chips)
Seat 3: 7f65d70 ($10.15 in chips)
Seat 4: 2441c176 ($12.75 in chips)
Seat 5: 6a8aff3d ($38.92 in chips)
Seat 6: 2583ab41 ($10.73 in chips)
Hero: posts small blind $0.05
7f65d70: posts big blind $0.1
*** HOLE CARDS ***
Dealt to d7f68c0e 
Dealt to Hero [Jh 8h]
Dealt to 7f65d70 
Dealt to 2441c176 
Dealt to 6a8aff3d 
Dealt to 2583ab41 
2441c176: folds
6a8aff3d: folds
2583ab41: raises $0.15 to $0.25
d7f68c0e: folds
Hero: folds
7f65d70: folds
Uncalled bet ($0.15) returned to 2583ab41
*** SHOWDOWN ***
2583ab41 collected $0.25 from pot
*** SUMMARY ***
Total pot $0.25 | Rake $0 | Jackpot $0 | Bingo $0 | Fortune $0 | Tax $0
Seat 1: d7f68c0e (button) folded before Flop (didn't bet)
Seat 2: Hero (small blind) folded before Flop
Seat 3: 7f65d70 (big blind) folded before Flop
Seat 4: 2441c176 folded before Flop (didn't bet)
Seat 5: 6a8aff3d folded before Flop (didn't bet)
Seat 6: 2583ab41 collected ($0.25)


Poker Hand #RC3141725038: Hold'em No Limit ($0.05/$0.1) - 2024/12/12 13:06:24
Table 'RushAndCash22320298' 6-max Seat #1 is the button
Seat 1: 53a81839 ($7.65 in chips)
Seat 2: 14311dad ($10.1 in chips)
Seat 3: 7bad2adb ($10 in chips)
Seat 4: Hero ($10.47 in chips)
Seat 5: 721d2ee6 ($13.84 in chips)
Seat 6: 2746c1f0 ($12.99 in chips)
14311dad: posts small blind $0.05
7bad2adb: posts big blind $0.1
*** HOLE CARDS ***
Dealt to 53a81839 
Dealt to 14311dad 
Dealt to 7bad2adb 
Dealt to Hero [Td 8s]
Dealt to 721d2ee6 
Dealt to 2746c1f0 
Hero: folds
721d2ee6: folds
2746c1f0: folds
53a81839: folds
14311dad: folds
Uncalled bet ($0.05) returned to 7bad2adb
*** SHOWDOWN ***
7bad2adb collected $0.1 from pot
*** SUMMARY ***
Total pot $0.1 | Rake $0 | Jackpot $0 | Bingo $0 | Fortune $0 | Tax $0
Seat 1: 53a81839 (button) folded before Flop (didn't bet)
Seat 2: 14311dad (small blind) folded before Flop
Seat 3: 7bad2adb (big blind) collected ($0.1)
Seat 4: Hero folded before Flop (didn't bet)
Seat 5: 721d2ee6 folded before Flop (didn't bet)
Seat 6: 2746c1f0 folded before Flop (didn't bet)


Poker Hand #RC3141725026: Hold'em No Limit ($0.05/$0.1) - 2024/12/12 13:06:21
Table 'RushAndCash22320286' 6-max Seat #1 is the button
Seat 1: 264523b9 ($9.69 in chips)
Seat 2: 5e52a0de ($10 in chips)
Seat 3: 295cc1bc ($14.41 in chips)
Seat 4: Hero ($10.47 in chips)
Seat 5: 53a81839 ($7.65 in chips)
Seat 6: 14311dad ($10.1 in chips)
5e52a0de: posts small blind $0.05
295cc1bc: posts big blind $0.1
*** HOLE CARDS ***
Dealt to 264523b9 
Dealt to 5e52a0de 
Dealt to 295cc1bc 
Dealt to Hero [2c Kc]
Dealt to 53a81839 
Dealt to 14311dad 
Hero: folds
53a81839: folds
14311dad: folds
264523b9: folds
5e52a0de: folds
Uncalled bet ($0.05) returned to 295cc1bc
*** SHOWDOWN ***
295cc1bc collected $0.1 from pot
*** SUMMARY ***
Total pot $0.1 | Rake $0 | Jackpot $0 | Bingo $0 | Fortune $0 | Tax $0
Seat 1: 264523b9 (button) folded before Flop (didn't bet)
Seat 2: 5e52a0de (small blind) folded before Flop
Seat 3: 295cc1bc (big blind) collected ($0.1)
Seat 4: Hero folded before Flop (didn't bet)
Seat 5: 53a81839 folded before Flop (didn't bet)
Seat 6: 14311dad folded before Flop (didn't bet)


Poker Hand #RC3141725005: Hold'em No Limit ($0.05/$0.1) - 2024/12/12 13:06:15
Table 'RushAndCash22320265' 6-max Seat #1 is the button
Seat 1: 9ef3daf1 ($17.83 in chips)
Seat 2: 526323fa ($12.97 in chips)
Seat 3: 59363533 ($6.18 in chips)
Seat 4: 7d40d863 ($11.35 in chips)
Seat 5: 2746c1f0 ($12.99 in chips)
Seat 6: Hero ($10.47 in chips)
526323fa: posts small blind $0.05
59363533: posts big blind $0.1
*** HOLE CARDS ***
Dealt to 9ef3daf1 
Dealt to 526323fa 
Dealt to 59363533 
Dealt to 7d40d863 
Dealt to 2746c1f0 
Dealt to Hero [Qd Jc]
7d40d863: raises $0.1 to $0.2
2746c1f0: folds
Hero: folds
9ef3daf1: folds
526323fa: calls $0.15
59363533: folds
*** FLOP *** [Js 2h 3d]
526323fa: checks
7d40d863: checks
*** TURN *** [Js 2h 3d] [5s]
526323fa: bets $0.38
7d40d863: raises $0.63 to $1.01
526323fa: folds
Uncalled bet ($0.63) returned to 7d40d863
*** SHOWDOWN ***
7d40d863 collected $1.2 from pot
*** SUMMARY ***
Total pot $1.26 | Rake $0.06 | Jackpot $0 | Bingo $0 | Fortune $0 | Tax $0
Board [Js 2h 3d 5s]
Seat 1: 9ef3daf1 (button) folded before Flop (didn't bet)
Seat 2: 526323fa (small blind) folded on the Turn
Seat 3: 59363533 (big blind) folded before Flop
Seat 4: 7d40d863 won ($1.2)
Seat 5: 2746c1f0 folded before Flop (didn't bet)
Seat 6: Hero folded before Flop (didn't bet)


Poker Hand #RC3141724929: Hold'em No Limit ($0.05/$0.1) - 2024/12/12 13:05:56
Table 'RushAndCash22320189' 6-max Seat #1 is the button
Seat 1: 17b5c9c3 ($10.43 in chips)
Seat 2: Hero ($10.52 in chips)
Seat 3: bacbbd0c ($8.78 in chips)
Seat 4: 727f0a35 ($10.52 in chips)
Seat 5: 73d90cc7 ($10.72 in chips)
Seat 6: 8a31e4cb ($9.97 in chips)
Hero: posts small blind $0.05
bacbbd0c: posts big blind $0.1
*** HOLE CARDS ***
Dealt to 17b5c9c3 
Dealt to Hero [9c Kc]
Dealt to bacbbd0c 
Dealt to 727f0a35 
Dealt to 73d90cc7 
Dealt to 8a31e4cb 
727f0a35: folds
73d90cc7: folds
8a31e4cb: folds
17b5c9c3: raises $0.1 to $0.2
Hero: folds
bacbbd0c: folds
Uncalled bet ($0.1) returned to 17b5c9c3
*** SHOWDOWN ***
17b5c9c3 collected $0.25 from pot
*** SUMMARY ***
Total pot $0.25 | Rake $0 | Jackpot $0 | Bingo $0 | Fortune $0 | Tax $0
Seat 1: 17b5c9c3 (button) collected ($0.25)
Seat 2: Hero (small blind) folded before Flop
Seat 3: bacbbd0c (big blind) folded before Flop
Seat 4: 727f0a35 folded before Flop (didn't bet)
Seat 5: 73d90cc7 folded before Flop (didn't bet)
Seat 6: 8a31e4cb folded before Flop (didn't bet)


Poker Hand #RC3141724914: Hold'em No Limit ($0.05/$0.1) - 2024/12/12 13:05:52
Table 'RushAndCash22320174' 6-max Seat #1 is the button
Seat 1: bacbbd0c ($8.78 in chips)
Seat 2: 2ad815d2 ($7.96 in chips)
Seat 3: f879c2d8 ($11.09 in chips)
Seat 4: Hero ($10.52 in chips)
Seat 5: 481b7ef8 ($29.73 in chips)
Seat 6: 54a8e111 ($13.28 in chips)
2ad815d2: posts small blind $0.05
f879c2d8: posts big blind $0.1
*** HOLE CARDS ***
Dealt to bacbbd0c 
Dealt to 2ad815d2 
Dealt to f879c2d8 
Dealt to Hero [4h Qc]
Dealt to 481b7ef8 
Dealt to 54a8e111 
Hero: folds
481b7ef8: folds
54a8e111: folds
bacbbd0c: folds
2ad815d2: folds
Uncalled bet ($0.05) returned to f879c2d8
*** SHOWDOWN ***
f879c2d8 collected $0.1 from pot
*** SUMMARY ***
Total pot $0.1 | Rake $0 | Jackpot $0 | Bingo $0 | Fortune $0 | Tax $0
Seat 1: bacbbd0c (button) folded before Flop (didn't bet)
Seat 2: 2ad815d2 (small blind) folded before Flop
Seat 3: f879c2d8 (big blind) collected ($0.1)
Seat 4: Hero folded before Flop (didn't bet)
Seat 5: 481b7ef8 folded before Flop (didn't bet)
Seat 6: 54a8e111 folded before Flop (didn't bet)


Poker Hand #RC3141724900: Hold'em No Limit ($0.05/$0.1) - 2024/12/12 13:05:49
Table 'RushAndCash22320160' 6-max Seat #1 is the button
Seat 1: 645be922 ($10.05 in chips)
Seat 2: 593f64c7 ($2.47 in chips)
Seat 3: b8e03e64 ($10.99 in chips)
Seat 4: 54a8e111 ($13.28 in chips)
Seat 5: Hero ($10.52 in chips)
Seat 6: b73105eb ($10.15 in chips)
593f64c7: posts small blind $0.05
b8e03e64: posts big blind $0.1
*** HOLE CARDS ***
Dealt to 645be922 
Dealt to 593f64c7 
Dealt to b8e03e64 
Dealt to 54a8e111 
Dealt to Hero [Jc 5s]
Dealt to b73105eb 
54a8e111: folds
Hero: folds
b73105eb: folds
645be922: folds
593f64c7: raises $0.15 to $0.25
b8e03e64: folds
Uncalled bet ($0.15) returned to 593f64c7
*** SHOWDOWN ***
593f64c7 collected $0.2 from pot
*** SUMMARY ***
Total pot $0.2 | Rake $0 | Jackpot $0 | Bingo $0 | Fortune $0 | Tax $0
Seat 1: 645be922 (button) folded before Flop (didn't bet)
Seat 2: 593f64c7 (small blind) collected ($0.2)
Seat 3: b8e03e64 (big blind) folded before Flop
Seat 4: 54a8e111 folded before Flop (didn't bet)
Seat 5: Hero folded before Flop (didn't bet)
Seat 6: b73105eb folded before Flop (didn't bet)


Poker Hand #RC3141724877: Hold'em No Limit ($0.05/$0.1) - 2024/12/12 13:05:43
Table 'RushAndCash22320137' 6-max Seat #1 is the button
Seat 1: 84849e11 ($91.34 in chips)
Seat 2: 340255c5 ($10 in chips)
Seat 3: Hero ($10.62 in chips)
Seat 4: ebfcde93 ($10.15 in chips)
Seat 5: 645be922 ($10.05 in chips)
Seat 6: bacbbd0c ($8.63 in chips)
340255c5: posts small blind $0.05
Hero: posts big blind $0.1
*** HOLE CARDS ***
Dealt to 84849e11 
Dealt to 340255c5 
Dealt to Hero [9d 6c]
Dealt to ebfcde93 
Dealt to 645be922 
Dealt to bacbbd0c 
ebfcde93: folds
645be922: folds
bacbbd0c: raises $0.1 to $0.2
84849e11: folds
340255c5: folds
Hero: folds
Uncalled bet ($0.1) returned to bacbbd0c
*** SHOWDOWN ***
bacbbd0c collected $0.25 from pot
*** SUMMARY ***
Total pot $0.25 | Rake $0 | Jackpot $0 | Bingo $0 | Fortune $0 | Tax $0
Seat 1: 84849e11 (button) folded before Flop (didn't bet)
Seat 2: 340255c5 (small blind) folded before Flop
Seat 3: Hero (big blind) folded before Flop
Seat 4: ebfcde93 folded before Flop (didn't bet)
Seat 5: 645be922 folded before Flop (didn't bet)
Seat 6: bacbbd0c collected ($0.25)


Poker Hand #RC3141724864: Hold'em No Limit ($0.05/$0.1) - 2024/12/12 13:05:39
Table 'RushAndCash22320124' 6-max Seat #1 is the button
Seat 1: c75bf164 ($9.85 in chips)
Seat 2: 506e90c1 ($10.3 in chips)
Seat 3: d7f68c0e ($10 in chips)
Seat 4: Hero ($10.62 in chips)
Seat 5: cf8c7bd5 ($21.15 in chips)
Seat 6: b4bc8071 ($13.72 in chips)
506e90c1: posts small blind $0.05
d7f68c0e: posts big blind $0.1
*** HOLE CARDS ***
Dealt to c75bf164 
Dealt to 506e90c1 
Dealt to d7f68c0e 
Dealt to Hero [4s 7h]
Dealt to cf8c7bd5 
Dealt to b4bc8071 
Hero: folds
cf8c7bd5: folds
b4bc8071: raises $0.1 to $0.2
c75bf164: folds
506e90c1: folds
d7f68c0e: calls $0.1
*** FLOP *** [9c 8s Jh]
d7f68c0e: checks
b4bc8071: bets $0.15
d7f68c0e: calls $0.15
*** TURN *** [9c 8s Jh] [Qs]
d7f68c0e: checks
b4bc8071: bets $1.2
d7f68c0e: folds
Uncalled bet ($1.2) returned to b4bc8071
*** SHOWDOWN ***
b4bc8071 collected $0.72 from pot
*** SUMMARY ***
Total pot $0.75 | Rake $0.03 | Jackpot $0 | Bingo $0 | Fortune $0 | Tax $0
Board [9c 8s Jh Qs]
Seat 1: c75bf164 (button) folded before Flop (didn't bet)
Seat 2: 506e90c1 (small blind) folded before Flop
Seat 3: d7f68c0e (big blind) folded on the Turn
Seat 4: Hero folded before Flop (didn't bet)
Seat 5: cf8c7bd5 folded before Flop (didn't bet)
Seat 6: b4bc8071 won ($0.72)


Poker Hand #RC3141724847: Hold'em No Limit ($0.05/$0.1) - 2024/12/12 13:05:35
Table 'RushAndCash22320107' 6-max Seat #1 is the button
Seat 1: 1a8ef95a ($10.48 in chips)
Seat 2: 6c4ba3fb ($16.21 in chips)
Seat 3: 5c1d4f73 ($10.36 in chips)
Seat 4: bc2007a2 ($17.86 in chips)
Seat 5: ebfcde93 ($10 in chips)
Seat 6: Hero ($10.62 in chips)
6c4ba3fb: posts small blind $0.05
5c1d4f73: posts big blind $0.1
*** HOLE CARDS ***
Dealt to 1a8ef95a 
Dealt to 6c4ba3fb 
Dealt to 5c1d4f73 
Dealt to bc2007a2 
Dealt to ebfcde93 
Dealt to Hero [7c Qh]
bc2007a2: folds
ebfcde93: raises $0.12 to $0.22
Hero: folds
1a8ef95a: folds
6c4ba3fb: folds
5c1d4f73: folds
Uncalled bet ($0.12) returned to ebfcde93
*** SHOWDOWN ***
ebfcde93 collected $0.25 from pot
*** SUMMARY ***
Total pot $0.25 | Rake $0 | Jackpot $0 | Bingo $0 | Fortune $0 | Tax $0
Seat 1: 1a8ef95a (button) folded before Flop (didn't bet)
Seat 2: 6c4ba3fb (small blind) folded before Flop
Seat 3: 5c1d4f73 (big blind) folded before Flop
Seat 4: bc2007a2 folded before Flop (didn't bet)
Seat 5: ebfcde93 collected ($0.25)
Seat 6: Hero folded before Flop (didn't bet)


Poker Hand #RC3141724809: Hold'em No Limit ($0.05/$0.1) - 2024/12/12 13:05:25
Table 'RushAndCash22320069' 6-max Seat #1 is the button
Seat 1: Hero ($10.62 in chips)
Seat 2: 7ec40c0d ($12.91 in chips)
Seat 3: 84849e11 ($91.34 in chips)
Seat 4: 974940e1 ($10.37 in chips)
Seat 5: d7f68c0e ($10 in chips)
Seat 6: 47ae29b2 ($10 in chips)
7ec40c0d: posts small blind $0.05
84849e11: posts big blind $0.1
*** HOLE CARDS ***
Dealt to Hero [7d 9d]
Dealt to 7ec40c0d 
Dealt to 84849e11 
Dealt to 974940e1 
Dealt to d7f68c0e 
Dealt to 47ae29b2 
974940e1: folds
d7f68c0e: raises $0.15 to $0.25
47ae29b2: raises $0.5 to $0.75
Hero: folds
7ec40c0d: folds
84849e11: folds
d7f68c0e: folds
Uncalled bet ($0.5) returned to 47ae29b2
*** SHOWDOWN ***
47ae29b2 collected $0.62 from pot
*** SUMMARY ***
Total pot $0.65 | Rake $0.03 | Jackpot $0 | Bingo $0 | Fortune $0 | Tax $0
Seat 1: Hero (button) folded before Flop (didn't bet)
Seat 2: 7ec40c0d (small blind) folded before Flop
Seat 3: 84849e11 (big blind) folded before Flop
Seat 4: 974940e1 folded before Flop (didn't bet)
Seat 5: d7f68c0e folded before Flop
Seat 6: 47ae29b2 collected ($0.62)


Poker Hand #RC3141724798: Hold'em No Limit ($0.05/$0.1) - 2024/12/12 13:05:22
Table 'RushAndCash22320058' 6-max Seat #1 is the button
Seat 1: Hero ($10.62 in chips)
Seat 2: 101c026b ($29.07 in chips)
Seat 3: 637471ad ($10.57 in chips)
Seat 4: 41ad32d3 ($11.01 in chips)
Seat 5: 84849e11 ($91.34 in chips)
Seat 6: 3f7822ab ($20.19 in chips)
101c026b: posts small blind $0.05
637471ad: posts big blind $0.1
*** HOLE CARDS ***
Dealt to Hero [6c Js]
Dealt to 101c026b 
Dealt to 637471ad 
Dealt to 41ad32d3 
Dealt to 84849e11 
Dealt to 3f7822ab 
41ad32d3: raises $0.1 to $0.2
84849e11: folds
3f7822ab: folds
Hero: folds
101c026b: folds
637471ad: folds
Uncalled bet ($0.1) returned to 41ad32d3
*** SHOWDOWN ***
41ad32d3 collected $0.25 from pot
*** SUMMARY ***
Total pot $0.25 | Rake $0 | Jackpot $0 | Bingo $0 | Fortune $0 | Tax $0
Seat 1: Hero (button) folded before Flop (didn't bet)
Seat 2: 101c026b (small blind) folded before Flop
Seat 3: 637471ad (big blind) folded before Flop
Seat 4: 41ad32d3 collected ($0.25)
Seat 5: 84849e11 folded before Flop (didn't bet)
Seat 6: 3f7822ab folded before Flop (didn't bet)


Poker Hand #RC3141724783: Hold'em No Limit ($0.05/$0.1) - 2024/12/12 13:05:17
Table 'RushAndCash22320043' 6-max Seat #1 is the button
Seat 1: 637471ad ($10.57 in chips)
Seat 2: Hero ($10.67 in chips)
Seat 3: 78854bfa ($10.12 in chips)
Seat 4: 8424fd65 ($16.12 in chips)
Seat 5: 4d3004b8 ($18.94 in chips)
Seat 6: a2fc0fa3 ($10 in chips)
Hero: posts small blind $0.05
78854bfa: posts big blind $0.1
*** HOLE CARDS ***
Dealt to 637471ad 
Dealt to Hero [Jh 4c]
Dealt to 78854bfa 
Dealt to 8424fd65 
Dealt to 4d3004b8 
Dealt to a2fc0fa3 
8424fd65: raises $0.1 to $0.2
4d3004b8: folds
a2fc0fa3: folds
637471ad: folds
Hero: folds
78854bfa: folds
Uncalled bet ($0.1) returned to 8424fd65
*** SHOWDOWN ***
8424fd65 collected $0.25 from pot
*** SUMMARY ***
Total pot $0.25 | Rake $0 | Jackpot $0 | Bingo $0 | Fortune $0 | Tax $0
Seat 1: 637471ad (button) folded before Flop (didn't bet)
Seat 2: Hero (small blind) folded before Flop
Seat 3: 78854bfa (big blind) folded before Flop
Seat 4: 8424fd65 collected ($0.25)
Seat 5: 4d3004b8 folded before Flop (didn't bet)
Seat 6: a2fc0fa3 folded before Flop (didn't bet)


Poker Hand #RC3141724771: Hold'em No Limit ($0.05/$0.1) - 2024/12/12 13:05:14
Table 'RushAndCash22320031' 6-max Seat #1 is the button
Seat 1: 4e5c7119 ($14.4 in chips)
Seat 2: 7ee23c5e ($11.55 in chips)
Seat 3: Hero ($10.77 in chips)
Seat 4: 3b12e634 ($12.85 in chips)
Seat 5: 36e85ed3 ($12.41 in chips)
Seat 6: ce410800 ($22.34 in chips)
7ee23c5e: posts small blind $0.05
Hero: posts big blind $0.1
*** HOLE CARDS ***
Dealt to 4e5c7119 
Dealt to 7ee23c5e 
Dealt to Hero [7h 5s]
Dealt to 3b12e634 
Dealt to 36e85ed3 
Dealt to ce410800 
3b12e634: folds
36e85ed3: folds
ce410800: folds
4e5c7119: folds
7ee23c5e: raises $0.15 to $0.25
Hero: folds
Uncalled bet ($0.15) returned to 7ee23c5e
*** SHOWDOWN ***
7ee23c5e collected $0.2 from pot
*** SUMMARY ***
Total pot $0.2 | Rake $0 | Jackpot $0 | Bingo $0 | Fortune $0 | Tax $0
Seat 1: 4e5c7119 (button) folded before Flop (didn't bet)
Seat 2: 7ee23c5e (small blind) collected ($0.2)
Seat 3: Hero (big blind) folded before Flop
Seat 4: 3b12e634 folded before Flop (didn't bet)
Seat 5: 36e85ed3 folded before Flop (didn't bet)
Seat 6: ce410800 folded before Flop (didn't bet)


Poker Hand #RC3141724757: Hold'em No Limit ($0.05/$0.1) - 2024/12/12 13:05:10
Table 'RushAndCash22320017' 6-max Seat #1 is the button
Seat 1: b9ea8dd9 ($5.43 in chips)
Seat 2: c6352e1c ($10 in chips)
Seat 3: 718b4a9 ($13.58 in chips)
Seat 4: Hero ($10.77 in chips)
Seat 5: 5041f166 ($9.53 in chips)
Seat 6: af208717 ($10.67 in chips)
c6352e1c: posts small blind $0.05
718b4a9: posts big blind $0.1
*** HOLE CARDS ***
Dealt to b9ea8dd9 
Dealt to c6352e1c 
Dealt to 718b4a9 
Dealt to Hero [9d 6d]
Dealt to 5041f166 
Dealt to af208717 
Hero: folds
5041f166: folds
af208717: folds
b9ea8dd9: raises $0.1 to $0.2
c6352e1c: raises $0.72 to $0.92
718b4a9: folds
b9ea8dd9: folds
Uncalled bet ($0.72) returned to c6352e1c
*** SHOWDOWN ***
c6352e1c collected $0.48 from pot
*** SUMMARY ***
Total pot $0.5 | Rake $0.02 | Jackpot $0 | Bingo $0 | Fortune $0 | Tax $0
Seat 1: b9ea8dd9 (button) folded before Flop
Seat 2: c6352e1c (small blind) collected ($0.48)
Seat 3: 718b4a9 (big blind) folded before Flop
Seat 4: Hero folded before Flop (didn't bet)
Seat 5: 5041f166 folded before Flop (didn't bet)
Seat 6: af208717 folded before Flop (didn't bet)


Poker Hand #RC3141674707: Hold'em No Limit ($0.05/$0.1) - 2024/12/12 13:04:56
Table 'RushAndCash22319967' 6-max Seat #1 is the button
Seat 1: 216abb36 ($10.2 in chips)
Seat 2: c6786b68 ($13.12 in chips)
Seat 3: 5a1e5412 ($7.61 in chips)
Seat 4: 2769a057 ($10 in chips)
Seat 5: Hero ($10.97 in chips)
Seat 6: c4d674fe ($15.54 in chips)
c6786b68: posts small blind $0.05
5a1e5412: posts big blind $0.1
*** HOLE CARDS ***
Dealt to 216abb36 
Dealt to c6786b68 
Dealt to 5a1e5412 
Dealt to 2769a057 
Dealt to Hero [Kd Qh]
Dealt to c4d674fe 
2769a057: folds
Hero: raises $0.1 to $0.2
c4d674fe: raises $0.6 to $0.8
216abb36: folds
c6786b68: folds
5a1e5412: calls $0.7
Hero: folds
*** FLOP *** [5s Qd 6c]
5a1e5412: checks
c4d674fe: bets $0.9
5a1e5412: calls $0.9
*** TURN *** [5s Qd 6c] [8h]
5a1e5412: checks
c4d674fe: checks
*** RIVER *** [5s Qd 6c 8h] [Jh]
5a1e5412: checks
c4d674fe: checks
5a1e5412: shows [7s Qs] (Pair of Queens)
c4d674fe: shows [7d 8d] (Pair of Eights)
*** SHOWDOWN ***
5a1e5412 collected $3.33 from pot
*** SUMMARY ***
Total pot $3.65 | Rake $0.17 | Jackpot $0.15 | Bingo $0 | Fortune $0 | Tax $0
Board [5s Qd 6c 8h Jh]
Seat 1: 216abb36 (button) folded before Flop (didn't bet)
Seat 2: c6786b68 (small blind) folded before Flop
Seat 3: 5a1e5412 (big blind) showed [7s Qs] and won ($3.33) with Pair of Queens
Seat 4: 2769a057 folded before Flop (didn't bet)
Seat 5: Hero folded before Flop
Seat 6: c4d674fe showed [7d 8d] and lost with Pair of Eights


Poker Hand #RC3141674698: Hold'em No Limit ($0.05/$0.1) - 2024/12/12 13:04:53
Table 'RushAndCash22319958' 6-max Seat #1 is the button
Seat 1: 55e95fce ($11.44 in chips)
Seat 2: Hero ($11.02 in chips)
Seat 3: d827b781 ($12.27 in chips)
Seat 4: 6c4ba3fb ($16.86 in chips)
Seat 5: 226dbbb0 ($10.56 in chips)
Seat 6: c6352e1c ($10 in chips)
Hero: posts small blind $0.05
d827b781: posts big blind $0.1
*** HOLE CARDS ***
Dealt to 55e95fce 
Dealt to Hero [5d 3h]
Dealt to d827b781 
Dealt to 6c4ba3fb 
Dealt to 226dbbb0 
Dealt to c6352e1c 
6c4ba3fb: raises $0.2 to $0.3
226dbbb0: folds
c6352e1c: folds
55e95fce: folds
Hero: folds
d827b781: folds
Uncalled bet ($0.2) returned to 6c4ba3fb
*** SHOWDOWN ***
6c4ba3fb collected $0.25 from pot
*** SUMMARY ***
Total pot $0.25 | Rake $0 | Jackpot $0 | Bingo $0 | Fortune $0 | Tax $0
Seat 1: 55e95fce (button) folded before Flop (didn't bet)
Seat 2: Hero (small blind) folded before Flop
Seat 3: d827b781 (big blind) folded before Flop
Seat 4: 6c4ba3fb collected ($0.25)
Seat 5: 226dbbb0 folded before Flop (didn't bet)
Seat 6: c6352e1c folded before Flop (didn't bet)


Poker Hand #RC3141674687: Hold'em No Limit ($0.05/$0.1) - 2024/12/12 13:04:49
Table 'RushAndCash22319947' 6-max Seat #1 is the button
Seat 1: e40115b ($10.59 in chips)
Seat 2: 2e3105a5 ($10.12 in chips)
Seat 3: e2a23377 ($10 in chips)
Seat 4: d827b781 ($12.27 in chips)
Seat 5: 55e95fce ($11.44 in chips)
Seat 6: Hero ($11.02 in chips)
2e3105a5: posts small blind $0.05
e2a23377: posts big blind $0.1
*** HOLE CARDS ***
Dealt to e40115b 
Dealt to 2e3105a5 
Dealt to e2a23377 
Dealt to d827b781 
Dealt to 55e95fce 
Dealt to Hero [7c Js]
d827b781: folds
55e95fce: folds
Hero: folds
e40115b: folds
2e3105a5: raises $0.2 to $0.3
e2a23377: calls $0.2
*** FLOP *** [9h Jd 4c]
2e3105a5: bets $0.16
e2a23377: folds
Uncalled bet ($0.16) returned to 2e3105a5
*** SHOWDOWN ***
2e3105a5 collected $0.57 from pot
*** SUMMARY ***
Total pot $0.6 | Rake $0.03 | Jackpot $0 | Bingo $0 | Fortune $0 | Tax $0
Board [9h Jd 4c]
Seat 1: e40115b (button) folded before Flop (didn't bet)
Seat 2: 2e3105a5 (small blind) won ($0.57)
Seat 3: e2a23377 (big blind) folded on the Flop
Seat 4: d827b781 folded before Flop (didn't bet)
Seat 5: 55e95fce folded before Flop (didn't bet)
Seat 6: Hero folded before Flop (didn't bet)


Poker Hand #RC3141674480: Hold'em No Limit ($0.05/$0.1) - 2024/12/12 13:03:58
Table 'RushAndCash22319740' 6-max Seat #1 is the button
Seat 1: 643f85e7 ($11.39 in chips)
Seat 2: e3914f0b ($27.69 in chips)
Seat 3: Hero ($10.78 in chips)
Seat 4: 526323fa ($10.61 in chips)
Seat 5: fed024e0 ($10.58 in chips)
Seat 6: e6e1de59 ($11.3 in chips)
e3914f0b: posts small blind $0.05
Hero: posts big blind $0.1
*** HOLE CARDS ***
Dealt to 643f85e7 
Dealt to e3914f0b 
Dealt to Hero [8s Ac]
Dealt to 526323fa 
Dealt to fed024e0 
Dealt to e6e1de59 
526323fa: folds
fed024e0: folds
e6e1de59: folds
643f85e7: raises $0.11 to $0.21
e3914f0b: folds
Hero: calls $0.11
*** FLOP *** [6h 7c Tc]
Hero: checks
643f85e7: checks
*** TURN *** [6h 7c Tc] [9s]
Hero: checks
643f85e7: checks
*** RIVER *** [6h 7c Tc 9s] [Qh]
Hero: bets $0.3
643f85e7: folds
Uncalled bet ($0.3) returned to Hero
*** SHOWDOWN ***
Hero collected $0.45 from pot
*** SUMMARY ***
Total pot $0.47 | Rake $0.02 | Jackpot $0 | Bingo $0 | Fortune $0 | Tax $0
Board [6h 7c Tc 9s Qh]
Seat 1: 643f85e7 (button) folded on the River
Seat 2: e3914f0b (small blind) folded before Flop
Seat 3: Hero (big blind) won ($0.45)
Seat 4: 526323fa folded before Flop (didn't bet)
Seat 5: fed024e0 folded before Flop (didn't bet)
Seat 6: e6e1de59 folded before Flop (didn't bet)


Poker Hand #RC3141674413: Hold'em No Limit ($0.05/$0.1) - 2024/12/12 13:03:42
Table 'RushAndCash22319673' 6-max Seat #1 is the button
Seat 1: Hero ($11.03 in chips)
Seat 2: cc8462b1 ($11.54 in chips)
Seat 3: a1907a02 ($21.59 in chips)
Seat 4: c5b1fa72 ($12.14 in chips)
Seat 5: 17b5c9c3 ($11.21 in chips)
Seat 6: 47ae29b2 ($10.15 in chips)
cc8462b1: posts small blind $0.05
a1907a02: posts big blind $0.1
*** HOLE CARDS ***
Dealt to Hero [Ah 4h]
Dealt to cc8462b1 
Dealt to a1907a02 
Dealt to c5b1fa72 
Dealt to 17b5c9c3 
Dealt to 47ae29b2 
c5b1fa72: folds
17b5c9c3: folds
47ae29b2: folds
Hero: raises $0.15 to $0.25
cc8462b1: raises $0.65 to $0.9
a1907a02: folds
Hero: folds
Uncalled bet ($0.65) returned to cc8462b1
*** SHOWDOWN ***
cc8462b1 collected $0.57 from pot
*** SUMMARY ***
Total pot $0.6 | Rake $0.03 | Jackpot $0 | Bingo $0 | Fortune $0 | Tax $0
Seat 1: Hero (button) folded before Flop
Seat 2: cc8462b1 (small blind) collected ($0.57)
Seat 3: a1907a02 (big blind) folded before Flop
Seat 4: c5b1fa72 folded before Flop (didn't bet)
Seat 5: 17b5c9c3 folded before Flop (didn't bet)
Seat 6: 47ae29b2 folded before Flop (didn't bet)


Poker Hand #RC3141674310: Hold'em No Limit ($0.05/$0.1) - 2024/12/12 13:03:15
Table 'RushAndCash22319570' 6-max Seat #1 is the button
Seat 1: b738541f ($13.22 in chips)
Seat 2: c5b1fa72 ($11.86 in chips)
Seat 3: c44f394 ($10.72 in chips)
Seat 4: Hero ($11.23 in chips)
Seat 5: 4cf26e8f ($10 in chips)
Seat 6: 86ee8e36 ($29.56 in chips)
c5b1fa72: posts small blind $0.05
c44f394: posts big blind $0.1
*** HOLE CARDS ***
Dealt to b738541f 
Dealt to c5b1fa72 
Dealt to c44f394 
Dealt to Hero [Jh Jc]
Dealt to 4cf26e8f 
Dealt to 86ee8e36 
Hero: raises $0.1 to $0.2
4cf26e8f: folds
86ee8e36: folds
b738541f: folds
c5b1fa72: raises $0.63 to $0.83
c44f394: folds
Hero: folds
Uncalled bet ($0.63) returned to c5b1fa72
*** SHOWDOWN ***
c5b1fa72 collected $0.48 from pot
*** SUMMARY ***
Total pot $0.5 | Rake $0.02 | Jackpot $0 | Bingo $0 | Fortune $0 | Tax $0
Seat 1: b738541f (button) folded before Flop (didn't bet)
Seat 2: c5b1fa72 (small blind) collected ($0.48)
Seat 3: c44f394 (big blind) folded before Flop
Seat 4: Hero folded before Flop
Seat 5: 4cf26e8f folded before Flop (didn't bet)
Seat 6: 86ee8e36 folded before Flop (didn't bet)


Poker Hand #RC3141674298: Hold'em No Limit ($0.05/$0.1) - 2024/12/12 13:03:11
Table 'RushAndCash22319558' 6-max Seat #1 is the button
Seat 1: 2db5d1cb ($12.11 in chips)
Seat 2: 101c026b ($35.48 in chips)
Seat 3: 73e84fa ($29.77 in chips)
Seat 4: 5af0bdcb ($20.7 in chips)
Seat 5: d6b17ac7 ($15.86 in chips)
Seat 6: Hero ($11.23 in chips)
101c026b: posts small blind $0.05
73e84fa: posts big blind $0.1
*** HOLE CARDS ***
Dealt to 2db5d1cb 
Dealt to 101c026b 
Dealt to 73e84fa 
Dealt to 5af0bdcb 
Dealt to d6b17ac7 
Dealt to Hero [Kc 9h]
5af0bdcb: calls $0.1
d6b17ac7: calls $0.1
Hero: folds
2db5d1cb: calls $0.1
101c026b: folds
73e84fa: checks
*** FLOP *** [9s 6c Kd]
73e84fa: checks
5af0bdcb: checks
d6b17ac7: checks
2db5d1cb: checks
*** TURN *** [9s 6c Kd] [3s]
73e84fa: checks
5af0bdcb: bets $0.34
d6b17ac7: folds
2db5d1cb: calls $0.34
73e84fa: folds
*** RIVER *** [9s 6c Kd 3s] [Qh]
5af0bdcb: bets $0.38
2db5d1cb: folds
Uncalled bet ($0.38) returned to 5af0bdcb
*** SHOWDOWN ***
5af0bdcb collected $1.08 from pot
*** SUMMARY ***
Total pot $1.13 | Rake $0.05 | Jackpot $0 | Bingo $0 | Fortune $0 | Tax $0
Board [9s 6c Kd 3s Qh]
Seat 1: 2db5d1cb (button) folded on the River
Seat 2: 101c026b (small blind) folded before Flop
Seat 3: 73e84fa (big blind) folded on the Turn
Seat 4: 5af0bdcb won ($1.08)
Seat 5: d6b17ac7 folded on the Turn
Seat 6: Hero folded before Flop (didn't bet)


Poker Hand #RC3141674281: Hold'em No Limit ($0.05/$0.1) - 2024/12/12 13:03:07
Table 'RushAndCash22319541' 6-max Seat #1 is the button
Seat 1: 37c4dd3d ($10.88 in chips)
Seat 2: 37686872 ($13.64 in chips)
Seat 3: f564c212 ($10 in chips)
Seat 4: 66a73913 ($17.05 in chips)
Seat 5: Hero ($11.23 in chips)
Seat 6: bc092e13 ($11.14 in chips)
37686872: posts small blind $0.05
f564c212: posts big blind $0.1
*** HOLE CARDS ***
Dealt to 37c4dd3d 
Dealt to 37686872 
Dealt to f564c212 
Dealt to 66a73913 
Dealt to Hero [5h Tc]
Dealt to bc092e13 
66a73913: folds
Hero: folds
bc092e13: raises $0.1 to $0.2
37c4dd3d: folds
37686872: folds
f564c212: folds
Uncalled bet ($0.1) returned to bc092e13
*** SHOWDOWN ***
bc092e13 collected $0.25 from pot
*** SUMMARY ***
Total pot $0.25 | Rake $0 | Jackpot $0 | Bingo $0 | Fortune $0 | Tax $0
Seat 1: 37c4dd3d (button) folded before Flop (didn't bet)
Seat 2: 37686872 (small blind) folded before Flop
Seat 3: f564c212 (big blind) folded before Flop
Seat 4: 66a73913 folded before Flop (didn't bet)
Seat 5: Hero folded before Flop (didn't bet)
Seat 6: bc092e13 collected ($0.25)


Poker Hand #RC3141674244: Hold'em No Limit ($0.05/$0.1) - 2024/12/12 13:02:58
Table 'RushAndCash22319504' 6-max Seat #1 is the button
Seat 1: d4deed2f ($10.15 in chips)
Seat 2: 77907fc4 ($17.29 in chips)
Seat 3: c75bf164 ($10 in chips)
Seat 4: 2e3105a5 ($11.44 in chips)
Seat 5: 9dd125fd ($23.58 in chips)
Seat 6: Hero ($11.08 in chips)
77907fc4: posts small blind $0.05
c75bf164: posts big blind $0.1
*** HOLE CARDS ***
Dealt to d4deed2f 
Dealt to 77907fc4 
Dealt to c75bf164 
Dealt to 2e3105a5 
Dealt to 9dd125fd 
Dealt to Hero [As Kd]
2e3105a5: folds
9dd125fd: folds
Hero: raises $0.15 to $0.25
d4deed2f: folds
77907fc4: folds
c75bf164: folds
Uncalled bet ($0.15) returned to Hero
*** SHOWDOWN ***
Hero collected $0.25 from pot
*** SUMMARY ***
Total pot $0.25 | Rake $0 | Jackpot $0 | Bingo $0 | Fortune $0 | Tax $0
Seat 1: d4deed2f (button) folded before Flop (didn't bet)
Seat 2: 77907fc4 (small blind) folded before Flop
Seat 3: c75bf164 (big blind) folded before Flop
Seat 4: 2e3105a5 folded before Flop (didn't bet)
Seat 5: 9dd125fd folded before Flop (didn't bet)
Seat 6: Hero collected ($0.25)


Poker Hand #RC3141674225: Hold'em No Limit ($0.05/$0.1) - 2024/12/12 13:02:53
Table 'RushAndCash22319485' 6-max Seat #1 is the button
Seat 1: Hero ($11.08 in chips)
Seat 2: 36e85ed3 ($12.47 in chips)
Seat 3: 55e95fce ($11.93 in chips)
Seat 4: d827b781 ($12.29 in chips)
Seat 5: 77907fc4 ($17.29 in chips)
Seat 6: 2e3105a5 ($11.44 in chips)
36e85ed3: posts small blind $0.05
55e95fce: posts big blind $0.1
*** HOLE CARDS ***
Dealt to Hero [Kc 3s]
Dealt to 36e85ed3 
Dealt to 55e95fce 
Dealt to d827b781 
Dealt to 77907fc4 
Dealt to 2e3105a5 
d827b781: folds
77907fc4: folds
2e3105a5: folds
Hero: folds
36e85ed3: calls $0.05
55e95fce: checks
*** FLOP *** [2d 6d Js]
36e85ed3: checks
55e95fce: checks
*** TURN *** [2d 6d Js] [Ad]
36e85ed3: bets $0.1
55e95fce: folds
Uncalled bet ($0.1) returned to 36e85ed3
*** SHOWDOWN ***
36e85ed3 collected $0.19 from pot
*** SUMMARY ***
Total pot $0.2 | Rake $0.01 | Jackpot $0 | Bingo $0 | Fortune $0 | Tax $0
Board [2d 6d Js Ad]
Seat 1: Hero (button) folded before Flop (didn't bet)
Seat 2: 36e85ed3 (small blind) won ($0.19)
Seat 3: 55e95fce (big blind) folded on the Turn
Seat 4: d827b781 folded before Flop (didn't bet)
Seat 5: 77907fc4 folded before Flop (didn't bet)
Seat 6: 2e3105a5 folded before Flop (didn't bet)


Poker Hand #RC3141673916: Hold'em No Limit ($0.05/$0.1) - 2024/12/12 13:01:38
Table 'RushAndCash22319176' 6-max Seat #1 is the button
Seat 1: 5ddf2544 ($24.14 in chips)
Seat 2: Hero ($10 in chips)
Seat 3: 36e85ed3 ($13.67 in chips)
Seat 4: a88ccb70 ($1.94 in chips)
Seat 5: 1a8ef95a ($10.38 in chips)
Seat 6: 721d2ee6 ($14.66 in chips)
Hero: posts small blind $0.05
36e85ed3: posts big blind $0.1
*** HOLE CARDS ***
Dealt to 5ddf2544 
Dealt to Hero [Td 8d]
Dealt to 36e85ed3 
Dealt to a88ccb70 
Dealt to 1a8ef95a 
Dealt to 721d2ee6 
a88ccb70: folds
1a8ef95a: folds
721d2ee6: folds
5ddf2544: folds
Hero: raises $0.2 to $0.3
36e85ed3: calls $0.2
*** FLOP *** [Th 7c 6h]
Hero: checks
36e85ed3: checks
*** TURN *** [Th 7c 6h] [4c]
Hero: checks
36e85ed3: bets $0.3
Hero: calls $0.3
*** RIVER *** [Th 7c 6h 4c] [Ks]
Hero: checks
36e85ed3: bets $0.6
Hero: calls $0.6
36e85ed3: shows [7s 8s] (Pair of Sevens)
Hero: shows [Td 8d] (Pair of Tens)
*** SHOWDOWN ***
Hero collected $2.28 from pot
*** SUMMARY ***
Total pot $2.4 | Rake $0.12 | Jackpot $0 | Bingo $0 | Fortune $0 | Tax $0
Board [Th 7c 6h 4c Ks]
Seat 1: 5ddf2544 (button) folded before Flop (didn't bet)
Seat 2: Hero (small blind) showed [Td 8d] and won ($2.28) with Pair of Tens
Seat 3: 36e85ed3 (big blind) showed [7s 8s] and lost with Pair of Sevens
Seat 4: a88ccb70 folded before Flop (didn't bet)
Seat 5: 1a8ef95a folded before Flop (didn't bet)
Seat 6: 721d2ee6 folded before Flop (didn't bet)


Poker Hand #RC3141673750: Hold'em No Limit ($0.05/$0.1) - 2024/12/12 13:00:59
Table 'RushAndCash22319010' 6-max Seat #1 is the button
Seat 1: ff1406c1 ($16.48 in chips)
Seat 2: 12b883d0 ($28.39 in chips)
Seat 3: Hero ($10 in chips)
Seat 4: 4b9faa96 ($12.44 in chips)
Seat 5: 14311dad ($10 in chips)
Seat 6: fed024e0 ($10 in chips)
12b883d0: posts small blind $0.05
Hero: posts big blind $0.1
*** HOLE CARDS ***
Dealt to ff1406c1 
Dealt to 12b883d0 
Dealt to Hero [Ts Qd]
Dealt to 4b9faa96 
Dealt to 14311dad 
Dealt to fed024e0 
4b9faa96: raises $0.15 to $0.25
14311dad: folds
fed024e0: folds
ff1406c1: folds
12b883d0: folds
Hero: calls $0.15
*** FLOP *** [Jc Qc 2d]
Hero: checks
4b9faa96: bets $0.42
Hero: folds
Uncalled bet ($0.42) returned to 4b9faa96
*** SHOWDOWN ***
4b9faa96 collected $0.53 from pot
*** SUMMARY ***
Total pot $0.55 | Rake $0.02 | Jackpot $0 | Bingo $0 | Fortune $0 | Tax $0
Board [Jc Qc 2d]
Seat 1: ff1406c1 (button) folded before Flop (didn't bet)
Seat 2: 12b883d0 (small blind) folded before Flop
Seat 3: Hero (big blind) folded on the Flop
Seat 4: 4b9faa96 won ($0.53)
Seat 5: 14311dad folded before Flop (didn't bet)
Seat 6: fed024e0 folded before Flop (didn't bet)


Poker Hand #RC3141673733: Hold'em No Limit ($0.05/$0.1) - 2024/12/12 13:00:55
Table 'RushAndCash22318993' 6-max Seat #1 is the button
Seat 1: 65bfb346 ($26.21 in chips)
Seat 2: b8e03e64 ($15.6 in chips)
Seat 3: 1e0385e8 ($10 in chips)
Seat 4: 5783aa3 ($11.44 in chips)
Seat 5: Hero ($10 in chips)
Seat 6: c199627b ($14.97 in chips)
b8e03e64: posts small blind $0.05
1e0385e8: posts big blind $0.1
*** HOLE CARDS ***
Dealt to 65bfb346 
Dealt to b8e03e64 
Dealt to 1e0385e8 
Dealt to 5783aa3 
Dealt to Hero [Qh 8d]
Dealt to c199627b 
5783aa3: folds
Hero: folds
c199627b: folds
65bfb346: raises $0.2 to $0.3
b8e03e64: folds
1e0385e8: folds
Uncalled bet ($0.2) returned to 65bfb346
*** SHOWDOWN ***
65bfb346 collected $0.25 from pot
*** SUMMARY ***
Total pot $0.25 | Rake $0 | Jackpot $0 | Bingo $0 | Fortune $0 | Tax $0
Seat 1: 65bfb346 (button) collected ($0.25)
Seat 2: b8e03e64 (small blind) folded before Flop
Seat 3: 1e0385e8 (big blind) folded before Flop
Seat 4: 5783aa3 folded before Flop (didn't bet)
Seat 5: Hero folded before Flop (didn't bet)
Seat 6: c199627b folded before Flop (didn't bet)


Poker Hand #RC3141673695: Hold'em No Limit ($0.05/$0.1) - 2024/12/12 13:00:47
Table 'RushAndCash22318955' 6-max Seat #1 is the button
Seat 1: 91e6eecf ($11.31 in chips)
Seat 2: 566d8ba0 ($12.53 in chips)
Seat 3: be2bfc8f ($10 in chips)
Seat 4: 79af8002 ($10 in chips)
Seat 5: 22ee6f58 ($10.26 in chips)
Seat 6: Hero ($10 in chips)
566d8ba0: posts small blind $0.05
be2bfc8f: posts big blind $0.1
*** HOLE CARDS ***
Dealt to 91e6eecf 
Dealt to 566d8ba0 
Dealt to be2bfc8f 
Dealt to 79af8002 
Dealt to 22ee6f58 
Dealt to Hero [8h 7h]
79af8002: raises $0.1 to $0.2
22ee6f58: folds
Hero: folds
91e6eecf: folds
566d8ba0: folds
be2bfc8f: calls $0.1
*** FLOP *** [7s 6s 2d]
be2bfc8f: checks
79af8002: checks
*** TURN *** [7s 6s 2d] [4h]
be2bfc8f: checks
79af8002: bets $0.34
be2bfc8f: calls $0.34
*** RIVER *** [7s 6s 2d 4h] [Ts]
be2bfc8f: checks
79af8002: checks
be2bfc8f: shows [6d Qd] (Pair of Sixes)
79af8002: shows [Kd Kh] (Pair of Kings)
*** SHOWDOWN ***
79af8002 collected $1.08 from pot
*** SUMMARY ***
Total pot $1.13 | Rake $0.05 | Jackpot $0 | Bingo $0 | Fortune $0 | Tax $0
Board [7s 6s 2d 4h Ts]
Seat 1: 91e6eecf (button) folded before Flop (didn't bet)
Seat 2: 566d8ba0 (small blind) folded before Flop
Seat 3: be2bfc8f (big blind) showed [6d Qd] and lost with Pair of Sixes
Seat 4: 79af8002 showed [Kd Kh] and won ($1.08) with Pair of Kings
Seat 5: 22ee6f58 folded before Flop (didn't bet)
Seat 6: Hero folded before Flop (didn't bet)


Poker Hand #RC3141673615: Hold'em No Limit ($0.05/$0.1) - 2024/12/12 13:00:27
Table 'RushAndCash22318875' 6-max Seat #1 is the button
Seat 1: e60f3780 ($12.39 in chips)
Seat 2: Hero ($10 in chips)
Seat 3: 6904b57e ($17.81 in chips)
Seat 4: cf64da1a ($22.42 in chips)
Seat 5: 3c75bc00 ($36.49 in chips)
Seat 6: d1764387 ($14.06 in chips)
Hero: posts small blind $0.05
6904b57e: posts big blind $0.1
*** HOLE CARDS ***
Dealt to e60f3780 
Dealt to Hero [8d 8h]
Dealt to 6904b57e 
Dealt to cf64da1a 
Dealt to 3c75bc00 
Dealt to d1764387 
cf64da1a: raises $0.1 to $0.2
3c75bc00: folds
d1764387: folds
e60f3780: folds
Hero: folds
6904b57e: calls $0.1
*** FLOP *** [Ks 7d 6d]
6904b57e: checks
cf64da1a: bets $0.2
6904b57e: calls $0.2
*** TURN *** [Ks 7d 6d] [6s]
6904b57e: checks
cf64da1a: checks
*** RIVER *** [Ks 7d 6d 6s] [Ac]
6904b57e: bets $0.64
cf64da1a: calls $0.64
6904b57e: shows [Ah Qd] (Pair of Aces and Pair of Sixes)
cf64da1a: shows [As Kd] (Pair of Aces and Pair of Kings)
*** SHOWDOWN ***
cf64da1a collected $2.03 from pot
*** SUMMARY ***
Total pot $2.13 | Rake $0.1 | Jackpot $0 | Bingo $0 | Fortune $0 | Tax $0
Board [Ks 7d 6d 6s Ac]
Seat 1: e60f3780 (button) folded before Flop (didn't bet)
Seat 2: Hero (small blind) folded before Flop
Seat 3: 6904b57e (big blind) showed [Ah Qd] and lost with Pair of Aces and Pair of Sixes
Seat 4: cf64da1a showed [As Kd] and won ($2.03) with Pair of Aces and Pair of Kings
Seat 5: 3c75bc00 folded before Flop (didn't bet)
Seat 6: d1764387 folded before Flop (didn't bet)


Poker Hand #RC3141673590: Hold'em No Limit ($0.05/$0.1) - 2024/12/12 13:00:21
Table 'RushAndCash22318850' 6-max Seat #1 is the button
Seat 1: dd68a104 ($11.02 in chips)
Seat 2: 1ecd1474 ($11.09 in chips)
Seat 3: Hero ($10.05 in chips)
Seat 4: 9b962a1c ($9.85 in chips)
Seat 5: b17f5bfe ($7.32 in chips)
Seat 6: bbe73ee2 ($12.69 in chips)
1ecd1474: posts small blind $0.05
Hero: posts big blind $0.1
*** HOLE CARDS ***
Dealt to dd68a104 
Dealt to 1ecd1474 
Dealt to Hero [Kc 7h]
Dealt to 9b962a1c 
Dealt to b17f5bfe 
Dealt to bbe73ee2 
9b962a1c: folds
b17f5bfe: calls $0.1
bbe73ee2: calls $0.1
dd68a104: raises $0.45 to $0.55
1ecd1474: folds
Hero: folds
b17f5bfe: folds
bbe73ee2: calls $0.45
*** FLOP *** [Qs Ah 2s]
bbe73ee2: checks
dd68a104: bets $1.02
bbe73ee2: folds
Uncalled bet ($1.02) returned to dd68a104
*** SHOWDOWN ***
dd68a104 collected $1.29 from pot
*** SUMMARY ***
Total pot $1.35 | Rake $0.06 | Jackpot $0 | Bingo $0 | Fortune $0 | Tax $0
Board [Qs Ah 2s]
Seat 1: dd68a104 (button) won ($1.29)
Seat 2: 1ecd1474 (small blind) folded before Flop
Seat 3: Hero (big blind) folded before Flop
Seat 4: 9b962a1c folded before Flop (didn't bet)
Seat 5: b17f5bfe folded before Flop
Seat 6: bbe73ee2 folded on the Flop


Poker Hand #RC3141673576: Hold'em No Limit ($0.05/$0.1) - 2024/12/12 13:00:17
Table 'RushAndCash22318836' 6-max Seat #1 is the button
Seat 1: b17f5bfe ($7.32 in chips)
Seat 2: 22ee6f58 ($10.41 in chips)
Seat 3: 4eb4d0d6 ($16.83 in chips)
Seat 4: Hero ($10.05 in chips)
Seat 5: 1e0385e8 ($10 in chips)
Seat 6: bbe73ee2 ($12.69 in chips)
22ee6f58: posts small blind $0.05
4eb4d0d6: posts big blind $0.1
*** HOLE CARDS ***
Dealt to b17f5bfe 
Dealt to 22ee6f58 
Dealt to 4eb4d0d6 
Dealt to Hero [9d 4c]
Dealt to 1e0385e8 
Dealt to bbe73ee2 
Hero: folds
1e0385e8: folds
bbe73ee2: folds
b17f5bfe: folds
22ee6f58: folds
Uncalled bet ($0.05) returned to 4eb4d0d6
*** SHOWDOWN ***
4eb4d0d6 collected $0.1 from pot
*** SUMMARY ***
Total pot $0.1 | Rake $0 | Jackpot $0 | Bingo $0 | Fortune $0 | Tax $0
Seat 1: b17f5bfe (button) folded before Flop (didn't bet)
Seat 2: 22ee6f58 (small blind) folded before Flop
Seat 3: 4eb4d0d6 (big blind) collected ($0.1)
Seat 4: Hero folded before Flop (didn't bet)
Seat 5: 1e0385e8 folded before Flop (didn't bet)
Seat 6: bbe73ee2 folded before Flop (didn't bet)


Poker Hand #RC3141673450: Hold'em No Limit ($0.05/$0.1) - 2024/12/12 12:59:45
Table 'RushAndCash22318710' 6-max Seat #1 is the button
Seat 1: Hero ($10.74 in chips)
Seat 2: 4eb4d0d6 ($16.11 in chips)
Seat 3: b9463896 ($11.65 in chips)
Seat 4: d09451f5 ($12.45 in chips)
Seat 5: ba2554d5 ($11.27 in chips)
Seat 6: 59363533 ($9.74 in chips)
4eb4d0d6: posts small blind $0.05
b9463896: posts big blind $0.1
*** HOLE CARDS ***
Dealt to Hero [Ks Qd]
Dealt to 4eb4d0d6 
Dealt to b9463896 
Dealt to d09451f5 
Dealt to ba2554d5 
Dealt to 59363533 
d09451f5: folds
ba2554d5: folds
59363533: folds
Hero: raises $0.15 to $0.25
4eb4d0d6: raises $0.44 to $0.69
b9463896: folds
Hero: calls $0.44
*** FLOP *** [5d 4c 8h]
4eb4d0d6: bets $0.74
Hero: folds
Uncalled bet ($0.74) returned to 4eb4d0d6
*** SHOWDOWN ***
4eb4d0d6 collected $1.41 from pot
*** SUMMARY ***
Total pot $1.48 | Rake $0.07 | Jackpot $0 | Bingo $0 | Fortune $0 | Tax $0
Board [5d 4c 8h]
Seat 1: Hero (button) folded on the Flop
Seat 2: 4eb4d0d6 (small blind) won ($1.41)
Seat 3: b9463896 (big blind) folded before Flop
Seat 4: d09451f5 folded before Flop (didn't bet)
Seat 5: ba2554d5 folded before Flop (didn't bet)
Seat 6: 59363533 folded before Flop (didn't bet)


Poker Hand #RC3141673436: Hold'em No Limit ($0.05/$0.1) - 2024/12/12 12:59:42
Table 'RushAndCash22318696' 6-max Seat #1 is the button
Seat 1: 84cc5caa ($10.49 in chips)
Seat 2: 4b9faa96 ($11.13 in chips)
Seat 3: b863ea8c ($22.4 in chips)
Seat 4: 721d2ee6 ($14.79 in chips)
Seat 5: Hero ($10.74 in chips)
Seat 6: 7829feb5 ($11.53 in chips)
4b9faa96: posts small blind $0.05
b863ea8c: posts big blind $0.1
*** HOLE CARDS ***
Dealt to 84cc5caa 
Dealt to 4b9faa96 
Dealt to b863ea8c 
Dealt to 721d2ee6 
Dealt to Hero [5c 9c]
Dealt to 7829feb5 
721d2ee6: folds
Hero: folds
7829feb5: folds
84cc5caa: folds
4b9faa96: folds
Uncalled bet ($0.05) returned to b863ea8c
*** SHOWDOWN ***
b863ea8c collected $0.1 from pot
*** SUMMARY ***
Total pot $0.1 | Rake $0 | Jackpot $0 | Bingo $0 | Fortune $0 | Tax $0
Seat 1: 84cc5caa (button) folded before Flop (didn't bet)
Seat 2: 4b9faa96 (small blind) folded before Flop
Seat 3: b863ea8c (big blind) collected ($0.1)
Seat 4: 721d2ee6 folded before Flop (didn't bet)
Seat 5: Hero folded before Flop (didn't bet)
Seat 6: 7829feb5 folded before Flop (didn't bet)


Poker Hand #RC3141673424: Hold'em No Limit ($0.05/$0.1) - 2024/12/12 12:59:38
Table 'RushAndCash22318684' 6-max Seat #1 is the button
Seat 1: 68283690 ($10 in chips)
Seat 2: a5767397 ($10.23 in chips)
Seat 3: 4f76bae1 ($10 in chips)
Seat 4: bc8cb2ed ($4.99 in chips)
Seat 5: 228a039d ($14 in chips)
Seat 6: Hero ($10.74 in chips)
a5767397: posts small blind $0.05
4f76bae1: posts big blind $0.1
*** HOLE CARDS ***
Dealt to 68283690 
Dealt to a5767397 
Dealt to 4f76bae1 
Dealt to bc8cb2ed 
Dealt to 228a039d 
Dealt to Hero [Qh 6c]
bc8cb2ed: folds
228a039d: folds
Hero: folds
68283690: raises $0.15 to $0.25
a5767397: folds
4f76bae1: folds
Uncalled bet ($0.15) returned to 68283690
*** SHOWDOWN ***
68283690 collected $0.25 from pot
*** SUMMARY ***
Total pot $0.25 | Rake $0 | Jackpot $0 | Bingo $0 | Fortune $0 | Tax $0
Seat 1: 68283690 (button) collected ($0.25)
Seat 2: a5767397 (small blind) folded before Flop
Seat 3: 4f76bae1 (big blind) folded before Flop
Seat 4: bc8cb2ed folded before Flop (didn't bet)
Seat 5: 228a039d folded before Flop (didn't bet)
Seat 6: Hero folded before Flop (didn't bet)


Poker Hand #RC3141673335: Hold'em No Limit ($0.05/$0.1) - 2024/12/12 12:59:16
Table 'RushAndCash22318595' 6-max Seat #1 is the button
Seat 1: Hero ($10.99 in chips)
Seat 2: a7936163 ($14.51 in chips)
Seat 3: bc8cb2ed ($4.71 in chips)
Seat 4: 84cc5caa ($10.64 in chips)
Seat 5: f08fe70 ($32.42 in chips)
Seat 6: a9eb45fc ($10.85 in chips)
a7936163: posts small blind $0.05
bc8cb2ed: posts big blind $0.1
*** HOLE CARDS ***
Dealt to Hero [Tc 9h]
Dealt to a7936163 
Dealt to bc8cb2ed 
Dealt to 84cc5caa 
Dealt to f08fe70 
Dealt to a9eb45fc 
84cc5caa: folds
f08fe70: folds
a9eb45fc: folds
Hero: raises $0.15 to $0.25
a7936163: folds
bc8cb2ed: raises $0.55 to $0.8
Hero: folds
Uncalled bet ($0.55) returned to bc8cb2ed
*** SHOWDOWN ***
bc8cb2ed collected $0.53 from pot
*** SUMMARY ***
Total pot $0.55 | Rake $0.02 | Jackpot $0 | Bingo $0 | Fortune $0 | Tax $0
Seat 1: Hero (button) folded before Flop
Seat 2: a7936163 (small blind) folded before Flop
Seat 3: bc8cb2ed (big blind) collected ($0.53)
Seat 4: 84cc5caa folded before Flop (didn't bet)
Seat 5: f08fe70 folded before Flop (didn't bet)
Seat 6: a9eb45fc folded before Flop (didn't bet)


Poker Hand #RC3141673168: Hold'em No Limit ($0.05/$0.1) - 2024/12/12 12:58:39
Table 'RushAndCash22318428' 6-max Seat #1 is the button
Seat 1: 566d8ba0 ($11.22 in chips)
Seat 2: 1677a3f4 ($15.19 in chips)
Seat 3: Hero ($11.19 in chips)
Seat 4: bc8cb2ed ($4.48 in chips)
Seat 5: 84849e11 ($102.09 in chips)
Seat 6: 2ff0a04b ($46.17 in chips)
1677a3f4: posts small blind $0.05
Hero: posts big blind $0.1
*** HOLE CARDS ***
Dealt to 566d8ba0 
Dealt to 1677a3f4 
Dealt to Hero [Kd Ts]
Dealt to bc8cb2ed 
Dealt to 84849e11 
Dealt to 2ff0a04b 
bc8cb2ed: raises $0.1 to $0.2
84849e11: folds
2ff0a04b: folds
566d8ba0: folds
1677a3f4: folds
Hero: calls $0.1
*** FLOP *** [Ah 7d Ac]
Hero: checks
bc8cb2ed: bets $0.23
Hero: folds
Uncalled bet ($0.23) returned to bc8cb2ed
*** SHOWDOWN ***
bc8cb2ed collected $0.43 from pot
*** SUMMARY ***
Total pot $0.45 | Rake $0.02 | Jackpot $0 | Bingo $0 | Fortune $0 | Tax $0
Board [Ah 7d Ac]
Seat 1: 566d8ba0 (button) folded before Flop (didn't bet)
Seat 2: 1677a3f4 (small blind) folded before Flop
Seat 3: Hero (big blind) folded on the Flop
Seat 4: bc8cb2ed won ($0.43)
Seat 5: 84849e11 folded before Flop (didn't bet)
Seat 6: 2ff0a04b folded before Flop (didn't bet)


Poker Hand #RC3141673143: Hold'em No Limit ($0.05/$0.1) - 2024/12/12 12:58:32
Table 'RushAndCash22318403' 6-max Seat #1 is the button
Seat 1: 53a81839 ($10 in chips)
Seat 2: Hero ($11.24 in chips)
Seat 3: 5a1e5412 ($9.29 in chips)
Seat 4: 61709362 ($10.26 in chips)
Seat 5: d037fd58 ($13.75 in chips)
Seat 6: c4d674fe ($10.37 in chips)
Hero: posts small blind $0.05
5a1e5412: posts big blind $0.1
*** HOLE CARDS ***
Dealt to 53a81839 
Dealt to Hero [7h As]
Dealt to 5a1e5412 
Dealt to 61709362 
Dealt to d037fd58 
Dealt to c4d674fe 
61709362: folds
d037fd58: folds
c4d674fe: folds
53a81839: raises $0.1 to $0.2
Hero: folds
5a1e5412: calls $0.1
*** FLOP *** [5c 5d 2d]
5a1e5412: checks
53a81839: checks
*** TURN *** [5c 5d 2d] [2h]
5a1e5412: checks
53a81839: bets $0.23
5a1e5412: folds
Uncalled bet ($0.23) returned to 53a81839
*** SHOWDOWN ***
53a81839 collected $0.43 from pot
*** SUMMARY ***
Total pot $0.45 | Rake $0.02 | Jackpot $0 | Bingo $0 | Fortune $0 | Tax $0
Board [5c 5d 2d 2h]
Seat 1: 53a81839 (button) won ($0.43)
Seat 2: Hero (small blind) folded before Flop
Seat 3: 5a1e5412 (big blind) folded on the Turn
Seat 4: 61709362 folded before Flop (didn't bet)
Seat 5: d037fd58 folded before Flop (didn't bet)
Seat 6: c4d674fe folded before Flop (didn't bet)


Poker Hand #RC3141673128: Hold'em No Limit ($0.05/$0.1) - 2024/12/12 12:58:29
Table 'RushAndCash22318388' 6-max Seat #1 is the button
Seat 1: afe10f69 ($10 in chips)
Seat 2: 59363533 ($10.34 in chips)
Seat 3: 8efbf75 ($10 in chips)
Seat 4: Hero ($11.24 in chips)
Seat 5: 916c6bd3 ($14.27 in chips)
Seat 6: 14311dad ($11.32 in chips)
59363533: posts small blind $0.05
8efbf75: posts big blind $0.1
*** HOLE CARDS ***
Dealt to afe10f69 
Dealt to 59363533 
Dealt to 8efbf75 
Dealt to Hero [2c Kd]
Dealt to 916c6bd3 
Dealt to 14311dad 
Hero: folds
916c6bd3: folds
14311dad: raises $0.13 to $0.23
afe10f69: folds
59363533: folds
8efbf75: folds
Uncalled bet ($0.13) returned to 14311dad
*** SHOWDOWN ***
14311dad collected $0.25 from pot
*** SUMMARY ***
Total pot $0.25 | Rake $0 | Jackpot $0 | Bingo $0 | Fortune $0 | Tax $0
Seat 1: afe10f69 (button) folded before Flop (didn't bet)
Seat 2: 59363533 (small blind) folded before Flop
Seat 3: 8efbf75 (big blind) folded before Flop
Seat 4: Hero folded before Flop (didn't bet)
Seat 5: 916c6bd3 folded before Flop (didn't bet)
Seat 6: 14311dad collected ($0.25)


Poker Hand #RC3141673113: Hold'em No Limit ($0.05/$0.1) - 2024/12/12 12:58:25
Table 'RushAndCash22318373' 6-max Seat #1 is the button
Seat 1: 5c1d4f73 ($11.52 in chips)
Seat 2: bc092e13 ($13.29 in chips)
Seat 3: fd36d45d ($13.62 in chips)
Seat 4: Hero ($11.24 in chips)
Seat 5: b4bc8071 ($10.41 in chips)
Seat 6: 24039de0 ($10.05 in chips)
bc092e13: posts small blind $0.05
fd36d45d: posts big blind $0.1
*** HOLE CARDS ***
Dealt to 5c1d4f73 
Dealt to bc092e13 
Dealt to fd36d45d 
Dealt to Hero [4d Td]
Dealt to b4bc8071 
Dealt to 24039de0 
Hero: folds
b4bc8071: folds
24039de0: folds
5c1d4f73: folds
bc092e13: raises $0.1 to $0.2
fd36d45d: folds
Uncalled bet ($0.1) returned to bc092e13
*** SHOWDOWN ***
bc092e13 collected $0.2 from pot
*** SUMMARY ***
Total pot $0.2 | Rake $0 | Jackpot $0 | Bingo $0 | Fortune $0 | Tax $0
Seat 1: 5c1d4f73 (button) folded before Flop (didn't bet)
Seat 2: bc092e13 (small blind) collected ($0.2)
Seat 3: fd36d45d (big blind) folded before Flop
Seat 4: Hero folded before Flop (didn't bet)
Seat 5: b4bc8071 folded before Flop (didn't bet)
Seat 6: 24039de0 folded before Flop (didn't bet)


Poker Hand #RC3141672711: Hold'em No Limit ($0.05/$0.1) - 2024/12/12 12:56:45
Table 'RushAndCash22317971' 6-max Seat #1 is the button
Seat 1: 2e3105a5 ($12.37 in chips)
Seat 2: 3f5e12f8 ($10 in chips)
Seat 3: e12528c0 ($31.59 in chips)
Seat 4: Hero ($13.12 in chips)
Seat 5: 8424fd65 ($15.63 in chips)
Seat 6: be885022 ($13.56 in chips)
3f5e12f8: posts small blind $0.05
e12528c0: posts big blind $0.1
*** HOLE CARDS ***
Dealt to 2e3105a5 
Dealt to 3f5e12f8 
Dealt to e12528c0 
Dealt to Hero [Qd Qs]
Dealt to 8424fd65 
Dealt to be885022 
Hero: raises $0.1 to $0.2
8424fd65: folds
be885022: raises $0.43 to $0.63
2e3105a5: folds
3f5e12f8: folds
e12528c0: folds
Hero: calls $0.43
*** FLOP *** [Th Jc 7c]
Hero: checks
be885022: bets $0.47
Hero: raises $0.78 to $1.25
be885022: raises $11.68 to $12.93 and is all-in
Hero: folds
Uncalled bet ($11.68) returned to be885022
*** SHOWDOWN ***
be885022 collected $3.58 from pot
*** SUMMARY ***
Total pot $3.91 | Rake $0.18 | Jackpot $0.15 | Bingo $0 | Fortune $0 | Tax $0
Board [Th Jc 7c]
Seat 1: 2e3105a5 (button) folded before Flop (didn't bet)
Seat 2: 3f5e12f8 (small blind) folded before Flop
Seat 3: e12528c0 (big blind) folded before Flop
Seat 4: Hero folded on the Flop
Seat 5: 8424fd65 folded before Flop (didn't bet)
Seat 6: be885022 won ($3.58)


Poker Hand #RC3141672697: Hold'em No Limit ($0.05/$0.1) - 2024/12/12 12:56:41
Table 'RushAndCash22317957' 6-max Seat #1 is the button
Seat 1: 59de94fc ($10.23 in chips)
Seat 2: 20a8d101 ($30.83 in chips)
Seat 3: b69e52ed ($13.37 in chips)
Seat 4: e7cd5db7 ($10.33 in chips)
Seat 5: 73d90cc7 ($12.93 in chips)
Seat 6: Hero ($13.12 in chips)
20a8d101: posts small blind $0.05
b69e52ed: posts big blind $0.1
*** HOLE CARDS ***
Dealt to 59de94fc 
Dealt to 20a8d101 
Dealt to b69e52ed 
Dealt to e7cd5db7 
Dealt to 73d90cc7 
Dealt to Hero [4h 8d]
e7cd5db7: folds
73d90cc7: folds
Hero: folds
59de94fc: folds
20a8d101: folds
Uncalled bet ($0.05) returned to b69e52ed
*** SHOWDOWN ***
b69e52ed collected $0.1 from pot
*** SUMMARY ***
Total pot $0.1 | Rake $0 | Jackpot $0 | Bingo $0 | Fortune $0 | Tax $0
Seat 1: 59de94fc (button) folded before Flop (didn't bet)
Seat 2: 20a8d101 (small blind) folded before Flop
Seat 3: b69e52ed (big blind) collected ($0.1)
Seat 4: e7cd5db7 folded before Flop (didn't bet)
Seat 5: 73d90cc7 folded before Flop (didn't bet)
Seat 6: Hero folded before Flop (didn't bet)


Poker Hand #RC3141672660: Hold'em No Limit ($0.05/$0.1) - 2024/12/12 12:56:32
Table 'RushAndCash22317920' 6-max Seat #1 is the button
Seat 1: 54a8e111 ($11.06 in chips)
Seat 2: Hero ($13.17 in chips)
Seat 3: cf8c7bd5 ($23.54 in chips)
Seat 4: 55e95fce ($10.15 in chips)
Seat 5: 97a1e12e ($10.94 in chips)
Seat 6: bbe73ee2 ($10.76 in chips)
Hero: posts small blind $0.05
cf8c7bd5: posts big blind $0.1
*** HOLE CARDS ***
Dealt to 54a8e111 
Dealt to Hero [2h 6c]
Dealt to cf8c7bd5 
Dealt to 55e95fce 
Dealt to 97a1e12e 
Dealt to bbe73ee2 
55e95fce: folds
97a1e12e: folds
bbe73ee2: folds
54a8e111: raises $0.14 to $0.24
Hero: folds
cf8c7bd5: calls $0.14
*** FLOP *** [5d 3c Ac]
cf8c7bd5: checks
54a8e111: checks
*** TURN *** [5d 3c Ac] [Qd]
cf8c7bd5: bets $0.4
54a8e111: folds
Uncalled bet ($0.4) returned to cf8c7bd5
*** SHOWDOWN ***
cf8c7bd5 collected $0.51 from pot
*** SUMMARY ***
Total pot $0.53 | Rake $0.02 | Jackpot $0 | Bingo $0 | Fortune $0 | Tax $0
Board [5d 3c Ac Qd]
Seat 1: 54a8e111 (button) folded on the Turn
Seat 2: Hero (small blind) folded before Flop
Seat 3: cf8c7bd5 (big blind) won ($0.51)
Seat 4: 55e95fce folded before Flop (didn't bet)
Seat 5: 97a1e12e folded before Flop (didn't bet)
Seat 6: bbe73ee2 folded before Flop (didn't bet)


Poker Hand #RC3141672646: Hold'em No Limit ($0.05/$0.1) - 2024/12/12 12:56:29
Table 'RushAndCash22317906' 6-max Seat #1 is the button
Seat 1: Hero ($13.17 in chips)
Seat 2: ce410800 ($19.6 in chips)
Seat 3: d037fd58 ($13.72 in chips)
Seat 4: 54a8e111 ($11.06 in chips)
Seat 5: 22ee6f58 ($10 in chips)
Seat 6: ee992e7e ($25.42 in chips)
ce410800: posts small blind $0.05
d037fd58: posts big blind $0.1
*** HOLE CARDS ***
Dealt to Hero [4s Td]
Dealt to ce410800 
Dealt to d037fd58 
Dealt to 54a8e111 
Dealt to 22ee6f58 
Dealt to ee992e7e 
54a8e111: folds
22ee6f58: folds
ee992e7e: folds
Hero: folds
ce410800: folds
Uncalled bet ($0.05) returned to d037fd58
*** SHOWDOWN ***
d037fd58 collected $0.1 from pot
*** SUMMARY ***
Total pot $0.1 | Rake $0 | Jackpot $0 | Bingo $0 | Fortune $0 | Tax $0
Seat 1: Hero (button) folded before Flop (didn't bet)
Seat 2: ce410800 (small blind) folded before Flop
Seat 3: d037fd58 (big blind) collected ($0.1)
Seat 4: 54a8e111 folded before Flop (didn't bet)
Seat 5: 22ee6f58 folded before Flop (didn't bet)
Seat 6: ee992e7e folded before Flop (didn't bet)


Poker Hand #RC3141672597: Hold'em No Limit ($0.05/$0.1) - 2024/12/12 12:56:15
Table 'RushAndCash22317857' 6-max Seat #1 is the button
Seat 1: 6ac23d86 ($11.45 in chips)
Seat 2: 41ef6e45 ($10.03 in chips)
Seat 3: Hero ($13.27 in chips)
Seat 4: 9ab5b010 ($24.13 in chips)
Seat 5: ff1406c1 ($11.88 in chips)
Seat 6: 35b5987 ($18.1 in chips)
41ef6e45: posts small blind $0.05
Hero: posts big blind $0.1
*** HOLE CARDS ***
Dealt to 6ac23d86 
Dealt to 41ef6e45 
Dealt to Hero [7c Kh]
Dealt to 9ab5b010 
Dealt to ff1406c1 
Dealt to 35b5987 
9ab5b010: folds
ff1406c1: folds
35b5987: folds
6ac23d86: folds
41ef6e45: calls $0.05
Hero: checks
*** FLOP *** [3c Qh Jd]
41ef6e45: checks
Hero: checks
*** TURN *** [3c Qh Jd] [3d]
41ef6e45: checks
Hero: checks
*** RIVER *** [3c Qh Jd 3d] [Th]
41ef6e45: bets $0.1
Hero: folds
Uncalled bet ($0.1) returned to 41ef6e45
*** SHOWDOWN ***
41ef6e45 collected $0.19 from pot
*** SUMMARY ***
Total pot $0.2 | Rake $0.01 | Jackpot $0 | Bingo $0 | Fortune $0 | Tax $0
Board [3c Qh Jd 3d Th]
Seat 1: 6ac23d86 (button) folded before Flop (didn't bet)
Seat 2: 41ef6e45 (small blind) won ($0.19)
Seat 3: Hero (big blind) folded on the River
Seat 4: 9ab5b010 folded before Flop (didn't bet)
Seat 5: ff1406c1 folded before Flop (didn't bet)
Seat 6: 35b5987 folded before Flop (didn't bet)


Poker Hand #RC3141672380: Hold'em No Limit ($0.05/$0.1) - 2024/12/12 12:55:19
Table 'RushAndCash22317640' 6-max Seat #1 is the button
Seat 1: 4cf26e8f ($10 in chips)
Seat 2: 406f58e4 ($10 in chips)
Seat 3: d9ccf407 ($10.06 in chips)
Seat 4: Hero ($12.69 in chips)
Seat 5: f2b49ec ($9.69 in chips)
Seat 6: 647dd971 ($7.82 in chips)
406f58e4: posts small blind $0.05
d9ccf407: posts big blind $0.1
*** HOLE CARDS ***
Dealt to 4cf26e8f 
Dealt to 406f58e4 
Dealt to d9ccf407 
Dealt to Hero [9c 9s]
Dealt to f2b49ec 
Dealt to 647dd971 
Hero: raises $0.1 to $0.2
f2b49ec: folds
647dd971: raises $0.28 to $0.48
4cf26e8f: folds
406f58e4: folds
d9ccf407: folds
Hero: calls $0.28
*** FLOP *** [Qc 7s Jc]
Hero: checks
647dd971: checks
*** TURN *** [Qc 7s Jc] [2h]
Hero: checks
647dd971: checks
*** RIVER *** [Qc 7s Jc 2h] [2d]
Hero: checks
647dd971: checks
Hero: shows [9c 9s] (Pair of Nines and Pair of Twos)
647dd971: shows [Ts Ah] (Pair of Twos)
*** SHOWDOWN ***
Hero collected $1.06 from pot
*** SUMMARY ***
Total pot $1.11 | Rake $0.05 | Jackpot $0 | Bingo $0 | Fortune $0 | Tax $0
Board [Qc 7s Jc 2h 2d]
Seat 1: 4cf26e8f (button) folded before Flop (didn't bet)
Seat 2: 406f58e4 (small blind) folded before Flop
Seat 3: d9ccf407 (big blind) folded before Flop
Seat 4: Hero showed [9c 9s] and won ($1.06) with Pair of Nines and Pair of Twos
Seat 5: f2b49ec folded before Flop (didn't bet)
Seat 6: 647dd971 showed [Ts Ah] and lost with Pair of Twos


Poker Hand #RC3141672364: Hold'em No Limit ($0.05/$0.1) - 2024/12/12 12:55:15
Table 'RushAndCash22317624' 6-max Seat #1 is the button
Seat 1: c279dad0 ($8.26 in chips)
Seat 2: c86d72c6 ($7.66 in chips)
Seat 3: e7cd5db7 ($10 in chips)
Seat 4: 3f7822ab ($18.11 in chips)
Seat 5: f347a136 ($10.45 in chips)
Seat 6: Hero ($12.69 in chips)
c86d72c6: posts small blind $0.05
e7cd5db7: posts big blind $0.1
*** HOLE CARDS ***
Dealt to c279dad0 
Dealt to c86d72c6 
Dealt to e7cd5db7 
Dealt to 3f7822ab 
Dealt to f347a136 
Dealt to Hero [7c 9c]
3f7822ab: folds
f347a136: folds
Hero: folds
c279dad0: folds
c86d72c6: folds
Uncalled bet ($0.05) returned to e7cd5db7
*** SHOWDOWN ***
e7cd5db7 collected $0.1 from pot
*** SUMMARY ***
Total pot $0.1 | Rake $0 | Jackpot $0 | Bingo $0 | Fortune $0 | Tax $0
Seat 1: c279dad0 (button) folded before Flop (didn't bet)
Seat 2: c86d72c6 (small blind) folded before Flop
Seat 3: e7cd5db7 (big blind) collected ($0.1)
Seat 4: 3f7822ab folded before Flop (didn't bet)
Seat 5: f347a136 folded before Flop (didn't bet)
Seat 6: Hero folded before Flop (didn't bet)


Poker Hand #RC3141672336: Hold'em No Limit ($0.05/$0.1) - 2024/12/12 12:55:08
Table 'RushAndCash22317596' 6-max Seat #1 is the button
Seat 1: 3a317c38 ($17.79 in chips)
Seat 2: ab081f1e ($10.05 in chips)
Seat 3: Hero ($12.79 in chips)
Seat 4: cc63da9c ($18.41 in chips)
Seat 5: 6904b57e ($10 in chips)
Seat 6: 23d20ac6 ($14.71 in chips)
ab081f1e: posts small blind $0.05
Hero: posts big blind $0.1
*** HOLE CARDS ***
Dealt to 3a317c38 
Dealt to ab081f1e 
Dealt to Hero [7h 2d]
Dealt to cc63da9c 
Dealt to 6904b57e 
Dealt to 23d20ac6 
cc63da9c: folds
6904b57e: folds
23d20ac6: folds
3a317c38: folds
ab081f1e: raises $0.1 to $0.2
Hero: folds
Uncalled bet ($0.1) returned to ab081f1e
*** SHOWDOWN ***
ab081f1e collected $0.2 from pot
*** SUMMARY ***
Total pot $0.2 | Rake $0 | Jackpot $0 | Bingo $0 | Fortune $0 | Tax $0
Seat 1: 3a317c38 (button) folded before Flop (didn't bet)
Seat 2: ab081f1e (small blind) collected ($0.2)
Seat 3: Hero (big blind) folded before Flop
Seat 4: cc63da9c folded before Flop (didn't bet)
Seat 5: 6904b57e folded before Flop (didn't bet)
Seat 6: 23d20ac6 folded before Flop (didn't bet)


Poker Hand #RC3141672307: Hold'em No Limit ($0.05/$0.1) - 2024/12/12 12:55:01
Table 'RushAndCash22317567' 6-max Seat #1 is the button
Seat 1: Hero ($12.79 in chips)
Seat 2: ed5538ab ($14.53 in chips)
Seat 3: 3f5e12f8 ($10.37 in chips)
Seat 4: 3f7822ab ($18.01 in chips)
Seat 5: 9ef3daf1 ($14.95 in chips)
Seat 6: 5041f166 ($12.11 in chips)
ed5538ab: posts small blind $0.05
3f5e12f8: posts big blind $0.1
*** HOLE CARDS ***
Dealt to Hero [As Jd]
Dealt to ed5538ab 
Dealt to 3f5e12f8 
Dealt to 3f7822ab 
Dealt to 9ef3daf1 
Dealt to 5041f166 
3f7822ab: raises $0.1 to $0.2
9ef3daf1: folds
5041f166: folds
Hero: folds
ed5538ab: folds
3f5e12f8: folds
Uncalled bet ($0.1) returned to 3f7822ab
*** SHOWDOWN ***
3f7822ab collected $0.25 from pot
*** SUMMARY ***
Total pot $0.25 | Rake $0 | Jackpot $0 | Bingo $0 | Fortune $0 | Tax $0
Seat 1: Hero (button) folded before Flop (didn't bet)
Seat 2: ed5538ab (small blind) folded before Flop
Seat 3: 3f5e12f8 (big blind) folded before Flop
Seat 4: 3f7822ab collected ($0.25)
Seat 5: 9ef3daf1 folded before Flop (didn't bet)
Seat 6: 5041f166 folded before Flop (didn't bet)


Poker Hand #RC3141672252: Hold'em No Limit ($0.05/$0.1) - 2024/12/12 12:54:49
Table 'RushAndCash22317512' 6-max Seat #1 is the button
Seat 1: 6c4ba3fb ($13.9 in chips)
Seat 2: Hero ($12.69 in chips)
Seat 3: ca4fa05a ($8 in chips)
Seat 4: dbcd9107 ($20.21 in chips)
Seat 5: 8499417 ($10.62 in chips)
Seat 6: c86d72c6 ($7.43 in chips)
Hero: posts small blind $0.05
ca4fa05a: posts big blind $0.1
*** HOLE CARDS ***
Dealt to 6c4ba3fb 
Dealt to Hero [4h 5h]
Dealt to ca4fa05a 
Dealt to dbcd9107 
Dealt to 8499417 
Dealt to c86d72c6 
dbcd9107: folds
8499417: folds
c86d72c6: folds
6c4ba3fb: folds
Hero: raises $0.2 to $0.3
ca4fa05a: folds
Uncalled bet ($0.2) returned to Hero
*** SHOWDOWN ***
Hero collected $0.2 from pot
*** SUMMARY ***
Total pot $0.2 | Rake $0 | Jackpot $0 | Bingo $0 | Fortune $0 | Tax $0
Seat 1: 6c4ba3fb (button) folded before Flop (didn't bet)
Seat 2: Hero (small blind) collected ($0.2)
Seat 3: ca4fa05a (big blind) folded before Flop
Seat 4: dbcd9107 folded before Flop (didn't bet)
Seat 5: 8499417 folded before Flop (didn't bet)
Seat 6: c86d72c6 folded before Flop (didn't bet)


Poker Hand #RC3141672240: Hold'em No Limit ($0.05/$0.1) - 2024/12/12 12:54:46
Table 'RushAndCash22317500' 6-max Seat #1 is the button
Seat 1: 7ec40c0d ($10.19 in chips)
Seat 2: c570720c ($14.39 in chips)
Seat 3: 7576a2e9 ($10.17 in chips)
Seat 4: 6c4ba3fb ($13.9 in chips)
Seat 5: Hero ($12.69 in chips)
Seat 6: 24039de0 ($10 in chips)
c570720c: posts small blind $0.05
7576a2e9: posts big blind $0.1
*** HOLE CARDS ***
Dealt to 7ec40c0d 
Dealt to c570720c 
Dealt to 7576a2e9 
Dealt to 6c4ba3fb 
Dealt to Hero [2s 3c]
Dealt to 24039de0 
6c4ba3fb: folds
Hero: folds
24039de0: folds
7ec40c0d: folds
c570720c: folds
Uncalled bet ($0.05) returned to 7576a2e9
*** SHOWDOWN ***
7576a2e9 collected $0.1 from pot
*** SUMMARY ***
Total pot $0.1 | Rake $0 | Jackpot $0 | Bingo $0 | Fortune $0 | Tax $0
Seat 1: 7ec40c0d (button) folded before Flop (didn't bet)
Seat 2: c570720c (small blind) folded before Flop
Seat 3: 7576a2e9 (big blind) collected ($0.1)
Seat 4: 6c4ba3fb folded before Flop (didn't bet)
Seat 5: Hero folded before Flop (didn't bet)
Seat 6: 24039de0 folded before Flop (didn't bet)


Poker Hand #RC3141672228: Hold'em No Limit ($0.05/$0.1) - 2024/12/12 12:54:42
Table 'RushAndCash22317488' 6-max Seat #1 is the button
Seat 1: 24039de0 ($10 in chips)
Seat 2: 8424fd65 ($15.93 in chips)
Seat 3: f4a6a825 ($10 in chips)
Seat 4: Hero ($12.69 in chips)
Seat 5: ee992e7e ($25.47 in chips)
Seat 6: 6c4ba3fb ($13.9 in chips)
8424fd65: posts small blind $0.05
f4a6a825: posts big blind $0.1
*** HOLE CARDS ***
Dealt to 24039de0 
Dealt to 8424fd65 
Dealt to f4a6a825 
Dealt to Hero [2c 8s]
Dealt to ee992e7e 
Dealt to 6c4ba3fb 
Hero: folds
ee992e7e: folds
6c4ba3fb: folds
24039de0: folds
8424fd65: folds
Uncalled bet ($0.05) returned to f4a6a825
*** SHOWDOWN ***
f4a6a825 collected $0.1 from pot
*** SUMMARY ***
Total pot $0.1 | Rake $0 | Jackpot $0 | Bingo $0 | Fortune $0 | Tax $0
Seat 1: 24039de0 (button) folded before Flop (didn't bet)
Seat 2: 8424fd65 (small blind) folded before Flop
Seat 3: f4a6a825 (big blind) collected ($0.1)
Seat 4: Hero folded before Flop (didn't bet)
Seat 5: ee992e7e folded before Flop (didn't bet)
Seat 6: 6c4ba3fb folded before Flop (didn't bet)


Poker Hand #RC3141672217: Hold'em No Limit ($0.05/$0.1) - 2024/12/12 12:54:39
Table 'RushAndCash22317477' 6-max Seat #1 is the button
Seat 1: 8ebad06f ($12.64 in chips)
Seat 2: 7ec40c0d ($10.24 in chips)
Seat 3: 24039de0 ($10.1 in chips)
Seat 4: d9ccf407 ($10.16 in chips)
Seat 5: a47e8f5 ($12.76 in chips)
Seat 6: Hero ($12.69 in chips)
7ec40c0d: posts small blind $0.05
24039de0: posts big blind $0.1
*** HOLE CARDS ***
Dealt to 8ebad06f 
Dealt to 7ec40c0d 
Dealt to 24039de0 
Dealt to d9ccf407 
Dealt to a47e8f5 
Dealt to Hero [Qh 2s]
d9ccf407: folds
a47e8f5: folds
Hero: folds
8ebad06f: folds
7ec40c0d: folds
Uncalled bet ($0.05) returned to 24039de0
*** SHOWDOWN ***
24039de0 collected $0.1 from pot
*** SUMMARY ***
Total pot $0.1 | Rake $0 | Jackpot $0 | Bingo $0 | Fortune $0 | Tax $0
Seat 1: 8ebad06f (button) folded before Flop (didn't bet)
Seat 2: 7ec40c0d (small blind) folded before Flop
Seat 3: 24039de0 (big blind) collected ($0.1)
Seat 4: d9ccf407 folded before Flop (didn't bet)
Seat 5: a47e8f5 folded before Flop (didn't bet)
Seat 6: Hero folded before Flop (didn't bet)


Poker Hand #RC3141672203: Hold'em No Limit ($0.05/$0.1) - 2024/12/12 12:54:36
Table 'RushAndCash22317463' 6-max Seat #1 is the button
Seat 1: Hero ($12.69 in chips)
Seat 2: 6dcb955a ($10 in chips)
Seat 3: d4deed2f ($10.22 in chips)
Seat 4: 1a8ef95a ($11.04 in chips)
Seat 5: 24039de0 ($10.1 in chips)
Seat 6: 8424fd65 ($15.93 in chips)
6dcb955a: posts small blind $0.05
d4deed2f: posts big blind $0.1
*** HOLE CARDS ***
Dealt to Hero [2h Qs]
Dealt to 6dcb955a 
Dealt to d4deed2f 
Dealt to 1a8ef95a 
Dealt to 24039de0 
Dealt to 8424fd65 
1a8ef95a: folds
24039de0: folds
8424fd65: folds
Hero: folds
6dcb955a: folds
Uncalled bet ($0.05) returned to d4deed2f
*** SHOWDOWN ***
d4deed2f collected $0.1 from pot
*** SUMMARY ***
Total pot $0.1 | Rake $0 | Jackpot $0 | Bingo $0 | Fortune $0 | Tax $0
Seat 1: Hero (button) folded before Flop (didn't bet)
Seat 2: 6dcb955a (small blind) folded before Flop
Seat 3: d4deed2f (big blind) collected ($0.1)
Seat 4: 1a8ef95a folded before Flop (didn't bet)
Seat 5: 24039de0 folded before Flop (didn't bet)
Seat 6: 8424fd65 folded before Flop (didn't bet)


Poker Hand #RC3141672164: Hold'em No Limit ($0.05/$0.1) - 2024/12/12 12:54:25
Table 'RushAndCash22317424' 6-max Seat #1 is the button
Seat 1: b0559006 ($8.62 in chips)
Seat 2: dbcd9107 ($20.31 in chips)
Seat 3: Hero ($12.79 in chips)
Seat 4: 4dd7bc95 ($10.98 in chips)
Seat 5: 71ddee08 ($11.2 in chips)
Seat 6: b4bc8071 ($10.4 in chips)
dbcd9107: posts small blind $0.05
Hero: posts big blind $0.1
*** HOLE CARDS ***
Dealt to b0559006 
Dealt to dbcd9107 
Dealt to Hero [2s 6c]
Dealt to 4dd7bc95 
Dealt to 71ddee08 
Dealt to b4bc8071 
4dd7bc95: raises $0.12 to $0.22
71ddee08: folds
b4bc8071: folds
b0559006: folds
dbcd9107: folds
Hero: folds
Uncalled bet ($0.12) returned to 4dd7bc95
*** SHOWDOWN ***
4dd7bc95 collected $0.25 from pot
*** SUMMARY ***
Total pot $0.25 | Rake $0 | Jackpot $0 | Bingo $0 | Fortune $0 | Tax $0
Seat 1: b0559006 (button) folded before Flop (didn't bet)
Seat 2: dbcd9107 (small blind) folded before Flop
Seat 3: Hero (big blind) folded before Flop
Seat 4: 4dd7bc95 collected ($0.25)
Seat 5: 71ddee08 folded before Flop (didn't bet)
Seat 6: b4bc8071 folded before Flop (didn't bet)


Poker Hand #RC3141671835: Hold'em No Limit ($0.05/$0.1) - 2024/12/12 12:53:01
Table 'RushAndCash22317095' 6-max Seat #1 is the button
Seat 1: 84cc5caa ($10 in chips)
Seat 2: e2a23377 ($10 in chips)
Seat 3: 719fb29e ($13.92 in chips)
Seat 4: b738541f ($12.28 in chips)
Seat 5: ee992e7e ($12.39 in chips)
Seat 6: Hero ($10.85 in chips)
e2a23377: posts small blind $0.05
719fb29e: posts big blind $0.1
*** HOLE CARDS ***
Dealt to 84cc5caa 
Dealt to e2a23377 
Dealt to 719fb29e 
Dealt to b738541f 
Dealt to ee992e7e 
Dealt to Hero [Ks Qs]
b738541f: raises $0.15 to $0.25
ee992e7e: folds
Hero: raises $0.49 to $0.74
84cc5caa: folds
e2a23377: folds
719fb29e: folds
b738541f: raises $1.41 to $2.15
Hero: calls $1.41
*** FLOP *** [Ad 8s 9d]
b738541f: checks
Hero: bets $2
b738541f: folds
Uncalled bet ($2) returned to Hero
b738541f: shows [Kc Kd] (Pair of Kings)
*** SHOWDOWN ***
Hero collected $4.09 from pot
*** SUMMARY ***
Total pot $4.45 | Rake $0.21 | Jackpot $0.15 | Bingo $0 | Fortune $0 | Tax $0
Board [Ad 8s 9d]
Seat 1: 84cc5caa (button) folded before Flop (didn't bet)
Seat 2: e2a23377 (small blind) folded before Flop
Seat 3: 719fb29e (big blind) folded before Flop
Seat 4: b738541f folded on the Flop
Seat 5: ee992e7e folded before Flop (didn't bet)
Seat 6: Hero won ($4.09)


Poker Hand #RC3141671785: Hold'em No Limit ($0.05/$0.1) - 2024/12/12 12:52:48
Table 'RushAndCash22317045' 6-max Seat #1 is the button
Seat 1: 4740c06b ($10.79 in chips)
Seat 2: Hero ($10.9 in chips)
Seat 3: 8a31e4cb ($18.53 in chips)
Seat 4: 3cdac696 ($8.53 in chips)
Seat 5: 74b4c8de ($9.85 in chips)
Seat 6: e896e324 ($10 in chips)
Hero: posts small blind $0.05
8a31e4cb: posts big blind $0.1
*** HOLE CARDS ***
Dealt to 4740c06b 
Dealt to Hero [Qh Kc]
Dealt to 8a31e4cb 
Dealt to 3cdac696 
Dealt to 74b4c8de 
Dealt to e896e324 
3cdac696: raises $0.1 to $0.2
74b4c8de: folds
e896e324: folds
4740c06b: folds
Hero: folds
8a31e4cb: calls $0.1
*** FLOP *** [6h 7d 3c]
8a31e4cb: checks
3cdac696: checks
*** TURN *** [6h 7d 3c] [Ts]
8a31e4cb: checks
3cdac696: bets $0.23
8a31e4cb: calls $0.23
*** RIVER *** [6h 7d 3c Ts] [4c]
8a31e4cb: checks
3cdac696: checks
8a31e4cb: shows [Kd 4d] (Pair of Fours)
3cdac696: shows [Tc Jc] (Pair of Tens)
*** SHOWDOWN ***
3cdac696 collected $0.87 from pot
*** SUMMARY ***
Total pot $0.91 | Rake $0.04 | Jackpot $0 | Bingo $0 | Fortune $0 | Tax $0
Board [6h 7d 3c Ts 4c]
Seat 1: 4740c06b (button) folded before Flop (didn't bet)
Seat 2: Hero (small blind) folded before Flop
Seat 3: 8a31e4cb (big blind) showed [Kd 4d] and lost with Pair of Fours
Seat 4: 3cdac696 showed [Tc Jc] and won ($0.87) with Pair of Tens
Seat 5: 74b4c8de folded before Flop (didn't bet)
Seat 6: e896e324 folded before Flop (didn't bet)


Poker Hand #RC3141671772: Hold'em No Limit ($0.05/$0.1) - 2024/12/12 12:52:44
Table 'RushAndCash22317032' 6-max Seat #1 is the button
Seat 1: 54d53a50 ($17.87 in chips)
Seat 2: 4740c06b ($10.84 in chips)
Seat 3: 6c4ba3fb ($11.46 in chips)
Seat 4: Hero ($10.9 in chips)
Seat 5: d6b17ac7 ($10.18 in chips)
Seat 6: 8d92b14e ($13.41 in chips)
4740c06b: posts small blind $0.05
6c4ba3fb: posts big blind $0.1
*** HOLE CARDS ***
Dealt to 54d53a50 
Dealt to 4740c06b 
Dealt to 6c4ba3fb 
Dealt to Hero [Kh 6h]
Dealt to d6b17ac7 
Dealt to 8d92b14e 
Hero: folds
d6b17ac7: folds
8d92b14e: folds
54d53a50: folds
4740c06b: folds
Uncalled bet ($0.05) returned to 6c4ba3fb
*** SHOWDOWN ***
6c4ba3fb collected $0.1 from pot
*** SUMMARY ***
Total pot $0.1 | Rake $0 | Jackpot $0 | Bingo $0 | Fortune $0 | Tax $0
Seat 1: 54d53a50 (button) folded before Flop (didn't bet)
Seat 2: 4740c06b (small blind) folded before Flop
Seat 3: 6c4ba3fb (big blind) collected ($0.1)
Seat 4: Hero folded before Flop (didn't bet)
Seat 5: d6b17ac7 folded before Flop (didn't bet)
Seat 6: 8d92b14e folded before Flop (didn't bet)


Poker Hand #RC3141671760: Hold'em No Limit ($0.05/$0.1) - 2024/12/12 12:52:41
Table 'RushAndCash22317020' 6-max Seat #1 is the button
Seat 1: 916c6bd3 ($9.44 in chips)
Seat 2: 24039de0 ($10.42 in chips)
Seat 3: 647dd971 ($7.3 in chips)
Seat 4: 38fd477d ($10 in chips)
Seat 5: f564c212 ($10 in chips)
Seat 6: Hero ($10.9 in chips)
24039de0: posts small blind $0.05
647dd971: posts big blind $0.1
*** HOLE CARDS ***
Dealt to 916c6bd3 
Dealt to 24039de0 
Dealt to 647dd971 
Dealt to 38fd477d 
Dealt to f564c212 
Dealt to Hero [6s Ts]
38fd477d: folds
f564c212: folds
Hero: folds
916c6bd3: raises $0.1 to $0.2
24039de0: folds
647dd971: folds
Uncalled bet ($0.1) returned to 916c6bd3
*** SHOWDOWN ***
916c6bd3 collected $0.25 from pot
*** SUMMARY ***
Total pot $0.25 | Rake $0 | Jackpot $0 | Bingo $0 | Fortune $0 | Tax $0
Seat 1: 916c6bd3 (button) collected ($0.25)
Seat 2: 24039de0 (small blind) folded before Flop
Seat 3: 647dd971 (big blind) folded before Flop
Seat 4: 38fd477d folded before Flop (didn't bet)
Seat 5: f564c212 folded before Flop (didn't bet)
Seat 6: Hero folded before Flop (didn't bet)


Poker Hand #RC3141671748: Hold'em No Limit ($0.05/$0.1) - 2024/12/12 12:52:38
Table 'RushAndCash22317008' 6-max Seat #1 is the button
Seat 1: 6c4ba3fb ($11.46 in chips)
Seat 2: 8a31e4cb ($18.58 in chips)
Seat 3: 3f908364 ($22.28 in chips)
Seat 4: Hero ($10.9 in chips)
Seat 5: 5af0bdcb ($10.73 in chips)
Seat 6: f879c2d8 ($12.64 in chips)
8a31e4cb: posts small blind $0.05
3f908364: posts big blind $0.1
*** HOLE CARDS ***
Dealt to 6c4ba3fb 
Dealt to 8a31e4cb 
Dealt to 3f908364 
Dealt to Hero [4h Qh]
Dealt to 5af0bdcb 
Dealt to f879c2d8 
Hero: folds
5af0bdcb: calls $0.1
f879c2d8: folds
6c4ba3fb: folds
8a31e4cb: folds
3f908364: raises $0.6 to $0.7
5af0bdcb: calls $0.6
*** FLOP *** [7d 5s 6d]
3f908364: bets $0.37
5af0bdcb: raises $1.1 to $1.47
3f908364: calls $1.1
*** TURN *** [7d 5s 6d] [8c]
3f908364: checks
5af0bdcb: checks
*** RIVER *** [7d 5s 6d 8c] [Ks]
3f908364: bets $20.11 and is all-in
5af0bdcb: calls $8.56 and is all-in
Uncalled bet ($11.55) returned to 3f908364
3f908364: shows [9c Kc] (Nines-High Straight)
5af0bdcb: shows [7s 9s] (Nines-High Straight)
*** SHOWDOWN ***
3f908364 collected $10.53 from pot
5af0bdcb collected $10.53 from pot
*** SUMMARY ***
Total pot $21.51 | Rake $0.3 | Jackpot $0.15 | Bingo $0 | Fortune $0 | Tax $0
Board [7d 5s 6d 8c Ks]
Seat 1: 6c4ba3fb (button) folded before Flop (didn't bet)
Seat 2: 8a31e4cb (small blind) folded before Flop
Seat 3: 3f908364 (big blind) showed [9c Kc] and won ($10.53) with Nines-High Straight
Seat 4: Hero folded before Flop (didn't bet)
Seat 5: 5af0bdcb showed [7s 9s] and won ($10.53) with Nines-High Straight
Seat 6: f879c2d8 folded before Flop (didn't bet)


Poker Hand #RC3141671732: Hold'em No Limit ($0.05/$0.1) - 2024/12/12 12:52:34
Table 'RushAndCash22316992' 6-max Seat #1 is the button
Seat 1: 1d37642 ($5.98 in chips)
Seat 2: Hero ($10.95 in chips)
Seat 3: 24c2159e ($10.75 in chips)
Seat 4: 2fb13304 ($10.86 in chips)
Seat 5: b82279c3 ($38.65 in chips)
Seat 6: e6eec7bb ($10 in chips)
Hero: posts small blind $0.05
24c2159e: posts big blind $0.1
*** HOLE CARDS ***
Dealt to 1d37642 
Dealt to Hero [5s 9d]
Dealt to 24c2159e 
Dealt to 2fb13304 
Dealt to b82279c3 
Dealt to e6eec7bb 
2fb13304: folds
b82279c3: folds
e6eec7bb: raises $0.15 to $0.25
1d37642: folds
Hero: folds
24c2159e: folds
Uncalled bet ($0.15) returned to e6eec7bb
*** SHOWDOWN ***
e6eec7bb collected $0.25 from pot
*** SUMMARY ***
Total pot $0.25 | Rake $0 | Jackpot $0 | Bingo $0 | Fortune $0 | Tax $0
Seat 1: 1d37642 (button) folded before Flop (didn't bet)
Seat 2: Hero (small blind) folded before Flop
Seat 3: 24c2159e (big blind) folded before Flop
Seat 4: 2fb13304 folded before Flop (didn't bet)
Seat 5: b82279c3 folded before Flop (didn't bet)
Seat 6: e6eec7bb collected ($0.25)


Poker Hand #RC3141671720: Hold'em No Limit ($0.05/$0.1) - 2024/12/12 12:52:31
Table 'RushAndCash22316980' 6-max Seat #1 is the button
Seat 1: b17f5bfe ($6.82 in chips)
Seat 2: 3896325a ($10.4 in chips)
Seat 3: Hero ($11.05 in chips)
Seat 4: 79af8002 ($10 in chips)
Seat 5: 2fb13304 ($10.86 in chips)
Seat 6: 6ac23d86 ($10 in chips)
3896325a: posts small blind $0.05
Hero: posts big blind $0.1
*** HOLE CARDS ***
Dealt to b17f5bfe 
Dealt to 3896325a 
Dealt to Hero [7s 9d]
Dealt to 79af8002 
Dealt to 2fb13304 
Dealt to 6ac23d86 
79af8002: folds
2fb13304: folds
6ac23d86: folds
b17f5bfe: raises $0.15 to $0.25
3896325a: folds
Hero: folds
Uncalled bet ($0.15) returned to b17f5bfe
*** SHOWDOWN ***
b17f5bfe collected $0.25 from pot
*** SUMMARY ***
Total pot $0.25 | Rake $0 | Jackpot $0 | Bingo $0 | Fortune $0 | Tax $0
Seat 1: b17f5bfe (button) collected ($0.25)
Seat 2: 3896325a (small blind) folded before Flop
Seat 3: Hero (big blind) folded before Flop
Seat 4: 79af8002 folded before Flop (didn't bet)
Seat 5: 2fb13304 folded before Flop (didn't bet)
Seat 6: 6ac23d86 folded before Flop (didn't bet)


Poker Hand #RC3141671697: Hold'em No Limit ($0.05/$0.1) - 2024/12/12 12:52:25
Table 'RushAndCash22316957' 6-max Seat #1 is the button
Seat 1: Hero ($11.05 in chips)
Seat 2: 4a1f9c37 ($7.4 in chips)
Seat 3: 8a55880e ($10 in chips)
Seat 4: 4746887d ($19.57 in chips)
Seat 5: ca49e84c ($11.93 in chips)
Seat 6: be2bfc8f ($10.15 in chips)
4a1f9c37: posts small blind $0.05
8a55880e: posts big blind $0.1
*** HOLE CARDS ***
Dealt to Hero [Js 9h]
Dealt to 4a1f9c37 
Dealt to 8a55880e 
Dealt to 4746887d 
Dealt to ca49e84c 
Dealt to be2bfc8f 
4746887d: folds
ca49e84c: folds
be2bfc8f: folds
Hero: folds
4a1f9c37: folds
Uncalled bet ($0.05) returned to 8a55880e
*** SHOWDOWN ***
8a55880e collected $0.1 from pot
*** SUMMARY ***
Total pot $0.1 | Rake $0 | Jackpot $0 | Bingo $0 | Fortune $0 | Tax $0
Seat 1: Hero (button) folded before Flop (didn't bet)
Seat 2: 4a1f9c37 (small blind) folded before Flop
Seat 3: 8a55880e (big blind) collected ($0.1)
Seat 4: 4746887d folded before Flop (didn't bet)
Seat 5: ca49e84c folded before Flop (didn't bet)
Seat 6: be2bfc8f folded before Flop (didn't bet)


Poker Hand #RC3141671682: Hold'em No Limit ($0.05/$0.1) - 2024/12/12 12:52:22
Table 'RushAndCash22316942' 6-max Seat #1 is the button
Seat 1: 8cfa2620 ($22.25 in chips)
Seat 2: 661d577b ($10.15 in chips)
Seat 3: 7a6f40ec ($10 in chips)
Seat 4: 86ee8e36 ($28 in chips)
Seat 5: 645be922 ($10 in chips)
Seat 6: Hero ($11.05 in chips)
661d577b: posts small blind $0.05
7a6f40ec: posts big blind $0.1
*** HOLE CARDS ***
Dealt to 8cfa2620 
Dealt to 661d577b 
Dealt to 7a6f40ec 
Dealt to 86ee8e36 
Dealt to 645be922 
Dealt to Hero [4h 7d]
86ee8e36: folds
645be922: folds
Hero: folds
8cfa2620: folds
661d577b: folds
Uncalled bet ($0.05) returned to 7a6f40ec
*** SHOWDOWN ***
7a6f40ec collected $0.1 from pot
*** SUMMARY ***
Total pot $0.1 | Rake $0 | Jackpot $0 | Bingo $0 | Fortune $0 | Tax $0
Seat 1: 8cfa2620 (button) folded before Flop (didn't bet)
Seat 2: 661d577b (small blind) folded before Flop
Seat 3: 7a6f40ec (big blind) collected ($0.1)
Seat 4: 86ee8e36 folded before Flop (didn't bet)
Seat 5: 645be922 folded before Flop (didn't bet)
Seat 6: Hero folded before Flop (didn't bet)


Poker Hand #RC3141671667: Hold'em No Limit ($0.05/$0.1) - 2024/12/12 12:52:17
Table 'RushAndCash22316927' 6-max Seat #1 is the button
Seat 1: 8fc49c26 ($42.71 in chips)
Seat 2: c05b084c ($10.2 in chips)
Seat 3: ec7ff353 ($10 in chips)
Seat 4: b863ea8c ($13.81 in chips)
Seat 5: Hero ($11.05 in chips)
Seat 6: e3914f0b ($26.37 in chips)
c05b084c: posts small blind $0.05
ec7ff353: posts big blind $0.1
*** HOLE CARDS ***
Dealt to 8fc49c26 
Dealt to c05b084c 
Dealt to ec7ff353 
Dealt to b863ea8c 
Dealt to Hero [Jd 4d]
Dealt to e3914f0b 
b863ea8c: folds
Hero: folds
e3914f0b: raises $0.1 to $0.2
8fc49c26: folds
c05b084c: folds
ec7ff353: calls $0.1
*** FLOP *** [Jh Qh 5s]
ec7ff353: checks
e3914f0b: bets $0.15
ec7ff353: calls $0.15
*** TURN *** [Jh Qh 5s] [Ac]
ec7ff353: checks
e3914f0b: bets $0.57
ec7ff353: calls $0.57
*** RIVER *** [Jh Qh 5s Ac] [Ts]
ec7ff353: checks
e3914f0b: checks
ec7ff353: shows [Td Ad] (Pair of Aces and Pair of Tens)
e3914f0b: shows [5d 5h] (Three Fives)
*** SHOWDOWN ***
e3914f0b collected $1.8 from pot
*** SUMMARY ***
Total pot $1.89 | Rake $0.09 | Jackpot $0 | Bingo $0 | Fortune $0 | Tax $0
Board [Jh Qh 5s Ac Ts]
Seat 1: 8fc49c26 (button) folded before Flop (didn't bet)
Seat 2: c05b084c (small blind) folded before Flop
Seat 3: ec7ff353 (big blind) showed [Td Ad] and lost with Pair of Aces and Pair of Tens
Seat 4: b863ea8c folded before Flop (didn't bet)
Seat 5: Hero folded before Flop (didn't bet)
Seat 6: e3914f0b showed [5d 5h] and won ($1.8) with Three Fives


Poker Hand #RC3141671654: Hold'em No Limit ($0.05/$0.1) - 2024/12/12 12:52:14
Table 'RushAndCash22316914' 6-max Seat #1 is the button
Seat 1: 727f0a35 ($13.03 in chips)
Seat 2: ff98cbcb ($23.44 in chips)
Seat 3: 61709362 ($10.34 in chips)
Seat 4: e3914f0b ($26.37 in chips)
Seat 5: Hero ($11.05 in chips)
Seat 6: 8fc49c26 ($42.71 in chips)
ff98cbcb: posts small blind $0.05
61709362: posts big blind $0.1
*** HOLE CARDS ***
Dealt to 727f0a35 
Dealt to ff98cbcb 
Dealt to 61709362 
Dealt to e3914f0b 
Dealt to Hero [Ts 5c]
Dealt to 8fc49c26 
e3914f0b: folds
Hero: folds
8fc49c26: folds
727f0a35: raises $0.2 to $0.3
ff98cbcb: folds
61709362: calls $0.2
*** FLOP *** [4s 7c 8h]
61709362: checks
727f0a35: checks
*** TURN *** [4s 7c 8h] [7d]
61709362: checks
727f0a35: bets $0.25
61709362: calls $0.25
*** RIVER *** [4s 7c 8h 7d] [8c]
61709362: bets $0.48
727f0a35: calls $0.48
61709362: shows [5h 4h] (Pair of Eights and Pair of Sevens)
727f0a35: shows [Js Ad] (Pair of Eights and Pair of Sevens)
*** SHOWDOWN ***
727f0a35 collected $2.01 from pot
*** SUMMARY ***
Total pot $2.11 | Rake $0.1 | Jackpot $0 | Bingo $0 | Fortune $0 | Tax $0
Board [4s 7c 8h 7d 8c]
Seat 1: 727f0a35 (button) showed [Js Ad] and won ($2.01) with Pair of Eights and Pair of Sevens
Seat 2: ff98cbcb (small blind) folded before Flop
Seat 3: 61709362 (big blind) showed [5h 4h] and lost with Pair of Eights and Pair of Sevens
Seat 4: e3914f0b folded before Flop (didn't bet)
Seat 5: Hero folded before Flop (didn't bet)
Seat 6: 8fc49c26 folded before Flop (didn't bet)


Poker Hand #RC3141671361: Hold'em No Limit ($0.05/$0.1) - 2024/12/12 12:50:57
Table 'RushAndCash22316621' 6-max Seat #1 is the button
Seat 1: deec756a ($11.42 in chips)
Seat 2: 721d2ee6 ($15.06 in chips)
Seat 3: aaca7529 ($6.95 in chips)
Seat 4: 499b4859 ($11.18 in chips)
Seat 5: ff98cbcb ($24.14 in chips)
Seat 6: Hero ($10.27 in chips)
721d2ee6: posts small blind $0.05
aaca7529: posts big blind $0.1
*** HOLE CARDS ***
Dealt to deec756a 
Dealt to 721d2ee6 
Dealt to aaca7529 
Dealt to 499b4859 
Dealt to ff98cbcb 
Dealt to Hero [Qs Qh]
499b4859: folds
ff98cbcb: raises $0.1 to $0.2
Hero: raises $0.5 to $0.7
deec756a: folds
721d2ee6: folds
aaca7529: folds
ff98cbcb: calls $0.5
*** FLOP *** [Qc 8h Js]
ff98cbcb: checks
Hero: checks
*** TURN *** [Qc 8h Js] [3d]
ff98cbcb: checks
Hero: bets $1
ff98cbcb: folds
Uncalled bet ($1) returned to Hero
*** SHOWDOWN ***
Hero collected $1.48 from pot
*** SUMMARY ***
Total pot $1.55 | Rake $0.07 | Jackpot $0 | Bingo $0 | Fortune $0 | Tax $0
Board [Qc 8h Js 3d]
Seat 1: deec756a (button) folded before Flop (didn't bet)
Seat 2: 721d2ee6 (small blind) folded before Flop
Seat 3: aaca7529 (big blind) folded before Flop
Seat 4: 499b4859 folded before Flop (didn't bet)
Seat 5: ff98cbcb folded on the Turn
Seat 6: Hero won ($1.48)


Poker Hand #RC3141671338: Hold'em No Limit ($0.05/$0.1) - 2024/12/12 12:50:52
Table 'RushAndCash22316598' 6-max Seat #1 is the button
Seat 1: c8e1bfcc ($9.72 in chips)
Seat 2: Hero ($10.32 in chips)
Seat 3: f04fb852 ($13.35 in chips)
Seat 4: 88133657 ($10.85 in chips)
Seat 5: b863ea8c ($13.94 in chips)
Seat 6: 78428b92 ($63.21 in chips)
Hero: posts small blind $0.05
f04fb852: posts big blind $0.1
*** HOLE CARDS ***
Dealt to c8e1bfcc 
Dealt to Hero [Ts 5s]
Dealt to f04fb852 
Dealt to 88133657 
Dealt to b863ea8c 
Dealt to 78428b92 
88133657: folds
b863ea8c: folds
78428b92: folds
c8e1bfcc: folds
Hero: folds
Uncalled bet ($0.05) returned to f04fb852
*** SHOWDOWN ***
f04fb852 collected $0.1 from pot
*** SUMMARY ***
Total pot $0.1 | Rake $0 | Jackpot $0 | Bingo $0 | Fortune $0 | Tax $0
Seat 1: c8e1bfcc (button) folded before Flop (didn't bet)
Seat 2: Hero (small blind) folded before Flop
Seat 3: f04fb852 (big blind) collected ($0.1)
Seat 4: 88133657 folded before Flop (didn't bet)
Seat 5: b863ea8c folded before Flop (didn't bet)
Seat 6: 78428b92 folded before Flop (didn't bet)


Poker Hand #RC3141671294: Hold'em No Limit ($0.05/$0.1) - 2024/12/12 12:50:41
Table 'RushAndCash22316554' 6-max Seat #1 is the button
Seat 1: 43eb8c8a ($10 in chips)
Seat 2: 5ab2e15d ($10.15 in chips)
Seat 3: Hero ($10.42 in chips)
Seat 4: df2e1f5d ($10.49 in chips)
Seat 5: 59de94fc ($11.99 in chips)
Seat 6: 6b0057b1 ($10 in chips)
5ab2e15d: posts small blind $0.05
Hero: posts big blind $0.1
*** HOLE CARDS ***
Dealt to 43eb8c8a 
Dealt to 5ab2e15d 
Dealt to Hero [Qh 4c]
Dealt to df2e1f5d 
Dealt to 59de94fc 
Dealt to 6b0057b1 
df2e1f5d: raises $0.15 to $0.25
59de94fc: folds
6b0057b1: folds
43eb8c8a: folds
5ab2e15d: raises $0.96 to $1.21
Hero: folds
df2e1f5d: calls $0.96
*** FLOP *** [6c 9s 4d]
5ab2e15d: checks
df2e1f5d: checks
*** TURN *** [6c 9s 4d] [Ks]
5ab2e15d: bets $1.8
df2e1f5d: folds
Uncalled bet ($1.8) returned to 5ab2e15d
*** SHOWDOWN ***
5ab2e15d collected $2.4 from pot
*** SUMMARY ***
Total pot $2.52 | Rake $0.12 | Jackpot $0 | Bingo $0 | Fortune $0 | Tax $0
Board [6c 9s 4d Ks]
Seat 1: 43eb8c8a (button) folded before Flop (didn't bet)
Seat 2: 5ab2e15d (small blind) won ($2.4)
Seat 3: Hero (big blind) folded before Flop
Seat 4: df2e1f5d folded on the Turn
Seat 5: 59de94fc folded before Flop (didn't bet)
Seat 6: 6b0057b1 folded before Flop (didn't bet)


Poker Hand #RC3141671278: Hold'em No Limit ($0.05/$0.1) - 2024/12/12 12:50:37
Table 'RushAndCash22316538' 6-max Seat #1 is the button
Seat 1: Hero ($10.42 in chips)
Seat 2: 4e5368fb ($8.92 in chips)
Seat 3: f1e9bea0 ($34.97 in chips)
Seat 4: c6786b68 ($16.23 in chips)
Seat 5: daa081a6 ($10.87 in chips)
Seat 6: 44a078c0 ($11.13 in chips)
4e5368fb: posts small blind $0.05
f1e9bea0: posts big blind $0.1
*** HOLE CARDS ***
Dealt to Hero [9s 5c]
Dealt to 4e5368fb 
Dealt to f1e9bea0 
Dealt to c6786b68 
Dealt to daa081a6 
Dealt to 44a078c0 
c6786b68: folds
daa081a6: folds
44a078c0: folds
Hero: folds
4e5368fb: raises $0.2 to $0.3
f1e9bea0: calls $0.2
*** FLOP *** [Jd 7s Th]
4e5368fb: bets $0.14
f1e9bea0: raises $0.66 to $0.8
4e5368fb: folds
Uncalled bet ($0.66) returned to f1e9bea0
*** SHOWDOWN ***
f1e9bea0 collected $0.84 from pot
*** SUMMARY ***
Total pot $0.88 | Rake $0.04 | Jackpot $0 | Bingo $0 | Fortune $0 | Tax $0
Board [Jd 7s Th]
Seat 1: Hero (button) folded before Flop (didn't bet)
Seat 2: 4e5368fb (small blind) folded on the Flop
Seat 3: f1e9bea0 (big blind) won ($0.84)
Seat 4: c6786b68 folded before Flop (didn't bet)
Seat 5: daa081a6 folded before Flop (didn't bet)
Seat 6: 44a078c0 folded before Flop (didn't bet)


Poker Hand #RC3141671264: Hold'em No Limit ($0.05/$0.1) - 2024/12/12 12:50:34
Table 'RushAndCash22316524' 6-max Seat #1 is the button
Seat 1: e3914f0b ($26.57 in chips)
Seat 2: ce410800 ($12.63 in chips)
Seat 3: 54d53a50 ($18.09 in chips)
Seat 4: Hero ($10.42 in chips)
Seat 5: daa081a6 ($10.87 in chips)
Seat 6: 44a078c0 ($11.13 in chips)
ce410800: posts small blind $0.05
54d53a50: posts big blind $0.1
*** HOLE CARDS ***
Dealt to e3914f0b 
Dealt to ce410800 
Dealt to 54d53a50 
Dealt to Hero [Jd 3c]
Dealt to daa081a6 
Dealt to 44a078c0 
Hero: folds
daa081a6: folds
44a078c0: folds
e3914f0b: raises $0.1 to $0.2
ce410800: folds
54d53a50: folds
Uncalled bet ($0.1) returned to e3914f0b
*** SHOWDOWN ***
e3914f0b collected $0.25 from pot
*** SUMMARY ***
Total pot $0.25 | Rake $0 | Jackpot $0 | Bingo $0 | Fortune $0 | Tax $0
Seat 1: e3914f0b (button) collected ($0.25)
Seat 2: ce410800 (small blind) folded before Flop
Seat 3: 54d53a50 (big blind) folded before Flop
Seat 4: Hero folded before Flop (didn't bet)
Seat 5: daa081a6 folded before Flop (didn't bet)
Seat 6: 44a078c0 folded before Flop (didn't bet)


Poker Hand #RC3141671249: Hold'em No Limit ($0.05/$0.1) - 2024/12/12 12:50:30
Table 'RushAndCash22316509' 6-max Seat #1 is the button
Seat 1: Hero ($10.42 in chips)
Seat 2: dbcd9107 ($19.47 in chips)
Seat 3: 28fac74e ($14.6 in chips)
Seat 4: 44a078c0 ($11.13 in chips)
Seat 5: 647dd971 ($7.94 in chips)
Seat 6: 1f54611 ($17.82 in chips)
dbcd9107: posts small blind $0.05
28fac74e: posts big blind $0.1
*** HOLE CARDS ***
Dealt to Hero [2s Ad]
Dealt to dbcd9107 
Dealt to 28fac74e 
Dealt to 44a078c0 
Dealt to 647dd971 
Dealt to 1f54611 
44a078c0: folds
647dd971: folds
1f54611: folds
Hero: folds
dbcd9107: folds
Uncalled bet ($0.05) returned to 28fac74e
*** SHOWDOWN ***
28fac74e collected $0.1 from pot
*** SUMMARY ***
Total pot $0.1 | Rake $0 | Jackpot $0 | Bingo $0 | Fortune $0 | Tax $0
Seat 1: Hero (button) folded before Flop (didn't bet)
Seat 2: dbcd9107 (small blind) folded before Flop
Seat 3: 28fac74e (big blind) collected ($0.1)
Seat 4: 44a078c0 folded before Flop (didn't bet)
Seat 5: 647dd971 folded before Flop (didn't bet)
Seat 6: 1f54611 folded before Flop (didn't bet)


Poker Hand #RC3141671214: Hold'em No Limit ($0.05/$0.1) - 2024/12/12 12:50:22
Table 'RushAndCash22316474' 6-max Seat #1 is the button
Seat 1: 3f1c4e6e ($14.21 in chips)
Seat 2: ba2554d5 ($10.45 in chips)
Seat 3: 272db4d7 ($19.84 in chips)
Seat 4: Hero ($10.42 in chips)
Seat 5: 5b14e7af ($24.72 in chips)
Seat 6: 8424fd65 ($16.52 in chips)
ba2554d5: posts small blind $0.05
272db4d7: posts big blind $0.1
*** HOLE CARDS ***
Dealt to 3f1c4e6e 
Dealt to ba2554d5 
Dealt to 272db4d7 
Dealt to Hero [Jh Tc]
Dealt to 5b14e7af 
Dealt to 8424fd65 
Hero: folds
5b14e7af: folds
8424fd65: raises $0.15 to $0.25
3f1c4e6e: raises $0.45 to $0.7
ba2554d5: folds
272db4d7: folds
8424fd65: folds
Uncalled bet ($0.45) returned to 3f1c4e6e
*** SHOWDOWN ***
3f1c4e6e collected $0.62 from pot
*** SUMMARY ***
Total pot $0.65 | Rake $0.03 | Jackpot $0 | Bingo $0 | Fortune $0 | Tax $0
Seat 1: 3f1c4e6e (button) collected ($0.62)
Seat 2: ba2554d5 (small blind) folded before Flop
Seat 3: 272db4d7 (big blind) folded before Flop
Seat 4: Hero folded before Flop (didn't bet)
Seat 5: 5b14e7af folded before Flop (didn't bet)
Seat 6: 8424fd65 folded before Flop


Poker Hand #RC3141670934: Hold'em No Limit ($0.05/$0.1) - 2024/12/12 12:49:11
Table 'RushAndCash22316194' 6-max Seat #1 is the button
Seat 1: a7936163 ($15.39 in chips)
Seat 2: Hero ($10.92 in chips)
Seat 3: ba2554d5 ($10 in chips)
Seat 4: bc8cb2ed ($10 in chips)
Seat 5: 3f1c4e6e ($15.11 in chips)
Seat 6: 8499417 ($10.15 in chips)
Hero: posts small blind $0.05
ba2554d5: posts big blind $0.1
*** HOLE CARDS ***
Dealt to a7936163 
Dealt to Hero [8s Ad]
Dealt to ba2554d5 
Dealt to bc8cb2ed 
Dealt to 3f1c4e6e 
Dealt to 8499417 
bc8cb2ed: folds
3f1c4e6e: folds
8499417: folds
a7936163: folds
Hero: raises $0.2 to $0.3
ba2554d5: calls $0.2
*** FLOP *** [4s 5s 9s]
Hero: checks
ba2554d5: checks
*** TURN *** [4s 5s 9s] [3s]
Hero: checks
ba2554d5: checks
*** RIVER *** [4s 5s 9s 3s] [Qs]
Hero: bets $0.2
ba2554d5: calls $0.2
Hero: shows [8s Ad] (Queen High Flush)
ba2554d5: shows [Ts Qd] (Queen High Flush)
*** SHOWDOWN ***
ba2554d5 collected $0.95 from pot
*** SUMMARY ***
Total pot $1 | Rake $0.05 | Jackpot $0 | Bingo $0 | Fortune $0 | Tax $0
Board [4s 5s 9s 3s Qs]
Seat 1: a7936163 (button) folded before Flop (didn't bet)
Seat 2: Hero (small blind) showed [8s Ad] and lost with Queen High Flush
Seat 3: ba2554d5 (big blind) showed [Ts Qd] and won ($0.95) with Queen High Flush
Seat 4: bc8cb2ed folded before Flop (didn't bet)
Seat 5: 3f1c4e6e folded before Flop (didn't bet)
Seat 6: 8499417 folded before Flop (didn't bet)


Poker Hand #RC3141670870: Hold'em No Limit ($0.05/$0.1) - 2024/12/12 12:48:54
Table 'RushAndCash22316130' 6-max Seat #1 is the button
Seat 1: c2b852ae ($11.02 in chips)
Seat 2: e60f3780 ($11.18 in chips)
Seat 3: Hero ($11.02 in chips)
Seat 4: 9a7505e ($14.16 in chips)
Seat 5: ae47099b ($17.8 in chips)
Seat 6: f564c212 ($10 in chips)
e60f3780: posts small blind $0.05
Hero: posts big blind $0.1
*** HOLE CARDS ***
Dealt to c2b852ae 
Dealt to e60f3780 
Dealt to Hero [5c 8h]
Dealt to 9a7505e 
Dealt to ae47099b 
Dealt to f564c212 
9a7505e: folds
ae47099b: folds
f564c212: folds
c2b852ae: raises $0.12 to $0.22
e60f3780: folds
Hero: folds
Uncalled bet ($0.12) returned to c2b852ae
*** SHOWDOWN ***
c2b852ae collected $0.25 from pot
*** SUMMARY ***
Total pot $0.25 | Rake $0 | Jackpot $0 | Bingo $0 | Fortune $0 | Tax $0
Seat 1: c2b852ae (button) collected ($0.25)
Seat 2: e60f3780 (small blind) folded before Flop
Seat 3: Hero (big blind) folded before Flop
Seat 4: 9a7505e folded before Flop (didn't bet)
Seat 5: ae47099b folded before Flop (didn't bet)
Seat 6: f564c212 folded before Flop (didn't bet)


Poker Hand #RC3141670858: Hold'em No Limit ($0.05/$0.1) - 2024/12/12 12:48:50
Table 'RushAndCash22316118' 6-max Seat #1 is the button
Seat 1: 542b35f9 ($9.85 in chips)
Seat 2: ae47099b ($17.85 in chips)
Seat 3: d1764387 ($15.47 in chips)
Seat 4: 874888c4 ($11.61 in chips)
Seat 5: 4b728c96 ($14.28 in chips)
Seat 6: Hero ($11.02 in chips)
ae47099b: posts small blind $0.05
d1764387: posts big blind $0.1
*** HOLE CARDS ***
Dealt to 542b35f9 
Dealt to ae47099b 
Dealt to d1764387 
Dealt to 874888c4 
Dealt to 4b728c96 
Dealt to Hero [Ac 3h]
874888c4: raises $0.1 to $0.2
4b728c96: folds
Hero: folds
542b35f9: calls $0.2
ae47099b: folds
d1764387: folds
*** FLOP *** [5c Jh 3c]
874888c4: bets $0.18
542b35f9: calls $0.18
*** TURN *** [5c Jh 3c] [Th]
874888c4: bets $0.68
542b35f9: folds
Uncalled bet ($0.68) returned to 874888c4
*** SHOWDOWN ***
874888c4 collected $0.87 from pot
*** SUMMARY ***
Total pot $0.91 | Rake $0.04 | Jackpot $0 | Bingo $0 | Fortune $0 | Tax $0
Board [5c Jh 3c Th]
Seat 1: 542b35f9 (button) folded on the Turn
Seat 2: ae47099b (small blind) folded before Flop
Seat 3: d1764387 (big blind) folded before Flop
Seat 4: 874888c4 won ($0.87)
Seat 5: 4b728c96 folded before Flop (didn't bet)
Seat 6: Hero folded before Flop (didn't bet)


Poker Hand #RC3141670845: Hold'em No Limit ($0.05/$0.1) - 2024/12/12 12:48:47
Table 'RushAndCash22316105' 6-max Seat #1 is the button
Seat 1: 1e25b5bb ($15.18 in chips)
Seat 2: 542b35f9 ($9.9 in chips)
Seat 3: 204f692c ($10 in chips)
Seat 4: 77162ce3 ($10.33 in chips)
Seat 5: Hero ($11.02 in chips)
Seat 6: ff98cbcb ($24.04 in chips)
542b35f9: posts small blind $0.05
204f692c: posts big blind $0.1
*** HOLE CARDS ***
Dealt to 1e25b5bb 
Dealt to 542b35f9 
Dealt to 204f692c 
Dealt to 77162ce3 
Dealt to Hero [5c 9h]
Dealt to ff98cbcb 
77162ce3: raises $0.15 to $0.25
Hero: folds
ff98cbcb: calls $0.25
1e25b5bb: folds
542b35f9: folds
204f692c: folds
*** FLOP *** [4c 4h 5h]
77162ce3: bets $0.33
ff98cbcb: folds
Uncalled bet ($0.33) returned to 77162ce3
*** SHOWDOWN ***
77162ce3 collected $0.62 from pot
*** SUMMARY ***
Total pot $0.65 | Rake $0.03 | Jackpot $0 | Bingo $0 | Fortune $0 | Tax $0
Board [4c 4h 5h]
Seat 1: 1e25b5bb (button) folded before Flop (didn't bet)
Seat 2: 542b35f9 (small blind) folded before Flop
Seat 3: 204f692c (big blind) folded before Flop
Seat 4: 77162ce3 won ($0.62)
Seat 5: Hero folded before Flop (didn't bet)
Seat 6: ff98cbcb folded on the Flop


Poker Hand #RC3141670832: Hold'em No Limit ($0.05/$0.1) - 2024/12/12 12:48:43
Table 'RushAndCash22316092' 6-max Seat #1 is the button
Seat 1: 721b66f0 ($10.37 in chips)
Seat 2: b738541f ($10.41 in chips)
Seat 3: f7ecedd7 ($16.09 in chips)
Seat 4: 8cfa2620 ($21.52 in chips)
Seat 5: a730cdce ($10.27 in chips)
Seat 6: Hero ($11.02 in chips)
b738541f: posts small blind $0.05
f7ecedd7: posts big blind $0.1
*** HOLE CARDS ***
Dealt to 721b66f0 
Dealt to b738541f 
Dealt to f7ecedd7 
Dealt to 8cfa2620 
Dealt to a730cdce 
Dealt to Hero [6d 5s]
8cfa2620: raises $0.1 to $0.2
a730cdce: folds
Hero: folds
721b66f0: folds
b738541f: folds
f7ecedd7: folds
Uncalled bet ($0.1) returned to 8cfa2620
*** SHOWDOWN ***
8cfa2620 collected $0.25 from pot
*** SUMMARY ***
Total pot $0.25 | Rake $0 | Jackpot $0 | Bingo $0 | Fortune $0 | Tax $0
Seat 1: 721b66f0 (button) folded before Flop (didn't bet)
Seat 2: b738541f (small blind) folded before Flop
Seat 3: f7ecedd7 (big blind) folded before Flop
Seat 4: 8cfa2620 collected ($0.25)
Seat 5: a730cdce folded before Flop (didn't bet)
Seat 6: Hero folded before Flop (didn't bet)


Poker Hand #RC3141670785: Hold'em No Limit ($0.05/$0.1) - 2024/12/12 12:48:31
Table 'RushAndCash22316045' 6-max Seat #1 is the button
Seat 1: cc63da9c ($14.97 in chips)
Seat 2: Hero ($11.07 in chips)
Seat 3: b8e03e64 ($11.08 in chips)
Seat 4: 1c087ec5 ($40.13 in chips)
Seat 5: 727ed023 ($10.62 in chips)
Seat 6: 88a9583f ($22.26 in chips)
Hero: posts small blind $0.05
b8e03e64: posts big blind $0.1
*** HOLE CARDS ***
Dealt to cc63da9c 
Dealt to Hero [8c 6c]
Dealt to b8e03e64 
Dealt to 1c087ec5 
Dealt to 727ed023 
Dealt to 88a9583f 
1c087ec5: folds
727ed023: raises $0.2 to $0.3
88a9583f: folds
cc63da9c: folds
Hero: folds
b8e03e64: folds
Uncalled bet ($0.2) returned to 727ed023
*** SHOWDOWN ***
727ed023 collected $0.25 from pot
*** SUMMARY ***
Total pot $0.25 | Rake $0 | Jackpot $0 | Bingo $0 | Fortune $0 | Tax $0
Seat 1: cc63da9c (button) folded before Flop (didn't bet)
Seat 2: Hero (small blind) folded before Flop
Seat 3: b8e03e64 (big blind) folded before Flop
Seat 4: 1c087ec5 folded before Flop (didn't bet)
Seat 5: 727ed023 collected ($0.25)
Seat 6: 88a9583f folded before Flop (didn't bet)


Poker Hand #RC3141670757: Hold'em No Limit ($0.05/$0.1) - 2024/12/12 12:48:23
Table 'RushAndCash22316017' 6-max Seat #1 is the button
Seat 1: 23d20ac6 ($17.34 in chips)
Seat 2: 556a8b26 ($16.32 in chips)
Seat 3: 2b1a7fe5 ($16.68 in chips)
Seat 4: Hero ($11.07 in chips)
Seat 5: 721d2ee6 ($15.26 in chips)
Seat 6: caa1a4d ($10 in chips)
556a8b26: posts small blind $0.05
2b1a7fe5: posts big blind $0.1
*** HOLE CARDS ***
Dealt to 23d20ac6 
Dealt to 556a8b26 
Dealt to 2b1a7fe5 
Dealt to Hero [7s 6s]
Dealt to 721d2ee6 
Dealt to caa1a4d 
Hero: folds
721d2ee6: raises $0.14 to $0.24
caa1a4d: folds
23d20ac6: folds
556a8b26: folds
2b1a7fe5: folds
Uncalled bet ($0.14) returned to 721d2ee6
*** SHOWDOWN ***
721d2ee6 collected $0.25 from pot
*** SUMMARY ***
Total pot $0.25 | Rake $0 | Jackpot $0 | Bingo $0 | Fortune $0 | Tax $0
Seat 1: 23d20ac6 (button) folded before Flop (didn't bet)
Seat 2: 556a8b26 (small blind) folded before Flop
Seat 3: 2b1a7fe5 (big blind) folded before Flop
Seat 4: Hero folded before Flop (didn't bet)
Seat 5: 721d2ee6 collected ($0.25)
Seat 6: caa1a4d folded before Flop (didn't bet)


Poker Hand #RC3141670732: Hold'em No Limit ($0.05/$0.1) - 2024/12/12 12:48:15
Table 'RushAndCash22315992' 6-max Seat #1 is the button
Seat 1: 77162ce3 ($10 in chips)
Seat 2: 24039de0 ($10.48 in chips)
Seat 3: Hero ($11.17 in chips)
Seat 4: b17f5bfe ($5.25 in chips)
Seat 5: 25c1f7d7 ($10 in chips)
Seat 6: 721d2ee6 ($15.26 in chips)
24039de0: posts small blind $0.05
Hero: posts big blind $0.1
*** HOLE CARDS ***
Dealt to 77162ce3 
Dealt to 24039de0 
Dealt to Hero [7d 5h]
Dealt to b17f5bfe 
Dealt to 25c1f7d7 
Dealt to 721d2ee6 
b17f5bfe: raises $0.1 to $0.2
25c1f7d7: folds
721d2ee6: folds
77162ce3: raises $0.52 to $0.72
24039de0: folds
Hero: folds
b17f5bfe: folds
Uncalled bet ($0.52) returned to 77162ce3
*** SHOWDOWN ***
77162ce3 collected $0.53 from pot
*** SUMMARY ***
Total pot $0.55 | Rake $0.02 | Jackpot $0 | Bingo $0 | Fortune $0 | Tax $0
Seat 1: 77162ce3 (button) collected ($0.53)
Seat 2: 24039de0 (small blind) folded before Flop
Seat 3: Hero (big blind) folded before Flop
Seat 4: b17f5bfe folded before Flop
Seat 5: 25c1f7d7 folded before Flop (didn't bet)
Seat 6: 721d2ee6 folded before Flop (didn't bet)


Poker Hand #RC3141670676: Hold'em No Limit ($0.05/$0.1) - 2024/12/12 12:48:00
Table 'RushAndCash22315936' 6-max Seat #1 is the button
Seat 1: Hero ($11.17 in chips)
Seat 2: 4684e24a ($19.19 in chips)
Seat 3: 1dc34506 ($14.68 in chips)
Seat 4: c4d674fe ($11.93 in chips)
Seat 5: 32014ea4 ($11.29 in chips)
Seat 6: 7829feb5 ($10.83 in chips)
4684e24a: posts small blind $0.05
1dc34506: posts big blind $0.1
*** HOLE CARDS ***
Dealt to Hero [7h Qh]
Dealt to 4684e24a 
Dealt to 1dc34506 
Dealt to c4d674fe 
Dealt to 32014ea4 
Dealt to 7829feb5 
c4d674fe: folds
32014ea4: raises $0.1 to $0.2
7829feb5: folds
Hero: folds
4684e24a: folds
1dc34506: calls $0.1
*** FLOP *** [3h Th Ah]
1dc34506: checks
32014ea4: bets $0.24
1dc34506: folds
Uncalled bet ($0.24) returned to 32014ea4
*** SHOWDOWN ***
32014ea4 collected $0.43 from pot
*** SUMMARY ***
Total pot $0.45 | Rake $0.02 | Jackpot $0 | Bingo $0 | Fortune $0 | Tax $0
Board [3h Th Ah]
Seat 1: Hero (button) folded before Flop (didn't bet)
Seat 2: 4684e24a (small blind) folded before Flop
Seat 3: 1dc34506 (big blind) folded on the Flop
Seat 4: c4d674fe folded before Flop (didn't bet)
Seat 5: 32014ea4 won ($0.43)
Seat 6: 7829feb5 folded before Flop (didn't bet)


Poker Hand #RC3141670627: Hold'em No Limit ($0.05/$0.1) - 2024/12/12 12:47:48
Table 'RushAndCash22315887' 6-max Seat #1 is the button
Seat 1: 755092ba ($11.58 in chips)
Seat 2: 84849e11 ($96.93 in chips)
Seat 3: 295cc1bc ($9.85 in chips)
Seat 4: Hero ($11.17 in chips)
Seat 5: a699d2de ($11.38 in chips)
Seat 6: 54d53a50 ($18.91 in chips)
84849e11: posts small blind $0.05
295cc1bc: posts big blind $0.1
*** HOLE CARDS ***
Dealt to 755092ba 
Dealt to 84849e11 
Dealt to 295cc1bc 
Dealt to Hero [Js Qc]
Dealt to a699d2de 
Dealt to 54d53a50 
Hero: folds
a699d2de: folds
54d53a50: folds
755092ba: folds
84849e11: folds
Uncalled bet ($0.05) returned to 295cc1bc
*** SHOWDOWN ***
295cc1bc collected $0.1 from pot
*** SUMMARY ***
Total pot $0.1 | Rake $0 | Jackpot $0 | Bingo $0 | Fortune $0 | Tax $0
Seat 1: 755092ba (button) folded before Flop (didn't bet)
Seat 2: 84849e11 (small blind) folded before Flop
Seat 3: 295cc1bc (big blind) collected ($0.1)
Seat 4: Hero folded before Flop (didn't bet)
Seat 5: a699d2de folded before Flop (didn't bet)
Seat 6: 54d53a50 folded before Flop (didn't bet)


Poker Hand #RC3141670613: Hold'em No Limit ($0.05/$0.1) - 2024/12/12 12:47:45
Table 'RushAndCash22315873' 6-max Seat #1 is the button
Seat 1: fed024e0 ($10.74 in chips)
Seat 2: ae47099b ($17.61 in chips)
Seat 3: 95e11761 ($11.97 in chips)
Seat 4: a699d2de ($11.38 in chips)
Seat 5: bb835227 ($11.74 in chips)
Seat 6: Hero ($11.17 in chips)
ae47099b: posts small blind $0.05
95e11761: posts big blind $0.1
*** HOLE CARDS ***
Dealt to fed024e0 
Dealt to ae47099b 
Dealt to 95e11761 
Dealt to a699d2de 
Dealt to bb835227 
Dealt to Hero [Qd 4c]
a699d2de: folds
bb835227: folds
Hero: folds
fed024e0: raises $0.15 to $0.25
ae47099b: folds
95e11761: folds
Uncalled bet ($0.15) returned to fed024e0
*** SHOWDOWN ***
fed024e0 collected $0.25 from pot
*** SUMMARY ***
Total pot $0.25 | Rake $0 | Jackpot $0 | Bingo $0 | Fortune $0 | Tax $0
Seat 1: fed024e0 (button) collected ($0.25)
Seat 2: ae47099b (small blind) folded before Flop
Seat 3: 95e11761 (big blind) folded before Flop
Seat 4: a699d2de folded before Flop (didn't bet)
Seat 5: bb835227 folded before Flop (didn't bet)
Seat 6: Hero folded before Flop (didn't bet)


Poker Hand #RC3141670601: Hold'em No Limit ($0.05/$0.1) - 2024/12/12 12:47:42
Table 'RushAndCash22315861' 6-max Seat #1 is the button
Seat 1: Hero ($11.17 in chips)
Seat 2: 80ebdd41 ($12.13 in chips)
Seat 3: 8a55880e ($10.49 in chips)
Seat 4: a699d2de ($11.38 in chips)
Seat 5: 81834a2f ($18.05 in chips)
Seat 6: 22e8274e ($14.06 in chips)
80ebdd41: posts small blind $0.05
8a55880e: posts big blind $0.1
*** HOLE CARDS ***
Dealt to Hero [3h 6h]
Dealt to 80ebdd41 
Dealt to 8a55880e 
Dealt to a699d2de 
Dealt to 81834a2f 
Dealt to 22e8274e 
a699d2de: folds
81834a2f: folds
22e8274e: raises $0.2 to $0.3
Hero: folds
80ebdd41: raises $0.8 to $1.1
8a55880e: folds
22e8274e: raises $2.3 to $3.4
80ebdd41: folds
Uncalled bet ($2.3) returned to 22e8274e
*** SHOWDOWN ***
22e8274e collected $2.19 from pot
*** SUMMARY ***
Total pot $2.3 | Rake $0.11 | Jackpot $0 | Bingo $0 | Fortune $0 | Tax $0
Seat 1: Hero (button) folded before Flop (didn't bet)
Seat 2: 80ebdd41 (small blind) folded before Flop
Seat 3: 8a55880e (big blind) folded before Flop
Seat 4: a699d2de folded before Flop (didn't bet)
Seat 5: 81834a2f folded before Flop (didn't bet)
Seat 6: 22e8274e collected ($2.19)


Poker Hand #RC3141670533: Hold'em No Limit ($0.05/$0.1) - 2024/12/12 12:47:25
Table 'RushAndCash22315793' 6-max Seat #1 is the button
Seat 1: f5628a04 ($11.55 in chips)
Seat 2: Hero ($11.22 in chips)
Seat 3: 3c1b4ee8 ($10.94 in chips)
Seat 4: 5b14e7af ($23.52 in chips)
Seat 5: c8c2a1e ($10.1 in chips)
Seat 6: f347a136 ($10 in chips)
Hero: posts small blind $0.05
3c1b4ee8: posts big blind $0.1
*** HOLE CARDS ***
Dealt to f5628a04 
Dealt to Hero [5c Ks]
Dealt to 3c1b4ee8 
Dealt to 5b14e7af 
Dealt to c8c2a1e 
Dealt to f347a136 
5b14e7af: folds
c8c2a1e: raises $0.1 to $0.2
f347a136: folds
f5628a04: folds
Hero: folds
3c1b4ee8: folds
Uncalled bet ($0.1) returned to c8c2a1e
*** SHOWDOWN ***
c8c2a1e collected $0.25 from pot
*** SUMMARY ***
Total pot $0.25 | Rake $0 | Jackpot $0 | Bingo $0 | Fortune $0 | Tax $0
Seat 1: f5628a04 (button) folded before Flop (didn't bet)
Seat 2: Hero (small blind) folded before Flop
Seat 3: 3c1b4ee8 (big blind) folded before Flop
Seat 4: 5b14e7af folded before Flop (didn't bet)
Seat 5: c8c2a1e collected ($0.25)
Seat 6: f347a136 folded before Flop (didn't bet)


Poker Hand #RC3141670439: Hold'em No Limit ($0.05/$0.1) - 2024/12/12 12:46:59
Table 'RushAndCash22315699' 6-max Seat #1 is the button
Seat 1: be885022 ($14.3 in chips)
Seat 2: 6a8aff3d ($34.33 in chips)
Seat 3: Hero ($11.52 in chips)
Seat 4: 5b14e7af ($23.2 in chips)
Seat 5: 37686872 ($17.32 in chips)
Seat 6: c92ccc19 ($7.38 in chips)
6a8aff3d: posts small blind $0.05
Hero: posts big blind $0.1
*** HOLE CARDS ***
Dealt to be885022 
Dealt to 6a8aff3d 
Dealt to Hero [Ac Qs]
Dealt to 5b14e7af 
Dealt to 37686872 
Dealt to c92ccc19 
5b14e7af: raises $0.2 to $0.3
37686872: folds
c92ccc19: folds
be885022: folds
6a8aff3d: folds
Hero: calls $0.2
*** FLOP *** [8d 4d Td]
Hero: checks
5b14e7af: bets $0.22
Hero: folds
Uncalled bet ($0.22) returned to 5b14e7af
*** SHOWDOWN ***
5b14e7af collected $0.62 from pot
*** SUMMARY ***
Total pot $0.65 | Rake $0.03 | Jackpot $0 | Bingo $0 | Fortune $0 | Tax $0
Board [8d 4d Td]
Seat 1: be885022 (button) folded before Flop (didn't bet)
Seat 2: 6a8aff3d (small blind) folded before Flop
Seat 3: Hero (big blind) folded on the Flop
Seat 4: 5b14e7af won ($0.62)
Seat 5: 37686872 folded before Flop (didn't bet)
Seat 6: c92ccc19 folded before Flop (didn't bet)


Poker Hand #RC3141670327: Hold'em No Limit ($0.05/$0.1) - 2024/12/12 12:46:30
Table 'RushAndCash22315587' 6-max Seat #1 is the button
Seat 1: 216abb36 ($11.24 in chips)
Seat 2: e7a93172 ($17.69 in chips)
Seat 3: b4bc8071 ($11 in chips)
Seat 4: b9463896 ($10.6 in chips)
Seat 5: b88452a1 ($10 in chips)
Seat 6: Hero ($11.52 in chips)
e7a93172: posts small blind $0.05
b4bc8071: posts big blind $0.1
*** HOLE CARDS ***
Dealt to 216abb36 
Dealt to e7a93172 
Dealt to b4bc8071 
Dealt to b9463896 
Dealt to b88452a1 
Dealt to Hero [Th Ac]
b9463896: folds
b88452a1: raises $0.12 to $0.22
Hero: folds
216abb36: folds
e7a93172: folds
b4bc8071: folds
Uncalled bet ($0.12) returned to b88452a1
*** SHOWDOWN ***
b88452a1 collected $0.25 from pot
*** SUMMARY ***
Total pot $0.25 | Rake $0 | Jackpot $0 | Bingo $0 | Fortune $0 | Tax $0
Seat 1: 216abb36 (button) folded before Flop (didn't bet)
Seat 2: e7a93172 (small blind) folded before Flop
Seat 3: b4bc8071 (big blind) folded before Flop
Seat 4: b9463896 folded before Flop (didn't bet)
Seat 5: b88452a1 collected ($0.25)
Seat 6: Hero folded before Flop (didn't bet)


Poker Hand #RC3141670255: Hold'em No Limit ($0.05/$0.1) - 2024/12/12 12:46:08
Table 'RushAndCash22315515' 6-max Seat #1 is the button
Seat 1: bf6a4250 ($11.43 in chips)
Seat 2: 3954586d ($10 in chips)
Seat 3: 2746c1f0 ($10.19 in chips)
Seat 4: Hero ($11.72 in chips)
Seat 5: cfe70ef2 ($11 in chips)
Seat 6: 916c6bd3 ($4.78 in chips)
3954586d: posts small blind $0.05
2746c1f0: posts big blind $0.1
*** HOLE CARDS ***
Dealt to bf6a4250 
Dealt to 3954586d 
Dealt to 2746c1f0 
Dealt to Hero [Kd Qd]
Dealt to cfe70ef2 
Dealt to 916c6bd3 
Hero: raises $0.1 to $0.2
cfe70ef2: folds
916c6bd3: calls $0.2
bf6a4250: raises $0.9 to $1.1
3954586d: folds
2746c1f0: folds
Hero: folds
916c6bd3: calls $0.9
*** FLOP *** [Qs 3s 9s]
916c6bd3: checks
bf6a4250: bets $0.83
916c6bd3: raises $2.85 to $3.68 and is all-in
bf6a4250: calls $2.85
916c6bd3: shows [Qc Jc] (Pair of Queens)
bf6a4250: shows [Ah Js] (Ace-High)
*** TURN *** [Qs 3s 9s] [3c]
*** RIVER *** [Qs 3s 9s 3c] [4d]
*** SHOWDOWN ***
916c6bd3 collected $9.46 from pot
*** SUMMARY ***
Total pot $9.91 | Rake $0.3 | Jackpot $0.15 | Bingo $0 | Fortune $0 | Tax $0
Board [Qs 3s 9s 3c 4d]
Seat 1: bf6a4250 (button) showed [Ah Js] and lost with Pair of Treys
Seat 2: 3954586d (small blind) folded before Flop
Seat 3: 2746c1f0 (big blind) folded before Flop
Seat 4: Hero folded before Flop
Seat 5: cfe70ef2 folded before Flop (didn't bet)
Seat 6: 916c6bd3 showed [Qc Jc] and won ($9.46) with Pair of Queens and Pair of Treys


Poker Hand #RC3141670242: Hold'em No Limit ($0.05/$0.1) - 2024/12/12 12:46:05
Table 'RushAndCash22315502' 6-max Seat #1 is the button
Seat 1: a699d2de ($11.55 in chips)
Seat 2: c8e1bfcc ($9.9 in chips)
Seat 3: eb12374a ($10 in chips)
Seat 4: Hero ($11.72 in chips)
Seat 5: 65bfb346 ($18.67 in chips)
Seat 6: 228a039d ($12.19 in chips)
c8e1bfcc: posts small blind $0.05
eb12374a: posts big blind $0.1
*** HOLE CARDS ***
Dealt to a699d2de 
Dealt to c8e1bfcc 
Dealt to eb12374a 
Dealt to Hero [Ac 5h]
Dealt to 65bfb346 
Dealt to 228a039d 
Hero: folds
65bfb346: raises $0.2 to $0.3
228a039d: folds
a699d2de: folds
c8e1bfcc: folds
eb12374a: folds
Uncalled bet ($0.2) returned to 65bfb346
*** SHOWDOWN ***
65bfb346 collected $0.25 from pot
*** SUMMARY ***
Total pot $0.25 | Rake $0 | Jackpot $0 | Bingo $0 | Fortune $0 | Tax $0
Seat 1: a699d2de (button) folded before Flop (didn't bet)
Seat 2: c8e1bfcc (small blind) folded before Flop
Seat 3: eb12374a (big blind) folded before Flop
Seat 4: Hero folded before Flop (didn't bet)
Seat 5: 65bfb346 collected ($0.25)
Seat 6: 228a039d folded before Flop (didn't bet)


Poker Hand #RC3141670227: Hold'em No Limit ($0.05/$0.1) - 2024/12/12 12:46:01
Table 'RushAndCash22315487' 6-max Seat #1 is the button
Seat 1: c279dad0 ($10.83 in chips)
Seat 2: f347a136 ($10 in chips)
Seat 3: 868ae2f3 ($15.4 in chips)
Seat 4: 3b768af1 ($11.79 in chips)
Seat 5: bf6a4250 ($11.43 in chips)
Seat 6: Hero ($11.72 in chips)
f347a136: posts small blind $0.05
868ae2f3: posts big blind $0.1
*** HOLE CARDS ***
Dealt to c279dad0 
Dealt to f347a136 
Dealt to 868ae2f3 
Dealt to 3b768af1 
Dealt to bf6a4250 
Dealt to Hero [6d 7c]
3b768af1: folds
bf6a4250: folds
Hero: folds
c279dad0: raises $0.1 to $0.2
f347a136: folds
868ae2f3: folds
Uncalled bet ($0.1) returned to c279dad0
*** SHOWDOWN ***
c279dad0 collected $0.25 from pot
*** SUMMARY ***
Total pot $0.25 | Rake $0 | Jackpot $0 | Bingo $0 | Fortune $0 | Tax $0
Seat 1: c279dad0 (button) collected ($0.25)
Seat 2: f347a136 (small blind) folded before Flop
Seat 3: 868ae2f3 (big blind) folded before Flop
Seat 4: 3b768af1 folded before Flop (didn't bet)
Seat 5: bf6a4250 folded before Flop (didn't bet)
Seat 6: Hero folded before Flop (didn't bet)


Poker Hand #RC3141670191: Hold'em No Limit ($0.05/$0.1) - 2024/12/12 12:45:52
Table 'RushAndCash22315451' 6-max Seat #1 is the button
Seat 1: 1039fde1 ($12.67 in chips)
Seat 2: Hero ($11.77 in chips)
Seat 3: 643f85e7 ($10.03 in chips)
Seat 4: 895d916a ($36.63 in chips)
Seat 5: 77907fc4 ($24.36 in chips)
Seat 6: e3914f0b ($25.48 in chips)
Hero: posts small blind $0.05
643f85e7: posts big blind $0.1
*** HOLE CARDS ***
Dealt to 1039fde1 
Dealt to Hero [6d Kh]
Dealt to 643f85e7 
Dealt to 895d916a 
Dealt to 77907fc4 
Dealt to e3914f0b 
895d916a: folds
77907fc4: raises $0.1 to $0.2
e3914f0b: folds
1039fde1: folds
Hero: folds
643f85e7: folds
Uncalled bet ($0.1) returned to 77907fc4
*** SHOWDOWN ***
77907fc4 collected $0.25 from pot
*** SUMMARY ***
Total pot $0.25 | Rake $0 | Jackpot $0 | Bingo $0 | Fortune $0 | Tax $0
Seat 1: 1039fde1 (button) folded before Flop (didn't bet)
Seat 2: Hero (small blind) folded before Flop
Seat 3: 643f85e7 (big blind) folded before Flop
Seat 4: 895d916a folded before Flop (didn't bet)
Seat 5: 77907fc4 collected ($0.25)
Seat 6: e3914f0b folded before Flop (didn't bet)


Poker Hand #RC3141670168: Hold'em No Limit ($0.05/$0.1) - 2024/12/12 12:45:46
Table 'RushAndCash22315428' 6-max Seat #1 is the button
Seat 1: a6717311 ($19.75 in chips)
Seat 2: 6dcb955a ($10 in chips)
Seat 3: Hero ($11.87 in chips)
Seat 4: 2746c1f0 ($10.19 in chips)
Seat 5: 4db3d050 ($8.41 in chips)
Seat 6: b17f5bfe ($5.63 in chips)
6dcb955a: posts small blind $0.05
Hero: posts big blind $0.1
*** HOLE CARDS ***
Dealt to a6717311 
Dealt to 6dcb955a 
Dealt to Hero [3h 8d]
Dealt to 2746c1f0 
Dealt to 4db3d050 
Dealt to b17f5bfe 
2746c1f0: folds
4db3d050: folds
b17f5bfe: folds
a6717311: raises $0.12 to $0.22
6dcb955a: folds
Hero: folds
Uncalled bet ($0.12) returned to a6717311
*** SHOWDOWN ***
a6717311 collected $0.25 from pot
*** SUMMARY ***
Total pot $0.25 | Rake $0 | Jackpot $0 | Bingo $0 | Fortune $0 | Tax $0
Seat 1: a6717311 (button) collected ($0.25)
Seat 2: 6dcb955a (small blind) folded before Flop
Seat 3: Hero (big blind) folded before Flop
Seat 4: 2746c1f0 folded before Flop (didn't bet)
Seat 5: 4db3d050 folded before Flop (didn't bet)
Seat 6: b17f5bfe folded before Flop (didn't bet)


Poker Hand #RC3141670127: Hold'em No Limit ($0.05/$0.1) - 2024/12/12 12:45:34
Table 'RushAndCash22315387' 6-max Seat #1 is the button
Seat 1: Hero ($11.87 in chips)
Seat 2: a699d2de ($11.45 in chips)
Seat 3: 874888c4 ($11.52 in chips)
Seat 4: 8cfa2620 ($19.38 in chips)
Seat 5: 4b728c96 ($14 in chips)
Seat 6: 4eb4d0d6 ($10.63 in chips)
a699d2de: posts small blind $0.05
874888c4: posts big blind $0.1
*** HOLE CARDS ***
Dealt to Hero [Td Kc]
Dealt to a699d2de 
Dealt to 874888c4 
Dealt to 8cfa2620 
Dealt to 4b728c96 
Dealt to 4eb4d0d6 
8cfa2620: folds
4b728c96: raises $0.1 to $0.2
4eb4d0d6: folds
Hero: folds
a699d2de: folds
874888c4: folds
Uncalled bet ($0.1) returned to 4b728c96
*** SHOWDOWN ***
4b728c96 collected $0.25 from pot
*** SUMMARY ***
Total pot $0.25 | Rake $0 | Jackpot $0 | Bingo $0 | Fortune $0 | Tax $0
Seat 1: Hero (button) folded before Flop (didn't bet)
Seat 2: a699d2de (small blind) folded before Flop
Seat 3: 874888c4 (big blind) folded before Flop
Seat 4: 8cfa2620 folded before Flop (didn't bet)
Seat 5: 4b728c96 collected ($0.25)
Seat 6: 4eb4d0d6 folded before Flop (didn't bet)


Poker Hand #RC3141670116: Hold'em No Limit ($0.05/$0.1) - 2024/12/12 12:45:31
Table 'RushAndCash22315376' 6-max Seat #1 is the button
Seat 1: 9dd125fd ($25.18 in chips)
Seat 2: e3914f0b ($25.53 in chips)
Seat 3: 54d53a50 ($18.53 in chips)
Seat 4: 9a7505e ($14.44 in chips)
Seat 5: Hero ($11.87 in chips)
Seat 6: dea1301e ($17.51 in chips)
e3914f0b: posts small blind $0.05
54d53a50: posts big blind $0.1
*** HOLE CARDS ***
Dealt to 9dd125fd 
Dealt to e3914f0b 
Dealt to 54d53a50 
Dealt to 9a7505e 
Dealt to Hero [9h 2d]
Dealt to dea1301e 
9a7505e: raises $0.1 to $0.2
Hero: folds
dea1301e: folds
9dd125fd: folds
e3914f0b: folds
54d53a50: folds
Uncalled bet ($0.1) returned to 9a7505e
*** SHOWDOWN ***
9a7505e collected $0.25 from pot
*** SUMMARY ***
Total pot $0.25 | Rake $0 | Jackpot $0 | Bingo $0 | Fortune $0 | Tax $0
Seat 1: 9dd125fd (button) folded before Flop (didn't bet)
Seat 2: e3914f0b (small blind) folded before Flop
Seat 3: 54d53a50 (big blind) folded before Flop
Seat 4: 9a7505e collected ($0.25)
Seat 5: Hero folded before Flop (didn't bet)
Seat 6: dea1301e folded before Flop (didn't bet)


Poker Hand #RC3141670105: Hold'em No Limit ($0.05/$0.1) - 2024/12/12 12:45:28
Table 'RushAndCash22315365' 6-max Seat #1 is the button
Seat 1: f00bacd2 ($18.88 in chips)
Seat 2: 4898aa10 ($23.78 in chips)
Seat 3: 418b0280 ($12.22 in chips)
Seat 4: 4e5368fb ($11.04 in chips)
Seat 5: Hero ($11.87 in chips)
Seat 6: 902b9d1a ($9.19 in chips)
4898aa10: posts small blind $0.05
418b0280: posts big blind $0.1
*** HOLE CARDS ***
Dealt to f00bacd2 
Dealt to 4898aa10 
Dealt to 418b0280 
Dealt to 4e5368fb 
Dealt to Hero [2h 4s]
Dealt to 902b9d1a 
4e5368fb: raises $0.1 to $0.2
Hero: folds
902b9d1a: folds
f00bacd2: folds
4898aa10: folds
418b0280: calls $0.1
*** FLOP *** [6s 2s 4d]
418b0280: checks
4e5368fb: checks
*** TURN *** [6s 2s 4d] [6c]
418b0280: bets $0.35
4e5368fb: calls $0.35
*** RIVER *** [6s 2s 4d 6c] [Kc]
418b0280: bets $0.65
4e5368fb: folds
Uncalled bet ($0.65) returned to 418b0280
*** SHOWDOWN ***
418b0280 collected $1.1 from pot
*** SUMMARY ***
Total pot $1.15 | Rake $0.05 | Jackpot $0 | Bingo $0 | Fortune $0 | Tax $0
Board [6s 2s 4d 6c Kc]
Seat 1: f00bacd2 (button) folded before Flop (didn't bet)
Seat 2: 4898aa10 (small blind) folded before Flop
Seat 3: 418b0280 (big blind) won ($1.1)
Seat 4: 4e5368fb folded on the River
Seat 5: Hero folded before Flop (didn't bet)
Seat 6: 902b9d1a folded before Flop (didn't bet)


Poker Hand #RC3141670094: Hold'em No Limit ($0.05/$0.1) - 2024/12/12 12:45:24
Table 'RushAndCash22315354' 6-max Seat #1 is the button
Seat 1: e2a23377 ($10.05 in chips)
Seat 2: af208717 ($13.18 in chips)
Seat 3: 2746c1f0 ($10.19 in chips)
Seat 4: Hero ($11.87 in chips)
Seat 5: 5c3b7f20 ($10.18 in chips)
Seat 6: 23d20ac6 ($16.69 in chips)
af208717: posts small blind $0.05
2746c1f0: posts big blind $0.1
*** HOLE CARDS ***
Dealt to e2a23377 
Dealt to af208717 
Dealt to 2746c1f0 
Dealt to Hero [6s 4d]
Dealt to 5c3b7f20 
Dealt to 23d20ac6 
Hero: folds
5c3b7f20: folds
23d20ac6: folds
e2a23377: folds
af208717: folds
Uncalled bet ($0.05) returned to 2746c1f0
*** SHOWDOWN ***
2746c1f0 collected $0.1 from pot
*** SUMMARY ***
Total pot $0.1 | Rake $0 | Jackpot $0 | Bingo $0 | Fortune $0 | Tax $0
Seat 1: e2a23377 (button) folded before Flop (didn't bet)
Seat 2: af208717 (small blind) folded before Flop
Seat 3: 2746c1f0 (big blind) collected ($0.1)
Seat 4: Hero folded before Flop (didn't bet)
Seat 5: 5c3b7f20 folded before Flop (didn't bet)
Seat 6: 23d20ac6 folded before Flop (didn't bet)


Poker Hand #RC3141670081: Hold'em No Limit ($0.05/$0.1) - 2024/12/12 12:45:21
Table 'RushAndCash22315341' 6-max Seat #1 is the button
Seat 1: Hero ($11.87 in chips)
Seat 2: b73e1c09 ($24.47 in chips)
Seat 3: 81834a2f ($19.1 in chips)
Seat 4: 97a1e12e ($11.57 in chips)
Seat 5: 4e5c7119 ($10.15 in chips)
Seat 6: af208717 ($13.18 in chips)
b73e1c09: posts small blind $0.05
81834a2f: posts big blind $0.1
*** HOLE CARDS ***
Dealt to Hero [7s Qc]
Dealt to b73e1c09 
Dealt to 81834a2f 
Dealt to 97a1e12e 
Dealt to 4e5c7119 
Dealt to af208717 
97a1e12e: folds
4e5c7119: folds
af208717: folds
Hero: folds
b73e1c09: raises $0.2 to $0.3
81834a2f: raises $0.7 to $1
b73e1c09: folds
Uncalled bet ($0.7) returned to 81834a2f
*** SHOWDOWN ***
81834a2f collected $0.57 from pot
*** SUMMARY ***
Total pot $0.6 | Rake $0.03 | Jackpot $0 | Bingo $0 | Fortune $0 | Tax $0
Seat 1: Hero (button) folded before Flop (didn't bet)
Seat 2: b73e1c09 (small blind) folded before Flop
Seat 3: 81834a2f (big blind) collected ($0.57)
Seat 4: 97a1e12e folded before Flop (didn't bet)
Seat 5: 4e5c7119 folded before Flop (didn't bet)
Seat 6: af208717 folded before Flop (didn't bet)


Poker Hand #RC3141670034: Hold'em No Limit ($0.05/$0.1) - 2024/12/12 12:45:08
Table 'RushAndCash22315294' 6-max Seat #1 is the button
Seat 1: e3244dc0 ($12 in chips)
Seat 2: f5628a04 ($12.42 in chips)
Seat 3: Hero ($11.97 in chips)
Seat 4: 1d37642 ($7.09 in chips)
Seat 5: c6352e1c ($10.15 in chips)
Seat 6: cc8462b1 ($13.11 in chips)
f5628a04: posts small blind $0.05
Hero: posts big blind $0.1
*** HOLE CARDS ***
Dealt to e3244dc0 
Dealt to f5628a04 
Dealt to Hero [Jh 8d]
Dealt to 1d37642 
Dealt to c6352e1c 
Dealt to cc8462b1 
1d37642: folds
c6352e1c: folds
cc8462b1: folds
e3244dc0: raises $0.2 to $0.3
f5628a04: folds
Hero: folds
Uncalled bet ($0.2) returned to e3244dc0
*** SHOWDOWN ***
e3244dc0 collected $0.25 from pot
*** SUMMARY ***
Total pot $0.25 | Rake $0 | Jackpot $0 | Bingo $0 | Fortune $0 | Tax $0
Seat 1: e3244dc0 (button) collected ($0.25)
Seat 2: f5628a04 (small blind) folded before Flop
Seat 3: Hero (big blind) folded before Flop
Seat 4: 1d37642 folded before Flop (didn't bet)
Seat 5: c6352e1c folded before Flop (didn't bet)
Seat 6: cc8462b1 folded before Flop (didn't bet)


Poker Hand #RC3141669960: Hold'em No Limit ($0.05/$0.1) - 2024/12/12 12:44:50
Table 'RushAndCash22315220' 6-max Seat #1 is the button
Seat 1: f1e9bea0 ($35.84 in chips)
Seat 2: Hero ($11.87 in chips)
Seat 3: 6fceecd ($12.65 in chips)
Seat 4: 8a31e4cb ($9.96 in chips)
Seat 5: 51e7f794 ($4 in chips)
Seat 6: b88452a1 ($10 in chips)
Hero: posts small blind $0.05
6fceecd: posts big blind $0.1
*** HOLE CARDS ***
Dealt to f1e9bea0 
Dealt to Hero [7s As]
Dealt to 6fceecd 
Dealt to 8a31e4cb 
Dealt to 51e7f794 
Dealt to b88452a1 
8a31e4cb: folds
51e7f794: folds
b88452a1: folds
f1e9bea0: folds
Hero: raises $0.2 to $0.3
6fceecd: folds
Uncalled bet ($0.2) returned to Hero
*** SHOWDOWN ***
Hero collected $0.2 from pot
*** SUMMARY ***
Total pot $0.2 | Rake $0 | Jackpot $0 | Bingo $0 | Fortune $0 | Tax $0
Seat 1: f1e9bea0 (button) folded before Flop (didn't bet)
Seat 2: Hero (small blind) collected ($0.2)
Seat 3: 6fceecd (big blind) folded before Flop
Seat 4: 8a31e4cb folded before Flop (didn't bet)
Seat 5: 51e7f794 folded before Flop (didn't bet)
Seat 6: b88452a1 folded before Flop (didn't bet)


Poker Hand #RC3141669897: Hold'em No Limit ($0.05/$0.1) - 2024/12/12 12:44:35
Table 'RushAndCash22315157' 6-max Seat #1 is the button
Seat 1: ae47099b ($18.23 in chips)
Seat 2: f383ae87 ($31.45 in chips)
Seat 3: 1f83b349 ($9.53 in chips)
Seat 4: a35a0951 ($8.81 in chips)
Seat 5: Hero ($11.87 in chips)
Seat 6: e6eec7bb ($11.3 in chips)
f383ae87: posts small blind $0.05
1f83b349: posts big blind $0.1
*** HOLE CARDS ***
Dealt to ae47099b 
Dealt to f383ae87 
Dealt to 1f83b349 
Dealt to a35a0951 
Dealt to Hero [Js Qh]
Dealt to e6eec7bb 
a35a0951: raises $0.1 to $0.2
Hero: folds
e6eec7bb: folds
ae47099b: folds
f383ae87: folds
1f83b349: folds
Uncalled bet ($0.1) returned to a35a0951
*** SHOWDOWN ***
a35a0951 collected $0.25 from pot
*** SUMMARY ***
Total pot $0.25 | Rake $0 | Jackpot $0 | Bingo $0 | Fortune $0 | Tax $0
Seat 1: ae47099b (button) folded before Flop (didn't bet)
Seat 2: f383ae87 (small blind) folded before Flop
Seat 3: 1f83b349 (big blind) folded before Flop
Seat 4: a35a0951 collected ($0.25)
Seat 5: Hero folded before Flop (didn't bet)
Seat 6: e6eec7bb folded before Flop (didn't bet)


Poker Hand #RC3141669883: Hold'em No Limit ($0.05/$0.1) - 2024/12/12 12:44:32
Table 'RushAndCash22315143' 6-max Seat #1 is the button
Seat 1: ce846db ($11.48 in chips)
Seat 2: 406f58e4 ($10.63 in chips)
Seat 3: f0c37558 ($15.18 in chips)
Seat 4: Hero ($11.87 in chips)
Seat 5: e3244dc0 ($12.15 in chips)
Seat 6: 1f54611 ($18.1 in chips)
406f58e4: posts small blind $0.05
f0c37558: posts big blind $0.1
*** HOLE CARDS ***
Dealt to ce846db 
Dealt to 406f58e4 
Dealt to f0c37558 
Dealt to Hero [3d 4c]
Dealt to e3244dc0 
Dealt to 1f54611 
Hero: folds
e3244dc0: folds
1f54611: raises $0.15 to $0.25
ce846db: folds
406f58e4: folds
f0c37558: folds
Uncalled bet ($0.15) returned to 1f54611
*** SHOWDOWN ***
1f54611 collected $0.25 from pot
*** SUMMARY ***
Total pot $0.25 | Rake $0 | Jackpot $0 | Bingo $0 | Fortune $0 | Tax $0
Seat 1: ce846db (button) folded before Flop (didn't bet)
Seat 2: 406f58e4 (small blind) folded before Flop
Seat 3: f0c37558 (big blind) folded before Flop
Seat 4: Hero folded before Flop (didn't bet)
Seat 5: e3244dc0 folded before Flop (didn't bet)
Seat 6: 1f54611 collected ($0.25)


Poker Hand #RC3141669829: Hold'em No Limit ($0.05/$0.1) - 2024/12/12 12:44:19
Table 'RushAndCash22315089' 6-max Seat #1 is the button
Seat 1: 9a52083d ($24.57 in chips)
Seat 2: f347a136 ($10.17 in chips)
Seat 3: 4bddf600 ($9.82 in chips)
Seat 4: fed024e0 ($10.63 in chips)
Seat 5: e9fe744a ($39.69 in chips)
Seat 6: Hero ($11.72 in chips)
f347a136: posts small blind $0.05
4bddf600: posts big blind $0.1
*** HOLE CARDS ***
Dealt to 9a52083d 
Dealt to f347a136 
Dealt to 4bddf600 
Dealt to fed024e0 
Dealt to e9fe744a 
Dealt to Hero [Jd Kd]
fed024e0: folds
e9fe744a: folds
Hero: raises $0.15 to $0.25
9a52083d: folds
f347a136: folds
4bddf600: folds
Uncalled bet ($0.15) returned to Hero
*** SHOWDOWN ***
Hero collected $0.25 from pot
*** SUMMARY ***
Total pot $0.25 | Rake $0 | Jackpot $0 | Bingo $0 | Fortune $0 | Tax $0
Seat 1: 9a52083d (button) folded before Flop (didn't bet)
Seat 2: f347a136 (small blind) folded before Flop
Seat 3: 4bddf600 (big blind) folded before Flop
Seat 4: fed024e0 folded before Flop (didn't bet)
Seat 5: e9fe744a folded before Flop (didn't bet)
Seat 6: Hero collected ($0.25)


Poker Hand #RC3141669774: Hold'em No Limit ($0.05/$0.1) - 2024/12/12 12:44:07
Table 'RushAndCash22315034' 6-max Seat #1 is the button
Seat 1: d07ab82c ($10.15 in chips)
Seat 2: e18303a2 ($13.29 in chips)
Seat 3: Hero ($11.82 in chips)
Seat 4: a5f5a77f ($11.06 in chips)
Seat 5: 4eb4d0d6 ($10.55 in chips)
Seat 6: 5041f166 ($10.1 in chips)
e18303a2: posts small blind $0.05
Hero: posts big blind $0.1
*** HOLE CARDS ***
Dealt to d07ab82c 
Dealt to e18303a2 
Dealt to Hero [2d Kh]
Dealt to a5f5a77f 
Dealt to 4eb4d0d6 
Dealt to 5041f166 
a5f5a77f: folds
4eb4d0d6: folds
5041f166: folds
d07ab82c: raises $0.1 to $0.2
e18303a2: folds
Hero: folds
Uncalled bet ($0.1) returned to d07ab82c
*** SHOWDOWN ***
d07ab82c collected $0.25 from pot
*** SUMMARY ***
Total pot $0.25 | Rake $0 | Jackpot $0 | Bingo $0 | Fortune $0 | Tax $0
Seat 1: d07ab82c (button) collected ($0.25)
Seat 2: e18303a2 (small blind) folded before Flop
Seat 3: Hero (big blind) folded before Flop
Seat 4: a5f5a77f folded before Flop (didn't bet)
Seat 5: 4eb4d0d6 folded before Flop (didn't bet)
Seat 6: 5041f166 folded before Flop (didn't bet)


Poker Hand #RC3141669728: Hold'em No Limit ($0.05/$0.1) - 2024/12/12 12:43:57
Table 'RushAndCash22314988' 6-max Seat #1 is the button
Seat 1: 6753f046 ($34.77 in chips)
Seat 2: Hero ($11.87 in chips)
Seat 3: 868ae2f3 ($15.7 in chips)
Seat 4: 5b14e7af ($21.89 in chips)
Seat 5: 1d2dacdf ($10 in chips)
Seat 6: 5304ad76 ($10 in chips)
Hero: posts small blind $0.05
868ae2f3: posts big blind $0.1
*** HOLE CARDS ***
Dealt to 6753f046 
Dealt to Hero [Qh 7d]
Dealt to 868ae2f3 
Dealt to 5b14e7af 
Dealt to 1d2dacdf 
Dealt to 5304ad76 
5b14e7af: folds
1d2dacdf: folds
5304ad76: folds
6753f046: folds
Hero: folds
Uncalled bet ($0.05) returned to 868ae2f3
*** SHOWDOWN ***
868ae2f3 collected $0.1 from pot
*** SUMMARY ***
Total pot $0.1 | Rake $0 | Jackpot $0 | Bingo $0 | Fortune $0 | Tax $0
Seat 1: 6753f046 (button) folded before Flop (didn't bet)
Seat 2: Hero (small blind) folded before Flop
Seat 3: 868ae2f3 (big blind) collected ($0.1)
Seat 4: 5b14e7af folded before Flop (didn't bet)
Seat 5: 1d2dacdf folded before Flop (didn't bet)
Seat 6: 5304ad76 folded before Flop (didn't bet)


Poker Hand #RC3141669713: Hold'em No Limit ($0.05/$0.1) - 2024/12/12 12:43:54
Table 'RushAndCash22314973' 6-max Seat #1 is the button
Seat 1: Hero ($11.87 in chips)
Seat 2: 2b1a7fe5 ($18.54 in chips)
Seat 3: d578ebdd ($10.09 in chips)
Seat 4: 7ea060c8 ($14.05 in chips)
Seat 5: 755092ba ($17.77 in chips)
Seat 6: 721d2ee6 ($13.82 in chips)
2b1a7fe5: posts small blind $0.05
d578ebdd: posts big blind $0.1
*** HOLE CARDS ***
Dealt to Hero [4s Td]
Dealt to 2b1a7fe5 
Dealt to d578ebdd 
Dealt to 7ea060c8 
Dealt to 755092ba 
Dealt to 721d2ee6 
7ea060c8: folds
755092ba: folds
721d2ee6: folds
Hero: folds
2b1a7fe5: raises $0.15 to $0.25
d578ebdd: folds
Uncalled bet ($0.15) returned to 2b1a7fe5
*** SHOWDOWN ***
2b1a7fe5 collected $0.2 from pot
*** SUMMARY ***
Total pot $0.2 | Rake $0 | Jackpot $0 | Bingo $0 | Fortune $0 | Tax $0
Seat 1: Hero (button) folded before Flop (didn't bet)
Seat 2: 2b1a7fe5 (small blind) collected ($0.2)
Seat 3: d578ebdd (big blind) folded before Flop
Seat 4: 7ea060c8 folded before Flop (didn't bet)
Seat 5: 755092ba folded before Flop (didn't bet)
Seat 6: 721d2ee6 folded before Flop (didn't bet)


Poker Hand #RC3141669698: Hold'em No Limit ($0.05/$0.1) - 2024/12/12 12:43:50
Table 'RushAndCash22314958' 6-max Seat #1 is the button
Seat 1: 59de94fc ($14.65 in chips)
Seat 2: 31e1f60f ($15.18 in chips)
Seat 3: d037fd58 ($12.12 in chips)
Seat 4: Hero ($11.87 in chips)
Seat 5: 2db5d1cb ($13.13 in chips)
Seat 6: cacc74b2 ($10.31 in chips)
31e1f60f: posts small blind $0.05
d037fd58: posts big blind $0.1
*** HOLE CARDS ***
Dealt to 59de94fc 
Dealt to 31e1f60f 
Dealt to d037fd58 
Dealt to Hero [3c Kh]
Dealt to 2db5d1cb 
Dealt to cacc74b2 
Hero: folds
2db5d1cb: folds
cacc74b2: raises $0.11 to $0.21
59de94fc: folds
31e1f60f: folds
d037fd58: folds
Uncalled bet ($0.11) returned to cacc74b2
*** SHOWDOWN ***
cacc74b2 collected $0.25 from pot
*** SUMMARY ***
Total pot $0.25 | Rake $0 | Jackpot $0 | Bingo $0 | Fortune $0 | Tax $0
Seat 1: 59de94fc (button) folded before Flop (didn't bet)
Seat 2: 31e1f60f (small blind) folded before Flop
Seat 3: d037fd58 (big blind) folded before Flop
Seat 4: Hero folded before Flop (didn't bet)
Seat 5: 2db5d1cb folded before Flop (didn't bet)
Seat 6: cacc74b2 collected ($0.25)


Poker Hand #RC3141669686: Hold'em No Limit ($0.05/$0.1) - 2024/12/12 12:43:47
Table 'RushAndCash22314946' 6-max Seat #1 is the button
Seat 1: Hero ($11.87 in chips)
Seat 2: 3e399c74 ($10.05 in chips)
Seat 3: 84c34548 ($10 in chips)
Seat 4: b17f5bfe ($5.78 in chips)
Seat 5: 1d2dacdf ($10 in chips)
Seat 6: cfe70ef2 ($10 in chips)
3e399c74: posts small blind $0.05
84c34548: posts big blind $0.1
*** HOLE CARDS ***
Dealt to Hero [4d 8s]
Dealt to 3e399c74 
Dealt to 84c34548 
Dealt to b17f5bfe 
Dealt to 1d2dacdf 
Dealt to cfe70ef2 
b17f5bfe: folds
1d2dacdf: folds
cfe70ef2: folds
Hero: folds
3e399c74: raises $0.2 to $0.3
84c34548: folds
Uncalled bet ($0.2) returned to 3e399c74
*** SHOWDOWN ***
3e399c74 collected $0.2 from pot
*** SUMMARY ***
Total pot $0.2 | Rake $0 | Jackpot $0 | Bingo $0 | Fortune $0 | Tax $0
Seat 1: Hero (button) folded before Flop (didn't bet)
Seat 2: 3e399c74 (small blind) collected ($0.2)
Seat 3: 84c34548 (big blind) folded before Flop
Seat 4: b17f5bfe folded before Flop (didn't bet)
Seat 5: 1d2dacdf folded before Flop (didn't bet)
Seat 6: cfe70ef2 folded before Flop (didn't bet)


Poker Hand #RC3141669670: Hold'em No Limit ($0.05/$0.1) - 2024/12/12 12:43:43
Table 'RushAndCash22314930' 6-max Seat #1 is the button
Seat 1: 26077f2f ($10.23 in chips)
Seat 2: 8fc49c26 ($42.98 in chips)
Seat 3: 3f908364 ($16.99 in chips)
Seat 4: Hero ($11.87 in chips)
Seat 5: ee394d0a ($10.76 in chips)
Seat 6: cfe70ef2 ($10 in chips)
8fc49c26: posts small blind $0.05
3f908364: posts big blind $0.1
*** HOLE CARDS ***
Dealt to 26077f2f 
Dealt to 8fc49c26 
Dealt to 3f908364 
Dealt to Hero [2d 3c]
Dealt to ee394d0a 
Dealt to cfe70ef2 
Hero: folds
ee394d0a: folds
cfe70ef2: folds
26077f2f: folds
8fc49c26: raises $0.2 to $0.3
3f908364: raises $0.6 to $0.9
8fc49c26: calls $0.6
*** FLOP *** [5c As Kc]
8fc49c26: checks
3f908364: bets $0.35
8fc49c26: calls $0.35
*** TURN *** [5c As Kc] [Tc]
8fc49c26: checks
3f908364: bets $1.15
8fc49c26: folds
Uncalled bet ($1.15) returned to 3f908364
*** SHOWDOWN ***
3f908364 collected $2.38 from pot
*** SUMMARY ***
Total pot $2.5 | Rake $0.12 | Jackpot $0 | Bingo $0 | Fortune $0 | Tax $0
Board [5c As Kc Tc]
Seat 1: 26077f2f (button) folded before Flop (didn't bet)
Seat 2: 8fc49c26 (small blind) folded on the Turn
Seat 3: 3f908364 (big blind) won ($2.38)
Seat 4: Hero folded before Flop (didn't bet)
Seat 5: ee394d0a folded before Flop (didn't bet)
Seat 6: cfe70ef2 folded before Flop (didn't bet)


Poker Hand #RC3141669654: Hold'em No Limit ($0.05/$0.1) - 2024/12/12 12:43:39
Table 'RushAndCash22314914' 6-max Seat #1 is the button
Seat 1: 1f54611 ($15.91 in chips)
Seat 2: Hero ($11.92 in chips)
Seat 3: c86d72c6 ($14.93 in chips)
Seat 4: c8e1bfcc ($10 in chips)
Seat 5: c4d674fe ($10.15 in chips)
Seat 6: 574859ba ($10.1 in chips)
Hero: posts small blind $0.05
c86d72c6: posts big blind $0.1
*** HOLE CARDS ***
Dealt to 1f54611 
Dealt to Hero [3s Qc]
Dealt to c86d72c6 
Dealt to c8e1bfcc 
Dealt to c4d674fe 
Dealt to 574859ba 
c8e1bfcc: folds
c4d674fe: folds
574859ba: folds
1f54611: folds
Hero: folds
Uncalled bet ($0.05) returned to c86d72c6
*** SHOWDOWN ***
c86d72c6 collected $0.1 from pot
*** SUMMARY ***
Total pot $0.1 | Rake $0 | Jackpot $0 | Bingo $0 | Fortune $0 | Tax $0
Seat 1: 1f54611 (button) folded before Flop (didn't bet)
Seat 2: Hero (small blind) folded before Flop
Seat 3: c86d72c6 (big blind) collected ($0.1)
Seat 4: c8e1bfcc folded before Flop (didn't bet)
Seat 5: c4d674fe folded before Flop (didn't bet)
Seat 6: 574859ba folded before Flop (didn't bet)


Poker Hand #RC3141669604: Hold'em No Limit ($0.05/$0.1) - 2024/12/12 12:43:27
Table 'RushAndCash22314864' 6-max Seat #1 is the button
Seat 1: 17f79555 ($10.34 in chips)
Seat 2: 8a31e4cb ($10.41 in chips)
Seat 3: Hero ($12.02 in chips)
Seat 4: 5c1d4f73 ($11.2 in chips)
Seat 5: f2b49ec ($10.44 in chips)
Seat 6: 92e8bfbd ($26.08 in chips)
8a31e4cb: posts small blind $0.05
Hero: posts big blind $0.1
*** HOLE CARDS ***
Dealt to 17f79555 
Dealt to 8a31e4cb 
Dealt to Hero [2h Kd]
Dealt to 5c1d4f73 
Dealt to f2b49ec 
Dealt to 92e8bfbd 
5c1d4f73: folds
f2b49ec: raises $0.1 to $0.2
92e8bfbd: folds
17f79555: folds
8a31e4cb: calls $0.15
Hero: folds
*** FLOP *** [2s Jd Ts]
8a31e4cb: checks
f2b49ec: bets $0.25
8a31e4cb: calls $0.25
*** TURN *** [2s Jd Ts] [As]
8a31e4cb: checks
f2b49ec: checks
*** RIVER *** [2s Jd Ts As] [9h]
8a31e4cb: checks
f2b49ec: checks
8a31e4cb: shows [Jc 8c] (Pair of Jacks)
f2b49ec: shows [Kc Jh] (Pair of Jacks)
*** SHOWDOWN ***
f2b49ec collected $0.95 from pot
*** SUMMARY ***
Total pot $1 | Rake $0.05 | Jackpot $0 | Bingo $0 | Fortune $0 | Tax $0
Board [2s Jd Ts As 9h]
Seat 1: 17f79555 (button) folded before Flop (didn't bet)
Seat 2: 8a31e4cb (small blind) showed [Jc 8c] and lost with Pair of Jacks
Seat 3: Hero (big blind) folded before Flop
Seat 4: 5c1d4f73 folded before Flop (didn't bet)
Seat 5: f2b49ec showed [Kc Jh] and won ($0.95) with Pair of Jacks
Seat 6: 92e8bfbd folded before Flop (didn't bet)


Poker Hand #RC3141669474: Hold'em No Limit ($0.05/$0.1) - 2024/12/12 12:42:58
Table 'RushAndCash22314734' 6-max Seat #1 is the button
Seat 1: e0a6d1b8 ($10.15 in chips)
Seat 2: a9eb45fc ($10 in chips)
Seat 3: 8a31e4cb ($10 in chips)
Seat 4: Hero ($12.42 in chips)
Seat 5: bc2007a2 ($15.32 in chips)
Seat 6: daa081a6 ($11.9 in chips)
a9eb45fc: posts small blind $0.05
8a31e4cb: posts big blind $0.1
*** HOLE CARDS ***
Dealt to e0a6d1b8 
Dealt to a9eb45fc 
Dealt to 8a31e4cb 
Dealt to Hero [Jh As]
Dealt to bc2007a2 
Dealt to daa081a6 
Hero: raises $0.1 to $0.2
bc2007a2: folds
daa081a6: folds
e0a6d1b8: folds
a9eb45fc: folds
8a31e4cb: calls $0.1
*** FLOP *** [Th 5h 2c]
8a31e4cb: checks
Hero: bets $0.2
8a31e4cb: raises $0.64 to $0.84
Hero: folds
Uncalled bet ($0.64) returned to 8a31e4cb
*** SHOWDOWN ***
8a31e4cb collected $0.81 from pot
*** SUMMARY ***
Total pot $0.85 | Rake $0.04 | Jackpot $0 | Bingo $0 | Fortune $0 | Tax $0
Board [Th 5h 2c]
Seat 1: e0a6d1b8 (button) folded before Flop (didn't bet)
Seat 2: a9eb45fc (small blind) folded before Flop
Seat 3: 8a31e4cb (big blind) won ($0.81)
Seat 4: Hero folded on the Flop
Seat 5: bc2007a2 folded before Flop (didn't bet)
Seat 6: daa081a6 folded before Flop (didn't bet)


Poker Hand #RC3141669458: Hold'em No Limit ($0.05/$0.1) - 2024/12/12 12:42:54
Table 'RushAndCash22314718' 6-max Seat #1 is the button
Seat 1: 22e8274e ($14.65 in chips)
Seat 2: 566d8ba0 ($10 in chips)
Seat 3: 4f76bae1 ($10 in chips)
Seat 4: Hero ($12.42 in chips)
Seat 5: 6fcf7795 ($25.83 in chips)
Seat 6: 1f54611 ($15.76 in chips)
566d8ba0: posts small blind $0.05
4f76bae1: posts big blind $0.1
*** HOLE CARDS ***
Dealt to 22e8274e 
Dealt to 566d8ba0 
Dealt to 4f76bae1 
Dealt to Hero [6d 7d]
Dealt to 6fcf7795 
Dealt to 1f54611 
Hero: folds
6fcf7795: folds
1f54611: folds
22e8274e: raises $0.1 to $0.2
566d8ba0: raises $0.7 to $0.9
4f76bae1: folds
22e8274e: folds
Uncalled bet ($0.7) returned to 566d8ba0
*** SHOWDOWN ***
566d8ba0 collected $0.48 from pot
*** SUMMARY ***
Total pot $0.5 | Rake $0.02 | Jackpot $0 | Bingo $0 | Fortune $0 | Tax $0
Seat 1: 22e8274e (button) folded before Flop
Seat 2: 566d8ba0 (small blind) collected ($0.48)
Seat 3: 4f76bae1 (big blind) folded before Flop
Seat 4: Hero folded before Flop (didn't bet)
Seat 5: 6fcf7795 folded before Flop (didn't bet)
Seat 6: 1f54611 folded before Flop (didn't bet)


Poker Hand #RC3141669443: Hold'em No Limit ($0.05/$0.1) - 2024/12/12 12:42:51
Table 'RushAndCash22314703' 6-max Seat #1 is the button
Seat 1: 101c026b ($24.89 in chips)
Seat 2: dea1301e ($17.74 in chips)
Seat 3: 2746c1f0 ($10 in chips)
Seat 4: 8424fd65 ($11.76 in chips)
Seat 5: 4a1f9c37 ($15.12 in chips)
Seat 6: Hero ($12.42 in chips)
dea1301e: posts small blind $0.05
2746c1f0: posts big blind $0.1
*** HOLE CARDS ***
Dealt to 101c026b 
Dealt to dea1301e 
Dealt to 2746c1f0 
Dealt to 8424fd65 
Dealt to 4a1f9c37 
Dealt to Hero [8s Tc]
8424fd65: raises $0.1 to $0.2
4a1f9c37: folds
Hero: folds
101c026b: folds
dea1301e: calls $0.15
2746c1f0: folds
*** FLOP *** [5s 3h Jh]
dea1301e: checks
8424fd65: bets $0.17
dea1301e: folds
Uncalled bet ($0.17) returned to 8424fd65
*** SHOWDOWN ***
8424fd65 collected $0.48 from pot
*** SUMMARY ***
Total pot $0.5 | Rake $0.02 | Jackpot $0 | Bingo $0 | Fortune $0 | Tax $0
Board [5s 3h Jh]
Seat 1: 101c026b (button) folded before Flop (didn't bet)
Seat 2: dea1301e (small blind) folded on the Flop
Seat 3: 2746c1f0 (big blind) folded before Flop
Seat 4: 8424fd65 won ($0.48)
Seat 5: 4a1f9c37 folded before Flop (didn't bet)
Seat 6: Hero folded before Flop (didn't bet)


Poker Hand #RC3141669428: Hold'em No Limit ($0.05/$0.1) - 2024/12/12 12:42:47
Table 'RushAndCash22314688' 6-max Seat #1 is the button
Seat 1: c199627b ($12.08 in chips)
Seat 2: 22e8274e ($14.7 in chips)
Seat 3: 4c96024a ($10 in chips)
Seat 4: 4bddf600 ($10 in chips)
Seat 5: 5c3b7f20 ($10 in chips)
Seat 6: Hero ($12.42 in chips)
22e8274e: posts small blind $0.05
4c96024a: posts big blind $0.1
*** HOLE CARDS ***
Dealt to c199627b 
Dealt to 22e8274e 
Dealt to 4c96024a 
Dealt to 4bddf600 
Dealt to 5c3b7f20 
Dealt to Hero [Th 8h]
4bddf600: folds
5c3b7f20: folds
Hero: folds
c199627b: raises $0.15 to $0.25
22e8274e: folds
4c96024a: folds
Uncalled bet ($0.15) returned to c199627b
*** SHOWDOWN ***
c199627b collected $0.25 from pot
*** SUMMARY ***
Total pot $0.25 | Rake $0 | Jackpot $0 | Bingo $0 | Fortune $0 | Tax $0
Seat 1: c199627b (button) collected ($0.25)
Seat 2: 22e8274e (small blind) folded before Flop
Seat 3: 4c96024a (big blind) folded before Flop
Seat 4: 4bddf600 folded before Flop (didn't bet)
Seat 5: 5c3b7f20 folded before Flop (didn't bet)
Seat 6: Hero folded before Flop (didn't bet)


Poker Hand #RC3141669414: Hold'em No Limit ($0.05/$0.1) - 2024/12/12 12:42:44
Table 'RushAndCash22314674' 6-max Seat #1 is the button
Seat 1: b37e3efe ($14.94 in chips)
Seat 2: edb28086 ($12.37 in chips)
Seat 3: Hero ($12.52 in chips)
Seat 4: 12b883d0 ($28.24 in chips)
Seat 5: b8e03e64 ($10 in chips)
Seat 6: b57eea46 ($10.99 in chips)
edb28086: posts small blind $0.05
Hero: posts big blind $0.1
*** HOLE CARDS ***
Dealt to b37e3efe 
Dealt to edb28086 
Dealt to Hero [2c 7s]
Dealt to 12b883d0 
Dealt to b8e03e64 
Dealt to b57eea46 
12b883d0: folds
b8e03e64: folds
b57eea46: raises $0.1 to $0.2
b37e3efe: folds
edb28086: folds
Hero: folds
Uncalled bet ($0.1) returned to b57eea46
*** SHOWDOWN ***
b57eea46 collected $0.25 from pot
*** SUMMARY ***
Total pot $0.25 | Rake $0 | Jackpot $0 | Bingo $0 | Fortune $0 | Tax $0
Seat 1: b37e3efe (button) folded before Flop (didn't bet)
Seat 2: edb28086 (small blind) folded before Flop
Seat 3: Hero (big blind) folded before Flop
Seat 4: 12b883d0 folded before Flop (didn't bet)
Seat 5: b8e03e64 folded before Flop (didn't bet)
Seat 6: b57eea46 collected ($0.25)


Poker Hand #RC3141669369: Hold'em No Limit ($0.05/$0.1) - 2024/12/12 12:42:32
Table 'RushAndCash22314629' 6-max Seat #1 is the button
Seat 1: Hero ($12.37 in chips)
Seat 2: b57eea46 ($11.04 in chips)
Seat 3: 3e399c74 ($10 in chips)
Seat 4: d8e077e9 ($35.53 in chips)
Seat 5: 77907fc4 ($25.57 in chips)
Seat 6: a3382d82 ($20.52 in chips)
b57eea46: posts small blind $0.05
3e399c74: posts big blind $0.1
*** HOLE CARDS ***
Dealt to Hero [Jc Qh]
Dealt to b57eea46 
Dealt to 3e399c74 
Dealt to d8e077e9 
Dealt to 77907fc4 
Dealt to a3382d82 
d8e077e9: folds
77907fc4: folds
a3382d82: folds
Hero: raises $0.15 to $0.25
b57eea46: folds
3e399c74: folds
Uncalled bet ($0.15) returned to Hero
*** SHOWDOWN ***
Hero collected $0.25 from pot
*** SUMMARY ***
Total pot $0.25 | Rake $0 | Jackpot $0 | Bingo $0 | Fortune $0 | Tax $0
Seat 1: Hero (button) collected ($0.25)
Seat 2: b57eea46 (small blind) folded before Flop
Seat 3: 3e399c74 (big blind) folded before Flop
Seat 4: d8e077e9 folded before Flop (didn't bet)
Seat 5: 77907fc4 folded before Flop (didn't bet)
Seat 6: a3382d82 folded before Flop (didn't bet)


Poker Hand #RC3141669355: Hold'em No Limit ($0.05/$0.1) - 2024/12/12 12:42:29
Table 'RushAndCash22314615' 6-max Seat #1 is the button
Seat 1: d6b17ac7 ($12.01 in chips)
Seat 2: Hero ($12.42 in chips)
Seat 3: 6b9a34dd ($8.28 in chips)
Seat 4: d8e077e9 ($35.53 in chips)
Seat 5: 17b381d5 ($25.5 in chips)
Seat 6: 721d2ee6 ($12.81 in chips)
Hero: posts small blind $0.05
6b9a34dd: posts big blind $0.1
*** HOLE CARDS ***
Dealt to d6b17ac7 
Dealt to Hero [6s Qd]
Dealt to 6b9a34dd 
Dealt to d8e077e9 
Dealt to 17b381d5 
Dealt to 721d2ee6 
d8e077e9: folds
17b381d5: raises $0.1 to $0.2
721d2ee6: folds
d6b17ac7: raises $0.5 to $0.7
Hero: folds
6b9a34dd: folds
17b381d5: folds
Uncalled bet ($0.5) returned to d6b17ac7
*** SHOWDOWN ***
d6b17ac7 collected $0.53 from pot
*** SUMMARY ***
Total pot $0.55 | Rake $0.02 | Jackpot $0 | Bingo $0 | Fortune $0 | Tax $0
Seat 1: d6b17ac7 (button) collected ($0.53)
Seat 2: Hero (small blind) folded before Flop
Seat 3: 6b9a34dd (big blind) folded before Flop
Seat 4: d8e077e9 folded before Flop (didn't bet)
Seat 5: 17b381d5 folded before Flop
Seat 6: 721d2ee6 folded before Flop (didn't bet)


Poker Hand #RC3141669341: Hold'em No Limit ($0.05/$0.1) - 2024/12/12 12:42:25
Table 'RushAndCash22314601' 6-max Seat #1 is the button
Seat 1: 27c51518 ($19.46 in chips)
Seat 2: 59de94fc ($14.59 in chips)
Seat 3: 8fc49c26 ($43.43 in chips)
Seat 4: fc90d2af ($4.7 in chips)
Seat 5: Hero ($12.42 in chips)
Seat 6: 1f54611 ($16.01 in chips)
59de94fc: posts small blind $0.05
8fc49c26: posts big blind $0.1
*** HOLE CARDS ***
Dealt to 27c51518 
Dealt to 59de94fc 
Dealt to 8fc49c26 
Dealt to fc90d2af 
Dealt to Hero [8d 2c]
Dealt to 1f54611 
fc90d2af: folds
Hero: folds
1f54611: folds
27c51518: folds
59de94fc: raises $0.2 to $0.3
8fc49c26: calls $0.2
*** FLOP *** [Qs 9c 4h]
59de94fc: bets $0.45
8fc49c26: folds
Uncalled bet ($0.45) returned to 59de94fc
*** SHOWDOWN ***
59de94fc collected $0.57 from pot
*** SUMMARY ***
Total pot $0.6 | Rake $0.03 | Jackpot $0 | Bingo $0 | Fortune $0 | Tax $0
Board [Qs 9c 4h]
Seat 1: 27c51518 (button) folded before Flop (didn't bet)
Seat 2: 59de94fc (small blind) won ($0.57)
Seat 3: 8fc49c26 (big blind) folded on the Flop
Seat 4: fc90d2af folded before Flop (didn't bet)
Seat 5: Hero folded before Flop (didn't bet)
Seat 6: 1f54611 folded before Flop (didn't bet)


Poker Hand #RC3141669325: Hold'em No Limit ($0.05/$0.1) - 2024/12/12 12:42:22
Table 'RushAndCash22314585' 6-max Seat #1 is the button
Seat 1: 8a31e4cb ($10 in chips)
Seat 2: 6a8aff3d ($37.22 in chips)
Seat 3: 8e0a697 ($10.18 in chips)
Seat 4: 4746887d ($12.06 in chips)
Seat 5: Hero ($12.42 in chips)
Seat 6: 15f3779a ($18.7 in chips)
6a8aff3d: posts small blind $0.05
8e0a697: posts big blind $0.1
*** HOLE CARDS ***
Dealt to 8a31e4cb 
Dealt to 6a8aff3d 
Dealt to 8e0a697 
Dealt to 4746887d 
Dealt to Hero [3c Qs]
Dealt to 15f3779a 
4746887d: raises $0.14 to $0.24
Hero: folds
15f3779a: folds
8a31e4cb: folds
6a8aff3d: calls $0.19
8e0a697: folds
*** FLOP *** [9c 4s 6c]
6a8aff3d: bets $0.32
4746887d: calls $0.32
*** TURN *** [9c 4s 6c] [9s]
6a8aff3d: bets $0.68
4746887d: calls $0.68
*** RIVER *** [9c 4s 6c 9s] [2c]
6a8aff3d: checks
4746887d: bets $2.58
6a8aff3d: calls $2.58
4746887d: shows [Kc Qc] (King High Flush)
6a8aff3d: shows [Tc Td] (Pair of Tens and Pair of Nines)
*** SHOWDOWN ***
4746887d collected $7.29 from pot
*** SUMMARY ***
Total pot $7.74 | Rake $0.3 | Jackpot $0.15 | Bingo $0 | Fortune $0 | Tax $0
Board [9c 4s 6c 9s 2c]
Seat 1: 8a31e4cb (button) folded before Flop (didn't bet)
Seat 2: 6a8aff3d (small blind) showed [Tc Td] and lost with Pair of Tens and Pair of Nines
Seat 3: 8e0a697 (big blind) folded before Flop
Seat 4: 4746887d showed [Kc Qc] and won ($7.29) with King High Flush
Seat 5: Hero folded before Flop (didn't bet)
Seat 6: 15f3779a folded before Flop (didn't bet)


Poker Hand #RC3141669311: Hold'em No Limit ($0.05/$0.1) - 2024/12/12 12:42:19
Table 'RushAndCash22314571' 6-max Seat #1 is the button
Seat 1: Hero ($12.42 in chips)
Seat 2: 4e5c7119 ($10.87 in chips)
Seat 3: b2132e5f ($10.73 in chips)
Seat 4: 15f3779a ($18.7 in chips)
Seat 5: d578ebdd ($10.54 in chips)
Seat 6: 5ab2e15d ($10 in chips)
4e5c7119: posts small blind $0.05
b2132e5f: posts big blind $0.1
*** HOLE CARDS ***
Dealt to Hero [Kh 6d]
Dealt to 4e5c7119 
Dealt to b2132e5f 
Dealt to 15f3779a 
Dealt to d578ebdd 
Dealt to 5ab2e15d 
15f3779a: folds
d578ebdd: folds
5ab2e15d: folds
Hero: folds
4e5c7119: raises $0.2 to $0.3
b2132e5f: calls $0.2
*** FLOP *** [Th 4h Tc]
4e5c7119: checks
b2132e5f: checks
*** TURN *** [Th 4h Tc] [6s]
4e5c7119: checks
b2132e5f: checks
*** RIVER *** [Th 4h Tc 6s] [6c]
4e5c7119: checks
b2132e5f: checks
4e5c7119: shows [Ad Kd] (Pair of Tens and Pair of Sixes)
b2132e5f: shows [Kc 3c] (Pair of Tens and Pair of Sixes)
*** SHOWDOWN ***
4e5c7119 collected $0.57 from pot
*** SUMMARY ***
Total pot $0.6 | Rake $0.03 | Jackpot $0 | Bingo $0 | Fortune $0 | Tax $0
Board [Th 4h Tc 6s 6c]
Seat 1: Hero (button) folded before Flop (didn't bet)
Seat 2: 4e5c7119 (small blind) showed [Ad Kd] and won ($0.57) with Pair of Tens and Pair of Sixes
Seat 3: b2132e5f (big blind) showed [Kc 3c] and lost with Pair of Tens and Pair of Sixes
Seat 4: 15f3779a folded before Flop (didn't bet)
Seat 5: d578ebdd folded before Flop (didn't bet)
Seat 6: 5ab2e15d folded before Flop (didn't bet)


Poker Hand #RC3141669261: Hold'em No Limit ($0.05/$0.1) - 2024/12/12 12:42:08
Table 'RushAndCash22314521' 6-max Seat #1 is the button
Seat 1: 17f79555 ($10.67 in chips)
Seat 2: Hero ($12.47 in chips)
Seat 3: 6d89c9cc ($13.2 in chips)
Seat 4: 1a8ef95a ($15.72 in chips)
Seat 5: f2ece23 ($14.94 in chips)
Seat 6: 9dd125fd ($24.04 in chips)
Hero: posts small blind $0.05
6d89c9cc: posts big blind $0.1
*** HOLE CARDS ***
Dealt to 17f79555 
Dealt to Hero [Td Jc]
Dealt to 6d89c9cc 
Dealt to 1a8ef95a 
Dealt to f2ece23 
Dealt to 9dd125fd 
1a8ef95a: raises $0.11 to $0.21
f2ece23: folds
9dd125fd: folds
17f79555: folds
Hero: folds
6d89c9cc: folds
Uncalled bet ($0.11) returned to 1a8ef95a
*** SHOWDOWN ***
1a8ef95a collected $0.25 from pot
*** SUMMARY ***
Total pot $0.25 | Rake $0 | Jackpot $0 | Bingo $0 | Fortune $0 | Tax $0
Seat 1: 17f79555 (button) folded before Flop (didn't bet)
Seat 2: Hero (small blind) folded before Flop
Seat 3: 6d89c9cc (big blind) folded before Flop
Seat 4: 1a8ef95a collected ($0.25)
Seat 5: f2ece23 folded before Flop (didn't bet)
Seat 6: 9dd125fd folded before Flop (didn't bet)


Poker Hand #RC3141669087: Hold'em No Limit ($0.05/$0.1) - 2024/12/12 12:41:26
Table 'RushAndCash22314347' 6-max Seat #1 is the button
Seat 1: 3e399c74 ($10 in chips)
Seat 2: 80ebdd41 ($11.96 in chips)
Seat 3: Hero ($12.24 in chips)
Seat 4: f2ece23 ($15.14 in chips)
Seat 5: dea1301e ($17.41 in chips)
Seat 6: 35b5987 ($11.89 in chips)
80ebdd41: posts small blind $0.05
Hero: posts big blind $0.1
*** HOLE CARDS ***
Dealt to 3e399c74 
Dealt to 80ebdd41 
Dealt to Hero [9c 8c]
Dealt to f2ece23 
Dealt to dea1301e 
Dealt to 35b5987 
f2ece23: raises $0.1 to $0.2
dea1301e: folds
35b5987: folds
3e399c74: folds
80ebdd41: folds
Hero: calls $0.1
*** FLOP *** [7s 9s 4c]
Hero: checks
f2ece23: checks
*** TURN *** [7s 9s 4c] [9h]
Hero: bets $0.15
f2ece23: folds
Uncalled bet ($0.15) returned to Hero
*** SHOWDOWN ***
Hero collected $0.43 from pot
*** SUMMARY ***
Total pot $0.45 | Rake $0.02 | Jackpot $0 | Bingo $0 | Fortune $0 | Tax $0
Board [7s 9s 4c 9h]
Seat 1: 3e399c74 (button) folded before Flop (didn't bet)
Seat 2: 80ebdd41 (small blind) folded before Flop
Seat 3: Hero (big blind) won ($0.43)
Seat 4: f2ece23 folded on the Turn
Seat 5: dea1301e folded before Flop (didn't bet)
Seat 6: 35b5987 folded before Flop (didn't bet)


Poker Hand #RC3141669033: Hold'em No Limit ($0.05/$0.1) - 2024/12/12 12:41:13
Table 'RushAndCash22314293' 6-max Seat #1 is the button
Seat 1: f383ae87 ($32.1 in chips)
Seat 2: b82279c3 ($39.89 in chips)
Seat 3: d9ccf407 ($20.68 in chips)
Seat 4: bc092e13 ($10 in chips)
Seat 5: Hero ($12.09 in chips)
Seat 6: 9a52083d ($25.13 in chips)
b82279c3: posts small blind $0.05
d9ccf407: posts big blind $0.1
*** HOLE CARDS ***
Dealt to f383ae87 
Dealt to b82279c3 
Dealt to d9ccf407 
Dealt to bc092e13 
Dealt to Hero [Ks Qh]
Dealt to 9a52083d 
bc092e13: folds
Hero: raises $0.1 to $0.2
9a52083d: folds
f383ae87: folds
b82279c3: folds
d9ccf407: folds
Uncalled bet ($0.1) returned to Hero
*** SHOWDOWN ***
Hero collected $0.25 from pot
*** SUMMARY ***
Total pot $0.25 | Rake $0 | Jackpot $0 | Bingo $0 | Fortune $0 | Tax $0
Seat 1: f383ae87 (button) folded before Flop (didn't bet)
Seat 2: b82279c3 (small blind) folded before Flop
Seat 3: d9ccf407 (big blind) folded before Flop
Seat 4: bc092e13 folded before Flop (didn't bet)
Seat 5: Hero collected ($0.25)
Seat 6: 9a52083d folded before Flop (didn't bet)


Poker Hand #RC3141669020: Hold'em No Limit ($0.05/$0.1) - 2024/12/12 12:41:10
Table 'RushAndCash22314280' 6-max Seat #1 is the button
Seat 1: 73df44d1 ($10 in chips)
Seat 2: d43f1d14 ($13.15 in chips)
Seat 3: d19ee248 ($9.9 in chips)
Seat 4: 15f3779a ($18.55 in chips)
Seat 5: Hero ($12.09 in chips)
Seat 6: 97a1e12e ($12.29 in chips)
d43f1d14: posts small blind $0.05
d19ee248: posts big blind $0.1
*** HOLE CARDS ***
Dealt to 73df44d1 
Dealt to d43f1d14 
Dealt to d19ee248 
Dealt to 15f3779a 
Dealt to Hero [5d 8d]
Dealt to 97a1e12e 
15f3779a: raises $0.1 to $0.2
Hero: folds
97a1e12e: folds
73df44d1: folds
d43f1d14: folds
d19ee248: folds
Uncalled bet ($0.1) returned to 15f3779a
*** SHOWDOWN ***
15f3779a collected $0.25 from pot
*** SUMMARY ***
Total pot $0.25 | Rake $0 | Jackpot $0 | Bingo $0 | Fortune $0 | Tax $0
Seat 1: 73df44d1 (button) folded before Flop (didn't bet)
Seat 2: d43f1d14 (small blind) folded before Flop
Seat 3: d19ee248 (big blind) folded before Flop
Seat 4: 15f3779a collected ($0.25)
Seat 5: Hero folded before Flop (didn't bet)
Seat 6: 97a1e12e folded before Flop (didn't bet)


Poker Hand #RC3141669007: Hold'em No Limit ($0.05/$0.1) - 2024/12/12 12:41:06
Table 'RushAndCash22314267' 6-max Seat #1 is the button
Seat 1: Hero ($12.09 in chips)
Seat 2: e0c4f56b ($7.55 in chips)
Seat 3: ee394d0a ($10 in chips)
Seat 4: d19ee248 ($9.9 in chips)
Seat 5: c2b852ae ($12.15 in chips)
Seat 6: af208717 ($15.26 in chips)
e0c4f56b: posts small blind $0.05
ee394d0a: posts big blind $0.1
*** HOLE CARDS ***
Dealt to Hero [3s Td]
Dealt to e0c4f56b 
Dealt to ee394d0a 
Dealt to d19ee248 
Dealt to c2b852ae 
Dealt to af208717 
d19ee248: folds
c2b852ae: raises $0.12 to $0.22
af208717: folds
Hero: folds
e0c4f56b: calls $0.17
ee394d0a: folds
*** FLOP *** [Qd 7c Th]
e0c4f56b: bets $0.27
c2b852ae: calls $0.27
*** TURN *** [Qd 7c Th] [4c]
e0c4f56b: checks
c2b852ae: checks
*** RIVER *** [Qd 7c Th 4c] [4h]
e0c4f56b: checks
c2b852ae: bets $0.81
e0c4f56b: folds
Uncalled bet ($0.81) returned to c2b852ae
*** SHOWDOWN ***
c2b852ae collected $1.03 from pot
*** SUMMARY ***
Total pot $1.08 | Rake $0.05 | Jackpot $0 | Bingo $0 | Fortune $0 | Tax $0
Board [Qd 7c Th 4c 4h]
Seat 1: Hero (button) folded before Flop (didn't bet)
Seat 2: e0c4f56b (small blind) folded on the River
Seat 3: ee394d0a (big blind) folded before Flop
Seat 4: d19ee248 folded before Flop (didn't bet)
Seat 5: c2b852ae won ($1.03)
Seat 6: af208717 folded before Flop (didn't bet)


Poker Hand #RC3141668991: Hold'em No Limit ($0.05/$0.1) - 2024/12/12 12:41:03
Table 'RushAndCash22314251' 6-max Seat #1 is the button
Seat 1: b0f074bd ($11.08 in chips)
Seat 2: f323cdf3 ($12.35 in chips)
Seat 3: f2ece23 ($15.14 in chips)
Seat 4: 8e0a697 ($10 in chips)
Seat 5: Hero ($12.09 in chips)
Seat 6: 902b9d1a ($8.58 in chips)
f323cdf3: posts small blind $0.05
f2ece23: posts big blind $0.1
*** HOLE CARDS ***
Dealt to b0f074bd 
Dealt to f323cdf3 
Dealt to f2ece23 
Dealt to 8e0a697 
Dealt to Hero [2h 4s]
Dealt to 902b9d1a 
8e0a697: folds
Hero: folds
902b9d1a: folds
b0f074bd: folds
f323cdf3: folds
Uncalled bet ($0.05) returned to f2ece23
*** SHOWDOWN ***
f2ece23 collected $0.1 from pot
*** SUMMARY ***
Total pot $0.1 | Rake $0 | Jackpot $0 | Bingo $0 | Fortune $0 | Tax $0
Seat 1: b0f074bd (button) folded before Flop (didn't bet)
Seat 2: f323cdf3 (small blind) folded before Flop
Seat 3: f2ece23 (big blind) collected ($0.1)
Seat 4: 8e0a697 folded before Flop (didn't bet)
Seat 5: Hero folded before Flop (didn't bet)
Seat 6: 902b9d1a folded before Flop (didn't bet)


Poker Hand #RC3141668962: Hold'em No Limit ($0.05/$0.1) - 2024/12/12 12:40:56
Table 'RushAndCash22314222' 6-max Seat #1 is the button
Seat 1: 8a31e4cb ($9.75 in chips)
Seat 2: Hero ($12.14 in chips)
Seat 3: f500aed7 ($10.7 in chips)
Seat 4: 82766ff ($17.33 in chips)
Seat 5: 6fceecd ($14.62 in chips)
Seat 6: b57eea46 ($9.85 in chips)
Hero: posts small blind $0.05
f500aed7: posts big blind $0.1
*** HOLE CARDS ***
Dealt to 8a31e4cb 
Dealt to Hero [Qc 8s]
Dealt to f500aed7 
Dealt to 82766ff 
Dealt to 6fceecd 
Dealt to b57eea46 
82766ff: folds
6fceecd: folds
b57eea46: folds
8a31e4cb: raises $0.11 to $0.21
Hero: folds
f500aed7: folds
Uncalled bet ($0.11) returned to 8a31e4cb
*** SHOWDOWN ***
8a31e4cb collected $0.25 from pot
*** SUMMARY ***
Total pot $0.25 | Rake $0 | Jackpot $0 | Bingo $0 | Fortune $0 | Tax $0
Seat 1: 8a31e4cb (button) collected ($0.25)
Seat 2: Hero (small blind) folded before Flop
Seat 3: f500aed7 (big blind) folded before Flop
Seat 4: 82766ff folded before Flop (didn't bet)
Seat 5: 6fceecd folded before Flop (didn't bet)
Seat 6: b57eea46 folded before Flop (didn't bet)


Poker Hand #RC3141668699: Hold'em No Limit ($0.05/$0.1) - 2024/12/12 12:39:53
Table 'RushAndCash22313959' 6-max Seat #1 is the button
Seat 1: f500aed7 ($11.65 in chips)
Seat 2: bb835227 ($10.33 in chips)
Seat 3: Hero ($11.23 in chips)
Seat 4: 204f692c ($10 in chips)
Seat 5: 86cef673 ($27.75 in chips)
Seat 6: 4897b3f2 ($19.62 in chips)
bb835227: posts small blind $0.05
Hero: posts big blind $0.1
*** HOLE CARDS ***
Dealt to f500aed7 
Dealt to bb835227 
Dealt to Hero [Ts Jc]
Dealt to 204f692c 
Dealt to 86cef673 
Dealt to 4897b3f2 
204f692c: folds
86cef673: folds
4897b3f2: folds
f500aed7: raises $0.15 to $0.25
bb835227: folds
Hero: calls $0.15
*** FLOP *** [Kd 6s 9h]
Hero: checks
f500aed7: bets $0.19
Hero: raises $0.51 to $0.7
f500aed7: calls $0.51
*** TURN *** [Kd 6s 9h] [5s]
Hero: bets $1.47
f500aed7: folds
Uncalled bet ($1.47) returned to Hero
*** SHOWDOWN ***
Hero collected $1.86 from pot
*** SUMMARY ***
Total pot $1.95 | Rake $0.09 | Jackpot $0 | Bingo $0 | Fortune $0 | Tax $0
Board [Kd 6s 9h 5s]
Seat 1: f500aed7 (button) folded on the Turn
Seat 2: bb835227 (small blind) folded before Flop
Seat 3: Hero (big blind) won ($1.86)
Seat 4: 204f692c folded before Flop (didn't bet)
Seat 5: 86cef673 folded before Flop (didn't bet)
Seat 6: 4897b3f2 folded before Flop (didn't bet)


Poker Hand #RC3141668684: Hold'em No Limit ($0.05/$0.1) - 2024/12/12 12:39:50
Table 'RushAndCash22313944' 6-max Seat #1 is the button
Seat 1: 77907fc4 ($23.92 in chips)
Seat 2: cd32f772 ($6.84 in chips)
Seat 3: bb835227 ($10.43 in chips)
Seat 4: Hero ($11.23 in chips)
Seat 5: f500aed7 ($11.65 in chips)
Seat 6: ce410800 ($10.42 in chips)
cd32f772: posts small blind $0.05
bb835227: posts big blind $0.1
*** HOLE CARDS ***
Dealt to 77907fc4 
Dealt to cd32f772 
Dealt to bb835227 
Dealt to Hero [Ks 4h]
Dealt to f500aed7 
Dealt to ce410800 
Hero: folds
f500aed7: folds
ce410800: folds
77907fc4: raises $0.1 to $0.2
cd32f772: folds
bb835227: folds
Uncalled bet ($0.1) returned to 77907fc4
*** SHOWDOWN ***
77907fc4 collected $0.25 from pot
*** SUMMARY ***
Total pot $0.25 | Rake $0 | Jackpot $0 | Bingo $0 | Fortune $0 | Tax $0
Seat 1: 77907fc4 (button) collected ($0.25)
Seat 2: cd32f772 (small blind) folded before Flop
Seat 3: bb835227 (big blind) folded before Flop
Seat 4: Hero folded before Flop (didn't bet)
Seat 5: f500aed7 folded before Flop (didn't bet)
Seat 6: ce410800 folded before Flop (didn't bet)


Poker Hand #RC3141668663: Hold'em No Limit ($0.05/$0.1) - 2024/12/12 12:39:44
Table 'RushAndCash22313923' 6-max Seat #1 is the button
Seat 1: 6fceecd ($13.8 in chips)
Seat 2: 2ff0a04b ($41.49 in chips)
Seat 3: 40c5a5bd ($11.84 in chips)
Seat 4: 4eb4d0d6 ($8.87 in chips)
Seat 5: Hero ($11.23 in chips)
Seat 6: b73e1c09 ($25.52 in chips)
2ff0a04b: posts small blind $0.05
40c5a5bd: posts big blind $0.1
*** HOLE CARDS ***
Dealt to 6fceecd 
Dealt to 2ff0a04b 
Dealt to 40c5a5bd 
Dealt to 4eb4d0d6 
Dealt to Hero [Kc 5c]
Dealt to b73e1c09 
4eb4d0d6: raises $0.1 to $0.2
Hero: folds
b73e1c09: folds
6fceecd: raises $0.42 to $0.62
2ff0a04b: folds
40c5a5bd: folds
4eb4d0d6: calls $0.42
*** FLOP *** [Js 4h Jc]
4eb4d0d6: checks
6fceecd: bets $0.13
4eb4d0d6: calls $0.13
*** TURN *** [Js 4h Jc] [4c]
4eb4d0d6: checks
6fceecd: bets $0.55
4eb4d0d6: folds
Uncalled bet ($0.55) returned to 6fceecd
*** SHOWDOWN ***
6fceecd collected $1.57 from pot
*** SUMMARY ***
Total pot $1.65 | Rake $0.08 | Jackpot $0 | Bingo $0 | Fortune $0 | Tax $0
Board [Js 4h Jc 4c]
Seat 1: 6fceecd (button) won ($1.57)
Seat 2: 2ff0a04b (small blind) folded before Flop
Seat 3: 40c5a5bd (big blind) folded before Flop
Seat 4: 4eb4d0d6 folded on the Turn
Seat 5: Hero folded before Flop (didn't bet)
Seat 6: b73e1c09 folded before Flop (didn't bet)


Poker Hand #RC3141668643: Hold'em No Limit ($0.05/$0.1) - 2024/12/12 12:39:40
Table 'RushAndCash22313903' 6-max Seat #1 is the button
Seat 1: 204f692c ($10 in chips)
Seat 2: 4a1f9c37 ($14.58 in chips)
Seat 3: 8b97e239 ($10.5 in chips)
Seat 4: ea8b094 ($7.18 in chips)
Seat 5: Hero ($11.23 in chips)
Seat 6: 5fd159a6 ($16.9 in chips)
4a1f9c37: posts small blind $0.05
8b97e239: posts big blind $0.1
*** HOLE CARDS ***
Dealt to 204f692c 
Dealt to 4a1f9c37 
Dealt to 8b97e239 
Dealt to ea8b094 
Dealt to Hero [6d Ac]
Dealt to 5fd159a6 
ea8b094: folds
Hero: folds
5fd159a6: raises $0.12 to $0.22
204f692c: folds
4a1f9c37: folds
8b97e239: folds
Uncalled bet ($0.12) returned to 5fd159a6
*** SHOWDOWN ***
5fd159a6 collected $0.25 from pot
*** SUMMARY ***
Total pot $0.25 | Rake $0 | Jackpot $0 | Bingo $0 | Fortune $0 | Tax $0
Seat 1: 204f692c (button) folded before Flop (didn't bet)
Seat 2: 4a1f9c37 (small blind) folded before Flop
Seat 3: 8b97e239 (big blind) folded before Flop
Seat 4: ea8b094 folded before Flop (didn't bet)
Seat 5: Hero folded before Flop (didn't bet)
Seat 6: 5fd159a6 collected ($0.25)


Poker Hand #RC3141668596: Hold'em No Limit ($0.05/$0.1) - 2024/12/12 12:39:29
Table 'RushAndCash22313856' 6-max Seat #1 is the button
Seat 1: Hero ($11.23 in chips)
Seat 2: 56ee5f48 ($17.51 in chips)
Seat 3: 204f692c ($10 in chips)
Seat 4: 493432cf ($13.59 in chips)
Seat 5: aca45379 ($13.5 in chips)
Seat 6: 1c087ec5 ($40.87 in chips)
56ee5f48: posts small blind $0.05
204f692c: posts big blind $0.1
*** HOLE CARDS ***
Dealt to Hero [Tc 9c]
Dealt to 56ee5f48 
Dealt to 204f692c 
Dealt to 493432cf 
Dealt to aca45379 
Dealt to 1c087ec5 
493432cf: folds
aca45379: raises $0.1 to $0.2
1c087ec5: folds
Hero: folds
56ee5f48: folds
204f692c: folds
Uncalled bet ($0.1) returned to aca45379
*** SHOWDOWN ***
aca45379 collected $0.25 from pot
*** SUMMARY ***
Total pot $0.25 | Rake $0 | Jackpot $0 | Bingo $0 | Fortune $0 | Tax $0
Seat 1: Hero (button) folded before Flop (didn't bet)
Seat 2: 56ee5f48 (small blind) folded before Flop
Seat 3: 204f692c (big blind) folded before Flop
Seat 4: 493432cf folded before Flop (didn't bet)
Seat 5: aca45379 collected ($0.25)
Seat 6: 1c087ec5 folded before Flop (didn't bet)


Poker Hand #RC3141668584: Hold'em No Limit ($0.05/$0.1) - 2024/12/12 12:39:25
Table 'RushAndCash22313844' 6-max Seat #1 is the button
Seat 1: e18303a2 ($12.54 in chips)
Seat 2: Hero ($11.28 in chips)
Seat 3: d6b17ac7 ($10.53 in chips)
Seat 4: b053d810 ($10.98 in chips)
Seat 5: aca45379 ($13.5 in chips)
Seat 6: 493432cf ($13.59 in chips)
Hero: posts small blind $0.05
d6b17ac7: posts big blind $0.1
*** HOLE CARDS ***
Dealt to e18303a2 
Dealt to Hero [2s 5h]
Dealt to d6b17ac7 
Dealt to b053d810 
Dealt to aca45379 
Dealt to 493432cf 
b053d810: folds
aca45379: folds
493432cf: folds
e18303a2: folds
Hero: folds
Uncalled bet ($0.05) returned to d6b17ac7
*** SHOWDOWN ***
d6b17ac7 collected $0.1 from pot
*** SUMMARY ***
Total pot $0.1 | Rake $0 | Jackpot $0 | Bingo $0 | Fortune $0 | Tax $0
Seat 1: e18303a2 (button) folded before Flop (didn't bet)
Seat 2: Hero (small blind) folded before Flop
Seat 3: d6b17ac7 (big blind) collected ($0.1)
Seat 4: b053d810 folded before Flop (didn't bet)
Seat 5: aca45379 folded before Flop (didn't bet)
Seat 6: 493432cf folded before Flop (didn't bet)


Poker Hand #RC3141668526: Hold'em No Limit ($0.05/$0.1) - 2024/12/12 12:39:11
Table 'RushAndCash22313786' 6-max Seat #1 is the button
Seat 1: cc63da9c ($10.23 in chips)
Seat 2: a35a0951 ($7.81 in chips)
Seat 3: Hero ($11.38 in chips)
Seat 4: b053d810 ($10.88 in chips)
Seat 5: 54a8e111 ($10.05 in chips)
Seat 6: 26efdee0 ($13.98 in chips)
a35a0951: posts small blind $0.05
Hero: posts big blind $0.1
*** HOLE CARDS ***
Dealt to cc63da9c 
Dealt to a35a0951 
Dealt to Hero [8h Jc]
Dealt to b053d810 
Dealt to 54a8e111 
Dealt to 26efdee0 
b053d810: folds
54a8e111: folds
26efdee0: folds
cc63da9c: raises $0.1 to $0.2
a35a0951: folds
Hero: folds
Uncalled bet ($0.1) returned to cc63da9c
*** SHOWDOWN ***
cc63da9c collected $0.25 from pot
*** SUMMARY ***
Total pot $0.25 | Rake $0 | Jackpot $0 | Bingo $0 | Fortune $0 | Tax $0
Seat 1: cc63da9c (button) collected ($0.25)
Seat 2: a35a0951 (small blind) folded before Flop
Seat 3: Hero (big blind) folded before Flop
Seat 4: b053d810 folded before Flop (didn't bet)
Seat 5: 54a8e111 folded before Flop (didn't bet)
Seat 6: 26efdee0 folded before Flop (didn't bet)


Poker Hand #RC3141668514: Hold'em No Limit ($0.05/$0.1) - 2024/12/12 12:39:07
Table 'RushAndCash22313774' 6-max Seat #1 is the button
Seat 1: 597469a5 ($15.88 in chips)
Seat 2: 6dcb955a ($10 in chips)
Seat 3: 11a00985 ($21.47 in chips)
Seat 4: 1c087ec5 ($40.72 in chips)
Seat 5: Hero ($11.38 in chips)
Seat 6: a6717311 ($19.93 in chips)
6dcb955a: posts small blind $0.05
11a00985: posts big blind $0.1
*** HOLE CARDS ***
Dealt to 597469a5 
Dealt to 6dcb955a 
Dealt to 11a00985 
Dealt to 1c087ec5 
Dealt to Hero [6d Js]
Dealt to a6717311 
1c087ec5: raises $0.2 to $0.3
Hero: folds
a6717311: folds
597469a5: folds
6dcb955a: folds
11a00985: folds
Uncalled bet ($0.2) returned to 1c087ec5
*** SHOWDOWN ***
1c087ec5 collected $0.25 from pot
*** SUMMARY ***
Total pot $0.25 | Rake $0 | Jackpot $0 | Bingo $0 | Fortune $0 | Tax $0
Seat 1: 597469a5 (button) folded before Flop (didn't bet)
Seat 2: 6dcb955a (small blind) folded before Flop
Seat 3: 11a00985 (big blind) folded before Flop
Seat 4: 1c087ec5 collected ($0.25)
Seat 5: Hero folded before Flop (didn't bet)
Seat 6: a6717311 folded before Flop (didn't bet)


Poker Hand #RC3141668500: Hold'em No Limit ($0.05/$0.1) - 2024/12/12 12:39:04
Table 'RushAndCash22313760' 6-max Seat #1 is the button
Seat 1: ee992e7e ($10.15 in chips)
Seat 2: 574859ba ($10 in chips)
Seat 3: eb765b8f ($11.88 in chips)
Seat 4: Hero ($11.38 in chips)
Seat 5: f7ecedd7 ($12.32 in chips)
Seat 6: 6dcb955a ($10 in chips)
574859ba: posts small blind $0.05
eb765b8f: posts big blind $0.1
*** HOLE CARDS ***
Dealt to ee992e7e 
Dealt to 574859ba 
Dealt to eb765b8f 
Dealt to Hero [5c 7s]
Dealt to f7ecedd7 
Dealt to 6dcb955a 
Hero: folds
f7ecedd7: raises $0.1 to $0.2
6dcb955a: folds
ee992e7e: folds
574859ba: folds
eb765b8f: folds
Uncalled bet ($0.1) returned to f7ecedd7
*** SHOWDOWN ***
f7ecedd7 collected $0.25 from pot
*** SUMMARY ***
Total pot $0.25 | Rake $0 | Jackpot $0 | Bingo $0 | Fortune $0 | Tax $0
Seat 1: ee992e7e (button) folded before Flop (didn't bet)
Seat 2: 574859ba (small blind) folded before Flop
Seat 3: eb765b8f (big blind) folded before Flop
Seat 4: Hero folded before Flop (didn't bet)
Seat 5: f7ecedd7 collected ($0.25)
Seat 6: 6dcb955a folded before Flop (didn't bet)


Poker Hand #RC3141668485: Hold'em No Limit ($0.05/$0.1) - 2024/12/12 12:39:01
Table 'RushAndCash22313745' 6-max Seat #1 is the button
Seat 1: 788303ec ($40.68 in chips)
Seat 2: af208717 ($16.59 in chips)
Seat 3: f04fb852 ($10 in chips)
Seat 4: Hero ($11.38 in chips)
Seat 5: e12528c0 ($34.06 in chips)
Seat 6: ee992e7e ($10.15 in chips)
af208717: posts small blind $0.05
f04fb852: posts big blind $0.1
*** HOLE CARDS ***
Dealt to 788303ec 
Dealt to af208717 
Dealt to f04fb852 
Dealt to Hero [6d 2s]
Dealt to e12528c0 
Dealt to ee992e7e 
Hero: folds
e12528c0: folds
ee992e7e: folds
788303ec: folds
af208717: folds
Uncalled bet ($0.05) returned to f04fb852
*** SHOWDOWN ***
f04fb852 collected $0.1 from pot
*** SUMMARY ***
Total pot $0.1 | Rake $0 | Jackpot $0 | Bingo $0 | Fortune $0 | Tax $0
Seat 1: 788303ec (button) folded before Flop (didn't bet)
Seat 2: af208717 (small blind) folded before Flop
Seat 3: f04fb852 (big blind) collected ($0.1)
Seat 4: Hero folded before Flop (didn't bet)
Seat 5: e12528c0 folded before Flop (didn't bet)
Seat 6: ee992e7e folded before Flop (didn't bet)


Poker Hand #RC3141668471: Hold'em No Limit ($0.05/$0.1) - 2024/12/12 12:38:57
Table 'RushAndCash22313731' 6-max Seat #1 is the button
Seat 1: Hero ($11.38 in chips)
Seat 2: 6b9a34dd ($4.77 in chips)
Seat 3: 228a039d ($14.03 in chips)
Seat 4: 17b381d5 ($25.63 in chips)
Seat 5: ee992e7e ($10.15 in chips)
Seat 6: 5b14e7af ($20.88 in chips)
6b9a34dd: posts small blind $0.05
228a039d: posts big blind $0.1
*** HOLE CARDS ***
Dealt to Hero [6h 7s]
Dealt to 6b9a34dd 
Dealt to 228a039d 
Dealt to 17b381d5 
Dealt to ee992e7e 
Dealt to 5b14e7af 
17b381d5: raises $0.1 to $0.2
ee992e7e: folds
5b14e7af: folds
Hero: folds
6b9a34dd: folds
228a039d: folds
Uncalled bet ($0.1) returned to 17b381d5
*** SHOWDOWN ***
17b381d5 collected $0.25 from pot
*** SUMMARY ***
Total pot $0.25 | Rake $0 | Jackpot $0 | Bingo $0 | Fortune $0 | Tax $0
Seat 1: Hero (button) folded before Flop (didn't bet)
Seat 2: 6b9a34dd (small blind) folded before Flop
Seat 3: 228a039d (big blind) folded before Flop
Seat 4: 17b381d5 collected ($0.25)
Seat 5: ee992e7e folded before Flop (didn't bet)
Seat 6: 5b14e7af folded before Flop (didn't bet)


Poker Hand #RC3141668424: Hold'em No Limit ($0.05/$0.1) - 2024/12/12 12:38:46
Table 'RushAndCash22313684' 6-max Seat #1 is the button
Seat 1: 5304ad76 ($10.72 in chips)
Seat 2: Hero ($11.43 in chips)
Seat 3: 1e41d97e ($8.39 in chips)
Seat 4: d43f1d14 ($12.14 in chips)
Seat 5: 574859ba ($10 in chips)
Seat 6: 8499417 ($10.97 in chips)
Hero: posts small blind $0.05
1e41d97e: posts big blind $0.1
*** HOLE CARDS ***
Dealt to 5304ad76 
Dealt to Hero [9d 8d]
Dealt to 1e41d97e 
Dealt to d43f1d14 
Dealt to 574859ba 
Dealt to 8499417 
d43f1d14: raises $0.12 to $0.22
574859ba: folds
8499417: folds
5304ad76: raises $0.45 to $0.67
Hero: folds
1e41d97e: folds
d43f1d14: folds
Uncalled bet ($0.45) returned to 5304ad76
*** SHOWDOWN ***
5304ad76 collected $0.56 from pot
*** SUMMARY ***
Total pot $0.59 | Rake $0.03 | Jackpot $0 | Bingo $0 | Fortune $0 | Tax $0
Seat 1: 5304ad76 (button) collected ($0.56)
Seat 2: Hero (small blind) folded before Flop
Seat 3: 1e41d97e (big blind) folded before Flop
Seat 4: d43f1d14 folded before Flop
Seat 5: 574859ba folded before Flop (didn't bet)
Seat 6: 8499417 folded before Flop (didn't bet)


Poker Hand #RC3141668382: Hold'em No Limit ($0.05/$0.1) - 2024/12/12 12:38:33
Table 'RushAndCash22313642' 6-max Seat #1 is the button
Seat 1: 9a7505e ($14.93 in chips)
Seat 2: f500aed7 ($11.8 in chips)
Seat 3: Hero ($11.53 in chips)
Seat 4: f323cdf3 ($10 in chips)
Seat 5: 228a039d ($14.08 in chips)
Seat 6: 3d7948d ($10 in chips)
f500aed7: posts small blind $0.05
Hero: posts big blind $0.1
*** HOLE CARDS ***
Dealt to 9a7505e 
Dealt to f500aed7 
Dealt to Hero [Ac 7c]
Dealt to f323cdf3 
Dealt to 228a039d 
Dealt to 3d7948d 
f323cdf3: raises $0.1 to $0.2
228a039d: folds
3d7948d: calls $0.2
9a7505e: folds
f500aed7: calls $0.15
Hero: folds
*** FLOP *** [8h 9h 8s]
f500aed7: checks
f323cdf3: checks
3d7948d: checks
*** TURN *** [8h 9h 8s] [7s]
f500aed7: checks
f323cdf3: bets $0.35
3d7948d: calls $0.35
f500aed7: folds
*** RIVER *** [8h 9h 8s 7s] [Js]
f323cdf3: checks
3d7948d: checks
f323cdf3: shows [7d 7h] (Sevens Full over Eights)
3d7948d: shows [Qh Qd] (Pair of Queens and Pair of Eights)
*** SHOWDOWN ***
f323cdf3 collected $1.33 from pot
*** SUMMARY ***
Total pot $1.4 | Rake $0.07 | Jackpot $0 | Bingo $0 | Fortune $0 | Tax $0
Board [8h 9h 8s 7s Js]
Seat 1: 9a7505e (button) folded before Flop (didn't bet)
Seat 2: f500aed7 (small blind) folded on the Turn
Seat 3: Hero (big blind) folded before Flop
Seat 4: f323cdf3 showed [7d 7h] and won ($1.33) with Sevens Full over Eights
Seat 5: 228a039d folded before Flop (didn't bet)
Seat 6: 3d7948d showed [Qh Qd] and lost with Pair of Queens and Pair of Eights


Poker Hand #RC3141668368: Hold'em No Limit ($0.05/$0.1) - 2024/12/12 12:38:30
Table 'RushAndCash22313628' 6-max Seat #1 is the button
Seat 1: 9ab5b010 ($24.28 in chips)
Seat 2: f5628a04 ($10 in chips)
Seat 3: b37e3efe ($14.68 in chips)
Seat 4: b69e52ed ($10.44 in chips)
Seat 5: Hero ($11.53 in chips)
Seat 6: 558d330b ($10 in chips)
f5628a04: posts small blind $0.05
b37e3efe: posts big blind $0.1
*** HOLE CARDS ***
Dealt to 9ab5b010 
Dealt to f5628a04 
Dealt to b37e3efe 
Dealt to b69e52ed 
Dealt to Hero [Jd 7h]
Dealt to 558d330b 
b69e52ed: folds
Hero: folds
558d330b: raises $0.2 to $0.3
9ab5b010: folds
f5628a04: folds
b37e3efe: folds
Uncalled bet ($0.2) returned to 558d330b
*** SHOWDOWN ***
558d330b collected $0.25 from pot
*** SUMMARY ***
Total pot $0.25 | Rake $0 | Jackpot $0 | Bingo $0 | Fortune $0 | Tax $0
Seat 1: 9ab5b010 (button) folded before Flop (didn't bet)
Seat 2: f5628a04 (small blind) folded before Flop
Seat 3: b37e3efe (big blind) folded before Flop
Seat 4: b69e52ed folded before Flop (didn't bet)
Seat 5: Hero folded before Flop (didn't bet)
Seat 6: 558d330b collected ($0.25)


Poker Hand #RC3141668325: Hold'em No Limit ($0.05/$0.1) - 2024/12/12 12:38:19
Table 'RushAndCash22313585' 6-max Seat #1 is the button
Seat 1: 7ea060c8 ($9.31 in chips)
Seat 2: 9c5748d ($23.57 in chips)
Seat 3: 97a1e12e ($12.46 in chips)
Seat 4: Hero ($11.53 in chips)
Seat 5: e9fe744a ($35.38 in chips)
Seat 6: d75a3941 ($10.46 in chips)
9c5748d: posts small blind $0.05
97a1e12e: posts big blind $0.1
*** HOLE CARDS ***
Dealt to 7ea060c8 
Dealt to 9c5748d 
Dealt to 97a1e12e 
Dealt to Hero [Ac 2h]
Dealt to e9fe744a 
Dealt to d75a3941 
Hero: folds
e9fe744a: folds
d75a3941: folds
7ea060c8: folds
9c5748d: raises $0.2 to $0.3
97a1e12e: folds
Uncalled bet ($0.2) returned to 9c5748d
*** SHOWDOWN ***
9c5748d collected $0.2 from pot
*** SUMMARY ***
Total pot $0.2 | Rake $0 | Jackpot $0 | Bingo $0 | Fortune $0 | Tax $0
Seat 1: 7ea060c8 (button) folded before Flop (didn't bet)
Seat 2: 9c5748d (small blind) collected ($0.2)
Seat 3: 97a1e12e (big blind) folded before Flop
Seat 4: Hero folded before Flop (didn't bet)
Seat 5: e9fe744a folded before Flop (didn't bet)
Seat 6: d75a3941 folded before Flop (didn't bet)


Poker Hand #RC3141668274: Hold'em No Limit ($0.05/$0.1) - 2024/12/12 12:38:05
Table 'RushAndCash22313534' 6-max Seat #1 is the button
Seat 1: 59de94fc ($19.17 in chips)
Seat 2: 1d37642 ($9.27 in chips)
Seat 3: b73e1c09 ($25.34 in chips)
Seat 4: daa081a6 ($10.68 in chips)
Seat 5: Hero ($11.53 in chips)
Seat 6: e3914f0b ($25.04 in chips)
1d37642: posts small blind $0.05
b73e1c09: posts big blind $0.1
*** HOLE CARDS ***
Dealt to 59de94fc 
Dealt to 1d37642 
Dealt to b73e1c09 
Dealt to daa081a6 
Dealt to Hero [6d Ad]
Dealt to e3914f0b 
daa081a6: raises $0.15 to $0.25
Hero: folds
e3914f0b: folds
59de94fc: raises $0.55 to $0.8
1d37642: folds
b73e1c09: folds
daa081a6: raises $1.32 to $2.12
59de94fc: calls $1.32
*** FLOP *** [7c 8d Ah]
daa081a6: bets $1.2
59de94fc: calls $1.2
*** TURN *** [7c 8d Ah] [Jd]
daa081a6: checks
59de94fc: checks
*** RIVER *** [7c 8d Ah Jd] [Kd]
daa081a6: checks
59de94fc: checks
daa081a6: shows [Ac As] (Three Aces)
59de94fc: shows [Qc Qh] (Pair of Queens)
*** SHOWDOWN ***
daa081a6 collected $6.34 from pot
*** SUMMARY ***
Total pot $6.79 | Rake $0.3 | Jackpot $0.15 | Bingo $0 | Fortune $0 | Tax $0
Board [7c 8d Ah Jd Kd]
Seat 1: 59de94fc (button) showed [Qc Qh] and lost with Pair of Queens
Seat 2: 1d37642 (small blind) folded before Flop
Seat 3: b73e1c09 (big blind) folded before Flop
Seat 4: daa081a6 showed [Ac As] and won ($6.34) with Three Aces
Seat 5: Hero folded before Flop (didn't bet)
Seat 6: e3914f0b folded before Flop (didn't bet)


Poker Hand #RC3141668209: Hold'em No Limit ($0.05/$0.1) - 2024/12/12 12:37:46
Table 'RushAndCash22313469' 6-max Seat #1 is the button
Seat 1: 916c6bd3 ($3.31 in chips)
Seat 2: d940390d ($13.04 in chips)
Seat 3: 574859ba ($10 in chips)
Seat 4: Hero ($11.53 in chips)
Seat 5: 2db5d1cb ($12.8 in chips)
Seat 6: 4c71ba67 ($11.06 in chips)
d940390d: posts small blind $0.05
574859ba: posts big blind $0.1
*** HOLE CARDS ***
Dealt to 916c6bd3 
Dealt to d940390d 
Dealt to 574859ba 
Dealt to Hero [Kh 5c]
Dealt to 2db5d1cb 
Dealt to 4c71ba67 
Hero: folds
2db5d1cb: folds
4c71ba67: folds
916c6bd3: raises $0.1 to $0.2
d940390d: folds
574859ba: calls $0.1
*** FLOP *** [Js 4s Tc]
574859ba: checks
916c6bd3: bets $0.34
574859ba: folds
Uncalled bet ($0.34) returned to 916c6bd3
*** SHOWDOWN ***
916c6bd3 collected $0.43 from pot
*** SUMMARY ***
Total pot $0.45 | Rake $0.02 | Jackpot $0 | Bingo $0 | Fortune $0 | Tax $0
Board [Js 4s Tc]
Seat 1: 916c6bd3 (button) won ($0.43)
Seat 2: d940390d (small blind) folded before Flop
Seat 3: 574859ba (big blind) folded on the Flop
Seat 4: Hero folded before Flop (didn't bet)
Seat 5: 2db5d1cb folded before Flop (didn't bet)
Seat 6: 4c71ba67 folded before Flop (didn't bet)


Poker Hand #RC3141668179: Hold'em No Limit ($0.05/$0.1) - 2024/12/12 12:37:38
Table 'RushAndCash22313439' 6-max Seat #1 is the button
Seat 1: 556a8b26 ($10 in chips)
Seat 2: 38992bb8 ($22.98 in chips)
Seat 3: Hero ($11.63 in chips)
Seat 4: 5ab2e15d ($10.1 in chips)
Seat 5: f0c37558 ($11.94 in chips)
Seat 6: 6753f046 ($41.86 in chips)
38992bb8: posts small blind $0.05
Hero: posts big blind $0.1
*** HOLE CARDS ***
Dealt to 556a8b26 
Dealt to 38992bb8 
Dealt to Hero [Qs 2c]
Dealt to 5ab2e15d 
Dealt to f0c37558 
Dealt to 6753f046 
5ab2e15d: folds
f0c37558: folds
6753f046: folds
556a8b26: folds
38992bb8: raises $0.2 to $0.3
Hero: folds
Uncalled bet ($0.2) returned to 38992bb8
*** SHOWDOWN ***
38992bb8 collected $0.2 from pot
*** SUMMARY ***
Total pot $0.2 | Rake $0 | Jackpot $0 | Bingo $0 | Fortune $0 | Tax $0
Seat 1: 556a8b26 (button) folded before Flop (didn't bet)
Seat 2: 38992bb8 (small blind) collected ($0.2)
Seat 3: Hero (big blind) folded before Flop
Seat 4: 5ab2e15d folded before Flop (didn't bet)
Seat 5: f0c37558 folded before Flop (didn't bet)
Seat 6: 6753f046 folded before Flop (didn't bet)


Poker Hand #RC3141668124: Hold'em No Limit ($0.05/$0.1) - 2024/12/12 12:37:25
Table 'RushAndCash22313384' 6-max Seat #1 is the button
Seat 1: Hero ($11.48 in chips)
Seat 2: 84849e11 ($83.75 in chips)
Seat 3: be2bfc8f ($10 in chips)
Seat 4: 9c5748d ($23.57 in chips)
Seat 5: 1039fde1 ($11.29 in chips)
Seat 6: 6fceecd ($11.46 in chips)
84849e11: posts small blind $0.05
be2bfc8f: posts big blind $0.1
*** HOLE CARDS ***
Dealt to Hero [5d Ac]
Dealt to 84849e11 
Dealt to be2bfc8f 
Dealt to 9c5748d 
Dealt to 1039fde1 
Dealt to 6fceecd 
9c5748d: folds
1039fde1: folds
6fceecd: folds
Hero: raises $0.15 to $0.25
84849e11: folds
be2bfc8f: folds
Uncalled bet ($0.15) returned to Hero
*** SHOWDOWN ***
Hero collected $0.25 from pot
*** SUMMARY ***
Total pot $0.25 | Rake $0 | Jackpot $0 | Bingo $0 | Fortune $0 | Tax $0
Seat 1: Hero (button) collected ($0.25)
Seat 2: 84849e11 (small blind) folded before Flop
Seat 3: be2bfc8f (big blind) folded before Flop
Seat 4: 9c5748d folded before Flop (didn't bet)
Seat 5: 1039fde1 folded before Flop (didn't bet)
Seat 6: 6fceecd folded before Flop (didn't bet)


Poker Hand #RC3141667986: Hold'em No Limit ($0.05/$0.1) - 2024/12/12 12:36:50
Table 'RushAndCash22313246' 6-max Seat #1 is the button
Seat 1: 55e0af0 ($10 in chips)
Seat 2: Hero ($10.15 in chips)
Seat 3: 916c6bd3 ($3.41 in chips)
Seat 4: f323cdf3 ($10.05 in chips)
Seat 5: 9c5748d ($23.67 in chips)
Seat 6: c4d674fe ($10.11 in chips)
Cash Drop to Pot : total $1 
Hero: posts small blind $0.05
916c6bd3: posts big blind $0.1
*** HOLE CARDS ***
Dealt to 55e0af0 
Dealt to Hero [As Qs]
Dealt to 916c6bd3 
Dealt to f323cdf3 
Dealt to 9c5748d 
Dealt to c4d674fe 
f323cdf3: calls $0.1
9c5748d: calls $0.1
c4d674fe: folds
55e0af0: calls $0.1
Hero: raises $10.05 to $10.15 and is all-in
916c6bd3: folds
f323cdf3: folds
9c5748d: folds
55e0af0: folds
Uncalled bet ($10.05) returned to Hero
*** SHOWDOWN ***
Hero collected $1.43 from pot
*** SUMMARY ***
Total pot $1.5 | Rake $0.07 | Jackpot $0 | Bingo $0 | Fortune $0 | Tax $0
Seat 1: 55e0af0 (button) folded before Flop
Seat 2: Hero (small blind) collected ($1.43)
Seat 3: 916c6bd3 (big blind) folded before Flop
Seat 4: f323cdf3 folded before Flop
Seat 5: 9c5748d folded before Flop
Seat 6: c4d674fe folded before Flop (didn't bet)


Poker Hand #RC3141667916: Hold'em No Limit ($0.05/$0.1) - 2024/12/12 12:36:34
Table 'RushAndCash22313176' 6-max Seat #1 is the button
Seat 1: c2b852ae ($11.45 in chips)
Seat 2: e6eec7bb ($11.3 in chips)
Seat 3: e0a6d1b8 ($10.97 in chips)
Seat 4: 6fceecd ($10.33 in chips)
Seat 5: ea8b094 ($6.95 in chips)
Seat 6: Hero ($10 in chips)
e6eec7bb: posts small blind $0.05
e0a6d1b8: posts big blind $0.1
*** HOLE CARDS ***
Dealt to c2b852ae 
Dealt to e6eec7bb 
Dealt to e0a6d1b8 
Dealt to 6fceecd 
Dealt to ea8b094 
Dealt to Hero [4h 4d]
6fceecd: folds
ea8b094: folds
Hero: raises $0.1 to $0.2
c2b852ae: folds
e6eec7bb: folds
e0a6d1b8: folds
Uncalled bet ($0.1) returned to Hero
*** SHOWDOWN ***
Hero collected $0.25 from pot
*** SUMMARY ***
Total pot $0.25 | Rake $0 | Jackpot $0 | Bingo $0 | Fortune $0 | Tax $0
Seat 1: c2b852ae (button) folded before Flop (didn't bet)
Seat 2: e6eec7bb (small blind) folded before Flop
Seat 3: e0a6d1b8 (big blind) folded before Flop
Seat 4: 6fceecd folded before Flop (didn't bet)
Seat 5: ea8b094 folded before Flop (didn't bet)
Seat 6: Hero collected ($0.25)


Poker Hand #RC3141667893: Hold'em No Limit ($0.05/$0.1) - 2024/12/12 12:36:29
Table 'RushAndCash22313153' 6-max Seat #1 is the button
Seat 1: 1e25b5bb ($13.47 in chips)
Seat 2: ae47099b ($13.69 in chips)
Seat 3: bb835227 ($10.81 in chips)
Seat 4: 4d1634eb ($10.1 in chips)
Seat 5: Hero ($10 in chips)
Seat 6: 9c716b19 ($13.04 in chips)
ae47099b: posts small blind $0.05
bb835227: posts big blind $0.1
*** HOLE CARDS ***
Dealt to 1e25b5bb 
Dealt to ae47099b 
Dealt to bb835227 
Dealt to 4d1634eb 
Dealt to Hero [8h Qc]
Dealt to 9c716b19 
4d1634eb: folds
Hero: folds
9c716b19: folds
1e25b5bb: folds
ae47099b: folds
Uncalled bet ($0.05) returned to bb835227
*** SHOWDOWN ***
bb835227 collected $0.1 from pot
*** SUMMARY ***
Total pot $0.1 | Rake $0 | Jackpot $0 | Bingo $0 | Fortune $0 | Tax $0
Seat 1: 1e25b5bb (button) folded before Flop (didn't bet)
Seat 2: ae47099b (small blind) folded before Flop
Seat 3: bb835227 (big blind) collected ($0.1)
Seat 4: 4d1634eb folded before Flop (didn't bet)
Seat 5: Hero folded before Flop (didn't bet)
Seat 6: 9c716b19 folded before Flop (didn't bet)


Poker Hand #RC3141667880: Hold'em No Limit ($0.05/$0.1) - 2024/12/12 12:36:26
Table 'RushAndCash22313140' 6-max Seat #1 is the button
Seat 1: f00bacd2 ($17.72 in chips)
Seat 2: 647dd971 ($3.46 in chips)
Seat 3: a0bab1fa ($10.15 in chips)
Seat 4: Hero ($10 in chips)
Seat 5: 5ef48bbc ($10.68 in chips)
Seat 6: 1ecd1474 ($10.05 in chips)
647dd971: posts small blind $0.05
a0bab1fa: posts big blind $0.1
*** HOLE CARDS ***
Dealt to f00bacd2 
Dealt to 647dd971 
Dealt to a0bab1fa 
Dealt to Hero [Qc 4d]
Dealt to 5ef48bbc 
Dealt to 1ecd1474 
Hero: folds
5ef48bbc: folds
1ecd1474: raises $0.12 to $0.22
f00bacd2: folds
647dd971: folds
a0bab1fa: folds
Uncalled bet ($0.12) returned to 1ecd1474
*** SHOWDOWN ***
1ecd1474 collected $0.25 from pot
*** SUMMARY ***
Total pot $0.25 | Rake $0 | Jackpot $0 | Bingo $0 | Fortune $0 | Tax $0
Seat 1: f00bacd2 (button) folded before Flop (didn't bet)
Seat 2: 647dd971 (small blind) folded before Flop
Seat 3: a0bab1fa (big blind) folded before Flop
Seat 4: Hero folded before Flop (didn't bet)
Seat 5: 5ef48bbc folded before Flop (didn't bet)
Seat 6: 1ecd1474 collected ($0.25)


Poker Hand #RC3141667858: Hold'em No Limit ($0.05/$0.1) - 2024/12/12 12:36:21
Table 'RushAndCash22313118' 6-max Seat #1 is the button
Seat 1: Hero ($10 in chips)
Seat 2: 15f3779a ($9.85 in chips)
Seat 3: 8e0a697 ($10.83 in chips)
Seat 4: 1d37642 ($8.95 in chips)
Seat 5: 31e1f60f ($11.86 in chips)
Seat 6: 65bfb346 ($12.34 in chips)
15f3779a: posts small blind $0.05
8e0a697: posts big blind $0.1
*** HOLE CARDS ***
Dealt to Hero [2d 8d]
Dealt to 15f3779a 
Dealt to 8e0a697 
Dealt to 1d37642 
Dealt to 31e1f60f 
Dealt to 65bfb346 
1d37642: folds
31e1f60f: folds
65bfb346: folds
Hero: folds
15f3779a: folds
Uncalled bet ($0.05) returned to 8e0a697
*** SHOWDOWN ***
8e0a697 collected $0.1 from pot
*** SUMMARY ***
Total pot $0.1 | Rake $0 | Jackpot $0 | Bingo $0 | Fortune $0 | Tax $0
Seat 1: Hero (button) folded before Flop (didn't bet)
Seat 2: 15f3779a (small blind) folded before Flop
Seat 3: 8e0a697 (big blind) collected ($0.1)
Seat 4: 1d37642 folded before Flop (didn't bet)
Seat 5: 31e1f60f folded before Flop (didn't bet)
Seat 6: 65bfb346 folded before Flop (didn't bet)


Poker Hand #RC3141667835: Hold'em No Limit ($0.05/$0.1) - 2024/12/12 12:36:16
Table 'RushAndCash22313095' 6-max Seat #1 is the button
Seat 1: e896e324 ($10 in chips)
Seat 2: Hero ($10 in chips)
Seat 3: d1764387 ($11.95 in chips)
Seat 4: e0c4f56b ($9.18 in chips)
Seat 5: c4d674fe ($10.26 in chips)
Seat 6: ce846db ($10.39 in chips)
Hero: posts small blind $0.05
d1764387: posts big blind $0.1
*** HOLE CARDS ***
Dealt to e896e324 
Dealt to Hero [Jd 2c]
Dealt to d1764387 
Dealt to e0c4f56b 
Dealt to c4d674fe 
Dealt to ce846db 
e0c4f56b: folds
c4d674fe: folds
ce846db: folds
e896e324: folds
Hero: folds
Uncalled bet ($0.05) returned to d1764387
*** SHOWDOWN ***
d1764387 collected $0.1 from pot
*** SUMMARY ***
Total pot $0.1 | Rake $0 | Jackpot $0 | Bingo $0 | Fortune $0 | Tax $0
Seat 1: e896e324 (button) folded before Flop (didn't bet)
Seat 2: Hero (small blind) folded before Flop
Seat 3: d1764387 (big blind) collected ($0.1)
Seat 4: e0c4f56b folded before Flop (didn't bet)
Seat 5: c4d674fe folded before Flop (didn't bet)
Seat 6: ce846db folded before Flop (didn't bet)


Poker Hand #RC3141667766: Hold'em No Limit ($0.05/$0.1) - 2024/12/12 12:36:01
Table 'RushAndCash22313026' 6-max Seat #1 is the button
Seat 1: bf8dfa7d ($6.11 in chips)
Seat 2: a7b31926 ($16.45 in chips)
Seat 3: Hero ($10 in chips)
Seat 4: 30e79389 ($22.2 in chips)
Seat 5: ca2bcc9f ($6.66 in chips)
Seat 6: e896e324 ($10.15 in chips)
a7b31926: posts small blind $0.05
Hero: posts big blind $0.1
*** HOLE CARDS ***
Dealt to bf8dfa7d 
Dealt to a7b31926 
Dealt to Hero [Tc 8d]
Dealt to 30e79389 
Dealt to ca2bcc9f 
Dealt to e896e324 
30e79389: folds
ca2bcc9f: folds
e896e324: folds
bf8dfa7d: raises $0.2 to $0.3
a7b31926: folds
Hero: folds
Uncalled bet ($0.2) returned to bf8dfa7d
*** SHOWDOWN ***
bf8dfa7d collected $0.25 from pot
*** SUMMARY ***
Total pot $0.25 | Rake $0 | Jackpot $0 | Bingo $0 | Fortune $0 | Tax $0
Seat 1: bf8dfa7d (button) collected ($0.25)
Seat 2: a7b31926 (small blind) folded before Flop
Seat 3: Hero (big blind) folded before Flop
Seat 4: 30e79389 folded before Flop (didn't bet)
Seat 5: ca2bcc9f folded before Flop (didn't bet)
Seat 6: e896e324 folded before Flop (didn't bet)


