Poker Hand #RC3141728571: Hold'em No Limit ($0.05/$0.1) - 2024/12/12 13:20:12
Table 'RushAndCash22323831' 6-max Seat #1 is the button
Seat 1: 8a55880e ($17.59 in chips)
Seat 2: cf8c7bd5 ($23.67 in chips)
Seat 3: c65c8b30 ($13.08 in chips)
Seat 4: dea77808 ($14.74 in chips)
Seat 5: Hero ($11.47 in chips)
Seat 6: afe10f69 ($10.74 in chips)
cf8c7bd5: posts small blind $0.05
c65c8b30: posts big blind $0.1
*** HOLE CARDS ***
Dealt to 8a55880e 
Dealt to cf8c7bd5 
Dealt to c65c8b30 
Dealt to dea77808 
Dealt to Hero [Kd Kc]
Dealt to afe10f69 
dea77808: folds
Hero: raises $0.1 to $0.2
afe10f69: folds
8a55880e: raises $0.55 to $0.75
cf8c7bd5: folds
c65c8b30: folds
Hero: raises $1.24 to $1.99
8a55880e: folds
Uncalled bet ($1.24) returned to Hero
*** SHOWDOWN ***
Hero collected $1.57 from pot
*** SUMMARY ***
Total pot $1.65 | Rake $0.08 | Jackpot $0 | Bingo $0 | Fortune $0 | Tax $0
Seat 1: 8a55880e (button) folded before Flop
Seat 2: cf8c7bd5 (small blind) folded before Flop
Seat 3: c65c8b30 (big blind) folded before Flop
Seat 4: dea77808 folded before Flop (didn't bet)
Seat 5: Hero collected ($1.57)
Seat 6: afe10f69 folded before Flop (didn't bet)


Poker Hand #RC3141728510: Hold'em No Limit ($0.05/$0.1) - 2024/12/12 13:19:59
Table 'RushAndCash22323770' 6-max Seat #1 is the button
Seat 1: 78a7e3b4 ($10.51 in chips)
Seat 2: Hero ($11.52 in chips)
Seat 3: 254fead6 ($10.79 in chips)
Seat 4: 6904b57e ($13.91 in chips)
Seat 5: 4f5c5eb ($10.66 in chips)
Seat 6: 316b7313 ($11.65 in chips)
Hero: posts small blind $0.05
254fead6: posts big blind $0.1
*** HOLE CARDS ***
Dealt to 78a7e3b4 
Dealt to Hero [Jh Th]
Dealt to 254fead6 
Dealt to 6904b57e 
Dealt to 4f5c5eb 
Dealt to 316b7313 
6904b57e: folds
4f5c5eb: raises $0.14 to $0.24
316b7313: folds
78a7e3b4: folds
Hero: folds
254fead6: calls $0.14
*** FLOP *** [7h Tc 6d]
254fead6: checks
4f5c5eb: checks
*** TURN *** [7h Tc 6d] [3s]
254fead6: checks
4f5c5eb: checks
*** RIVER *** [7h Tc 6d 3s] [6c]
254fead6: checks
4f5c5eb: checks
254fead6: shows [Qd 8d] (Pair of Sixes)
4f5c5eb: shows [5d As] (Pair of Sixes)
*** SHOWDOWN ***
4f5c5eb collected $0.51 from pot
*** SUMMARY ***
Total pot $0.53 | Rake $0.02 | Jackpot $0 | Bingo $0 | Fortune $0 | Tax $0
Board [7h Tc 6d 3s 6c]
Seat 1: 78a7e3b4 (button) folded before Flop (didn't bet)
Seat 2: Hero (small blind) folded before Flop
Seat 3: 254fead6 (big blind) showed [Qd 8d] and lost with Pair of Sixes
Seat 4: 6904b57e folded before Flop (didn't bet)
Seat 5: 4f5c5eb showed [5d As] and won ($0.51) with Pair of Sixes
Seat 6: 316b7313 folded before Flop (didn't bet)


Poker Hand #RC3141728493: Hold'em No Limit ($0.05/$0.1) - 2024/12/12 13:19:56
Table 'RushAndCash22323753' 6-max Seat #1 is the button
Seat 1: 79658983 ($13.12 in chips)
Seat 2: 56e396a1 ($12.69 in chips)
Seat 3: 645be922 ($10 in chips)
Seat 4: 718b4a9 ($9.65 in chips)
Seat 5: 1a8ef95a ($10.41 in chips)
Seat 6: Hero ($11.52 in chips)
56e396a1: posts small blind $0.05
645be922: posts big blind $0.1
*** HOLE CARDS ***
Dealt to 79658983 
Dealt to 56e396a1 
Dealt to 645be922 
Dealt to 718b4a9 
Dealt to 1a8ef95a 
Dealt to Hero [4d Kc]
718b4a9: raises $0.2 to $0.3
1a8ef95a: folds
Hero: folds
79658983: calls $0.3
56e396a1: folds
645be922: folds
*** FLOP *** [Kd Td 7s]
718b4a9: checks
79658983: checks
*** TURN *** [Kd Td 7s] [9s]
718b4a9: bets $0.25
79658983: raises $0.65 to $0.9
718b4a9: folds
Uncalled bet ($0.65) returned to 79658983
*** SHOWDOWN ***
79658983 collected $1.19 from pot
*** SUMMARY ***
Total pot $1.25 | Rake $0.06 | Jackpot $0 | Bingo $0 | Fortune $0 | Tax $0
Board [Kd Td 7s 9s]
Seat 1: 79658983 (button) won ($1.19)
Seat 2: 56e396a1 (small blind) folded before Flop
Seat 3: 645be922 (big blind) folded before Flop
Seat 4: 718b4a9 folded on the Turn
Seat 5: 1a8ef95a folded before Flop (didn't bet)
Seat 6: Hero folded before Flop (didn't bet)


Poker Hand #RC3141728455: Hold'em No Limit ($0.05/$0.1) - 2024/12/12 13:19:49
Table 'RushAndCash22323715' 6-max Seat #1 is the button
Seat 1: 78428b92 ($79.39 in chips)
Seat 2: fa56d9ad ($8.19 in chips)
Seat 3: 1a8ef95a ($10.51 in chips)
Seat 4: bb09d73b ($6.81 in chips)
Seat 5: 254fead6 ($10.64 in chips)
Seat 6: Hero ($11.52 in chips)
fa56d9ad: posts small blind $0.05
1a8ef95a: posts big blind $0.1
*** HOLE CARDS ***
Dealt to 78428b92 
Dealt to fa56d9ad 
Dealt to 1a8ef95a 
Dealt to bb09d73b 
Dealt to 254fead6 
Dealt to Hero [9h Ad]
bb09d73b: folds
254fead6: raises $0.1 to $0.2
Hero: folds
78428b92: folds
fa56d9ad: folds
1a8ef95a: folds
Uncalled bet ($0.1) returned to 254fead6
*** SHOWDOWN ***
254fead6 collected $0.25 from pot
*** SUMMARY ***
Total pot $0.25 | Rake $0 | Jackpot $0 | Bingo $0 | Fortune $0 | Tax $0
Seat 1: 78428b92 (button) folded before Flop (didn't bet)
Seat 2: fa56d9ad (small blind) folded before Flop
Seat 3: 1a8ef95a (big blind) folded before Flop
Seat 4: bb09d73b folded before Flop (didn't bet)
Seat 5: 254fead6 collected ($0.25)
Seat 6: Hero folded before Flop (didn't bet)


Poker Hand #RC3141728080: Hold'em No Limit ($0.05/$0.1) - 2024/12/12 13:18:27
Table 'RushAndCash22323340' 6-max Seat #1 is the button
Seat 1: 66a73913 ($17.64 in chips)
Seat 2: afe85e9d ($10.23 in chips)
Seat 3: bb835227 ($11.87 in chips)
Seat 4: Hero ($11.19 in chips)
Seat 5: 645be922 ($10.49 in chips)
Seat 6: 5f7772c4 ($9.42 in chips)
afe85e9d: posts small blind $0.05
bb835227: posts big blind $0.1
*** HOLE CARDS ***
Dealt to 66a73913 
Dealt to afe85e9d 
Dealt to bb835227 
Dealt to Hero [Jh Ks]
Dealt to 645be922 
Dealt to 5f7772c4 
Hero: raises $0.1 to $0.2
645be922: folds
5f7772c4: folds
66a73913: calls $0.2
afe85e9d: folds
bb835227: folds
*** FLOP *** [Qs 8s 5c]
Hero: checks
66a73913: checks
*** TURN *** [Qs 8s 5c] [Ts]
Hero: checks
66a73913: checks
*** RIVER *** [Qs 8s 5c Ts] [7s]
Hero: bets $0.42
66a73913: folds
Uncalled bet ($0.42) returned to Hero
*** SHOWDOWN ***
Hero collected $0.53 from pot
*** SUMMARY ***
Total pot $0.55 | Rake $0.02 | Jackpot $0 | Bingo $0 | Fortune $0 | Tax $0
Board [Qs 8s 5c Ts 7s]
Seat 1: 66a73913 (button) folded on the River
Seat 2: afe85e9d (small blind) folded before Flop
Seat 3: bb835227 (big blind) folded before Flop
Seat 4: Hero won ($0.53)
Seat 5: 645be922 folded before Flop (didn't bet)
Seat 6: 5f7772c4 folded before Flop (didn't bet)


Poker Hand #RC3141728064: Hold'em No Limit ($0.05/$0.1) - 2024/12/12 13:18:24
Table 'RushAndCash22323324' 6-max Seat #1 is the button
Seat 1: Hero ($11.19 in chips)
Seat 2: 22e8274e ($23.7 in chips)
Seat 3: 86ee8e36 ($34.35 in chips)
Seat 4: c65c8b30 ($12.34 in chips)
Seat 5: c2b852ae ($7.4 in chips)
Seat 6: b8e03e64 ($10.4 in chips)
22e8274e: posts small blind $0.05
86ee8e36: posts big blind $0.1
*** HOLE CARDS ***
Dealt to Hero [9h 8c]
Dealt to 22e8274e 
Dealt to 86ee8e36 
Dealt to c65c8b30 
Dealt to c2b852ae 
Dealt to b8e03e64 
c65c8b30: raises $0.2 to $0.3
c2b852ae: folds
b8e03e64: folds
Hero: folds
22e8274e: folds
86ee8e36: folds
Uncalled bet ($0.2) returned to c65c8b30
*** SHOWDOWN ***
c65c8b30 collected $0.25 from pot
*** SUMMARY ***
Total pot $0.25 | Rake $0 | Jackpot $0 | Bingo $0 | Fortune $0 | Tax $0
Seat 1: Hero (button) folded before Flop (didn't bet)
Seat 2: 22e8274e (small blind) folded before Flop
Seat 3: 86ee8e36 (big blind) folded before Flop
Seat 4: c65c8b30 collected ($0.25)
Seat 5: c2b852ae folded before Flop (didn't bet)
Seat 6: b8e03e64 folded before Flop (didn't bet)


Poker Hand #RC3141728048: Hold'em No Limit ($0.05/$0.1) - 2024/12/12 13:18:20
Table 'RushAndCash22323308' 6-max Seat #1 is the button
Seat 1: cf64da1a ($20.29 in chips)
Seat 2: 59de94fc ($15.67 in chips)
Seat 3: Hero ($11.29 in chips)
Seat 4: a8408ae7 ($10 in chips)
Seat 5: 7ec40c0d ($19.85 in chips)
Seat 6: 393dfd41 ($7.81 in chips)
59de94fc: posts small blind $0.05
Hero: posts big blind $0.1
*** HOLE CARDS ***
Dealt to cf64da1a 
Dealt to 59de94fc 
Dealt to Hero [Kh 2c]
Dealt to a8408ae7 
Dealt to 7ec40c0d 
Dealt to 393dfd41 
a8408ae7: raises $0.1 to $0.2
7ec40c0d: folds
393dfd41: folds
cf64da1a: raises $0.43 to $0.63
59de94fc: raises $2.34 to $2.97
Hero: folds
a8408ae7: folds
cf64da1a: folds
Uncalled bet ($2.34) returned to 59de94fc
*** SHOWDOWN ***
59de94fc collected $1.49 from pot
*** SUMMARY ***
Total pot $1.56 | Rake $0.07 | Jackpot $0 | Bingo $0 | Fortune $0 | Tax $0
Seat 1: cf64da1a (button) folded before Flop
Seat 2: 59de94fc (small blind) collected ($1.49)
Seat 3: Hero (big blind) folded before Flop
Seat 4: a8408ae7 folded before Flop
Seat 5: 7ec40c0d folded before Flop (didn't bet)
Seat 6: 393dfd41 folded before Flop (didn't bet)


Poker Hand #RC3141728032: Hold'em No Limit ($0.05/$0.1) - 2024/12/12 13:18:17
Table 'RushAndCash22323292' 6-max Seat #1 is the button
Seat 1: aa6f9192 ($10 in chips)
Seat 2: Hero ($11.34 in chips)
Seat 3: 78428b92 ($77.69 in chips)
Seat 4: 393dfd41 ($7.81 in chips)
Seat 5: 40e145e5 ($9.6 in chips)
Seat 6: cc07b659 ($10.08 in chips)
Hero: posts small blind $0.05
78428b92: posts big blind $0.1
*** HOLE CARDS ***
Dealt to aa6f9192 
Dealt to Hero [Jd 8c]
Dealt to 78428b92 
Dealt to 393dfd41 
Dealt to 40e145e5 
Dealt to cc07b659 
393dfd41: folds
40e145e5: raises $0.1 to $0.2
cc07b659: raises $0.42 to $0.62
aa6f9192: folds
Hero: folds
78428b92: folds
40e145e5: raises $1.05 to $1.67
cc07b659: calls $1.05
*** FLOP *** [7c 5h 6c]
40e145e5: checks
cc07b659: bets $1.72
40e145e5: calls $1.72
*** TURN *** [7c 5h 6c] [9d]
40e145e5: checks
cc07b659: bets $6.69 and is all-in
40e145e5: folds
Uncalled bet ($6.69) returned to cc07b659
*** SHOWDOWN ***
cc07b659 collected $6.48 from pot
*** SUMMARY ***
Total pot $6.93 | Rake $0.3 | Jackpot $0.15 | Bingo $0 | Fortune $0 | Tax $0
Board [7c 5h 6c 9d]
Seat 1: aa6f9192 (button) folded before Flop (didn't bet)
Seat 2: Hero (small blind) folded before Flop
Seat 3: 78428b92 (big blind) folded before Flop
Seat 4: 393dfd41 folded before Flop (didn't bet)
Seat 5: 40e145e5 folded on the Turn
Seat 6: cc07b659 won ($6.48)


Poker Hand #RC3141727971: Hold'em No Limit ($0.05/$0.1) - 2024/12/12 13:18:03
Table 'RushAndCash22323231' 6-max Seat #1 is the button
Seat 1: 36e10f27 ($14.95 in chips)
Seat 2: 1dc50d10 ($10.65 in chips)
Seat 3: f48d519f ($10.4 in chips)
Seat 4: 248d80e1 ($10.5 in chips)
Seat 5: Hero ($11.19 in chips)
Seat 6: 40e145e5 ($9.6 in chips)
1dc50d10: posts small blind $0.05
f48d519f: posts big blind $0.1
*** HOLE CARDS ***
Dealt to 36e10f27 
Dealt to 1dc50d10 
Dealt to f48d519f 
Dealt to 248d80e1 
Dealt to Hero [As 2s]
Dealt to 40e145e5 
248d80e1: folds
Hero: raises $0.1 to $0.2
40e145e5: folds
36e10f27: folds
1dc50d10: folds
f48d519f: folds
Uncalled bet ($0.1) returned to Hero
*** SHOWDOWN ***
Hero collected $0.25 from pot
*** SUMMARY ***
Total pot $0.25 | Rake $0 | Jackpot $0 | Bingo $0 | Fortune $0 | Tax $0
Seat 1: 36e10f27 (button) folded before Flop (didn't bet)
Seat 2: 1dc50d10 (small blind) folded before Flop
Seat 3: f48d519f (big blind) folded before Flop
Seat 4: 248d80e1 folded before Flop (didn't bet)
Seat 5: Hero collected ($0.25)
Seat 6: 40e145e5 folded before Flop (didn't bet)


Poker Hand #RC3141727956: Hold'em No Limit ($0.05/$0.1) - 2024/12/12 13:17:58
Table 'RushAndCash22323216' 6-max Seat #1 is the button
Seat 1: ce410800 ($26.48 in chips)
Seat 2: 643f85e7 ($9.35 in chips)
Seat 3: Hero ($11.29 in chips)
Seat 4: 88a9583f ($48.01 in chips)
Seat 5: 19a20066 ($10.2 in chips)
Seat 6: 73df44d1 ($10 in chips)
643f85e7: posts small blind $0.05
Hero: posts big blind $0.1
*** HOLE CARDS ***
Dealt to ce410800 
Dealt to 643f85e7 
Dealt to Hero [8c 2c]
Dealt to 88a9583f 
Dealt to 19a20066 
Dealt to 73df44d1 
88a9583f: folds
19a20066: raises $0.1 to $0.2
73df44d1: folds
ce410800: folds
643f85e7: folds
Hero: folds
Uncalled bet ($0.1) returned to 19a20066
*** SHOWDOWN ***
19a20066 collected $0.25 from pot
*** SUMMARY ***
Total pot $0.25 | Rake $0 | Jackpot $0 | Bingo $0 | Fortune $0 | Tax $0
Seat 1: ce410800 (button) folded before Flop (didn't bet)
Seat 2: 643f85e7 (small blind) folded before Flop
Seat 3: Hero (big blind) folded before Flop
Seat 4: 88a9583f folded before Flop (didn't bet)
Seat 5: 19a20066 collected ($0.25)
Seat 6: 73df44d1 folded before Flop (didn't bet)


Poker Hand #RC3141727921: Hold'em No Limit ($0.05/$0.1) - 2024/12/12 13:17:52
Table 'RushAndCash22323181' 6-max Seat #1 is the button
Seat 1: a3d9ddb9 ($15.8 in chips)
Seat 2: Hero ($11.34 in chips)
Seat 3: 9cfbee05 ($10 in chips)
Seat 4: ce410800 ($26.48 in chips)
Seat 5: b1f396f4 ($21.01 in chips)
Seat 6: 51c5666 ($28.34 in chips)
Hero: posts small blind $0.05
9cfbee05: posts big blind $0.1
*** HOLE CARDS ***
Dealt to a3d9ddb9 
Dealt to Hero [Kc 4h]
Dealt to 9cfbee05 
Dealt to ce410800 
Dealt to b1f396f4 
Dealt to 51c5666 
ce410800: folds
b1f396f4: folds
51c5666: folds
a3d9ddb9: folds
Hero: folds
Uncalled bet ($0.05) returned to 9cfbee05
*** SHOWDOWN ***
9cfbee05 collected $0.1 from pot
*** SUMMARY ***
Total pot $0.1 | Rake $0 | Jackpot $0 | Bingo $0 | Fortune $0 | Tax $0
Seat 1: a3d9ddb9 (button) folded before Flop (didn't bet)
Seat 2: Hero (small blind) folded before Flop
Seat 3: 9cfbee05 (big blind) collected ($0.1)
Seat 4: ce410800 folded before Flop (didn't bet)
Seat 5: b1f396f4 folded before Flop (didn't bet)
Seat 6: 51c5666 folded before Flop (didn't bet)


Poker Hand #RC3141727906: Hold'em No Limit ($0.05/$0.1) - 2024/12/12 13:17:49
Table 'RushAndCash22323166' 6-max Seat #1 is the button
Seat 1: 1d094c87 ($10 in chips)
Seat 2: 10144c4d ($6.51 in chips)
Seat 3: c65c8b30 ($12.2 in chips)
Seat 4: 9cfbee05 ($10 in chips)
Seat 5: Hero ($11.34 in chips)
Seat 6: c113e767 ($5.98 in chips)
10144c4d: posts small blind $0.05
c65c8b30: posts big blind $0.1
*** HOLE CARDS ***
Dealt to 1d094c87 
Dealt to 10144c4d 
Dealt to c65c8b30 
Dealt to 9cfbee05 
Dealt to Hero [6h 8c]
Dealt to c113e767 
9cfbee05: folds
Hero: folds
c113e767: calls $0.1
1d094c87: folds
10144c4d: calls $0.05
c65c8b30: raises $0.5 to $0.6
c113e767: folds
10144c4d: folds
Uncalled bet ($0.5) returned to c65c8b30
*** SHOWDOWN ***
c65c8b30 collected $0.29 from pot
*** SUMMARY ***
Total pot $0.3 | Rake $0.01 | Jackpot $0 | Bingo $0 | Fortune $0 | Tax $0
Seat 1: 1d094c87 (button) folded before Flop (didn't bet)
Seat 2: 10144c4d (small blind) folded before Flop
Seat 3: c65c8b30 (big blind) collected ($0.29)
Seat 4: 9cfbee05 folded before Flop (didn't bet)
Seat 5: Hero folded before Flop (didn't bet)
Seat 6: c113e767 folded before Flop


Poker Hand #RC3141727887: Hold'em No Limit ($0.05/$0.1) - 2024/12/12 13:17:45
Table 'RushAndCash22323147' 6-max Seat #1 is the button
Seat 1: 22ee6f58 ($10.18 in chips)
Seat 2: 17798854 ($10.05 in chips)
Seat 3: b15bbba6 ($11.41 in chips)
Seat 4: 7d40d863 ($7.47 in chips)
Seat 5: aecd8c87 ($20.99 in chips)
Seat 6: Hero ($11.34 in chips)
17798854: posts small blind $0.05
b15bbba6: posts big blind $0.1
*** HOLE CARDS ***
Dealt to 22ee6f58 
Dealt to 17798854 
Dealt to b15bbba6 
Dealt to 7d40d863 
Dealt to aecd8c87 
Dealt to Hero [4d 9c]
7d40d863: folds
aecd8c87: folds
Hero: folds
22ee6f58: folds
17798854: raises $0.2 to $0.3
b15bbba6: folds
Uncalled bet ($0.2) returned to 17798854
*** SHOWDOWN ***
17798854 collected $0.2 from pot
*** SUMMARY ***
Total pot $0.2 | Rake $0 | Jackpot $0 | Bingo $0 | Fortune $0 | Tax $0
Seat 1: 22ee6f58 (button) folded before Flop (didn't bet)
Seat 2: 17798854 (small blind) collected ($0.2)
Seat 3: b15bbba6 (big blind) folded before Flop
Seat 4: 7d40d863 folded before Flop (didn't bet)
Seat 5: aecd8c87 folded before Flop (didn't bet)
Seat 6: Hero folded before Flop (didn't bet)


Poker Hand #RC3141727873: Hold'em No Limit ($0.05/$0.1) - 2024/12/12 13:17:41
Table 'RushAndCash22323133' 6-max Seat #1 is the button
Seat 1: Hero ($11.34 in chips)
Seat 2: fd36d45d ($14.9 in chips)
Seat 3: 81834a2f ($14.3 in chips)
Seat 4: 4e5c7119 ($14.86 in chips)
Seat 5: 10144c4d ($6.61 in chips)
Seat 6: 84c13d8 ($27.46 in chips)
fd36d45d: posts small blind $0.05
81834a2f: posts big blind $0.1
*** HOLE CARDS ***
Dealt to Hero [8s 4c]
Dealt to fd36d45d 
Dealt to 81834a2f 
Dealt to 4e5c7119 
Dealt to 10144c4d 
Dealt to 84c13d8 
4e5c7119: folds
10144c4d: folds
84c13d8: folds
Hero: folds
fd36d45d: folds
Uncalled bet ($0.05) returned to 81834a2f
*** SHOWDOWN ***
81834a2f collected $0.1 from pot
*** SUMMARY ***
Total pot $0.1 | Rake $0 | Jackpot $0 | Bingo $0 | Fortune $0 | Tax $0
Seat 1: Hero (button) folded before Flop (didn't bet)
Seat 2: fd36d45d (small blind) folded before Flop
Seat 3: 81834a2f (big blind) collected ($0.1)
Seat 4: 4e5c7119 folded before Flop (didn't bet)
Seat 5: 10144c4d folded before Flop (didn't bet)
Seat 6: 84c13d8 folded before Flop (didn't bet)


Poker Hand #RC3141727854: Hold'em No Limit ($0.05/$0.1) - 2024/12/12 13:17:37
Table 'RushAndCash22323114' 6-max Seat #1 is the button
Seat 1: e12528c0 ($29.45 in chips)
Seat 2: Hero ($11.39 in chips)
Seat 3: 8f901b97 ($31.15 in chips)
Seat 4: 60b2f955 ($12.82 in chips)
Seat 5: bc46bb6c ($13.41 in chips)
Seat 6: a699d2de ($17.22 in chips)
Hero: posts small blind $0.05
8f901b97: posts big blind $0.1
*** HOLE CARDS ***
Dealt to e12528c0 
Dealt to Hero [2c Ks]
Dealt to 8f901b97 
Dealt to 60b2f955 
Dealt to bc46bb6c 
Dealt to a699d2de 
60b2f955: folds
bc46bb6c: folds
a699d2de: folds
e12528c0: folds
Hero: folds
Uncalled bet ($0.05) returned to 8f901b97
*** SHOWDOWN ***
8f901b97 collected $0.1 from pot
*** SUMMARY ***
Total pot $0.1 | Rake $0 | Jackpot $0 | Bingo $0 | Fortune $0 | Tax $0
Seat 1: e12528c0 (button) folded before Flop (didn't bet)
Seat 2: Hero (small blind) folded before Flop
Seat 3: 8f901b97 (big blind) collected ($0.1)
Seat 4: 60b2f955 folded before Flop (didn't bet)
Seat 5: bc46bb6c folded before Flop (didn't bet)
Seat 6: a699d2de folded before Flop (didn't bet)


Poker Hand #RC3141727770: Hold'em No Limit ($0.05/$0.1) - 2024/12/12 13:17:20
Table 'RushAndCash22323030' 6-max Seat #1 is the button
Seat 1: Hero ($11.64 in chips)
Seat 2: bc46bb6c ($13.09 in chips)
Seat 3: a6fdbe1b ($12.85 in chips)
Seat 4: f383ae87 ($11.57 in chips)
Seat 5: 59de94fc ($15.57 in chips)
Seat 6: 334d3992 ($10.28 in chips)
bc46bb6c: posts small blind $0.05
a6fdbe1b: posts big blind $0.1
*** HOLE CARDS ***
Dealt to Hero [8s Ks]
Dealt to bc46bb6c 
Dealt to a6fdbe1b 
Dealt to f383ae87 
Dealt to 59de94fc 
Dealt to 334d3992 
f383ae87: folds
59de94fc: folds
334d3992: folds
Hero: raises $0.15 to $0.25
bc46bb6c: raises $0.85 to $1.1
a6fdbe1b: folds
Hero: folds
Uncalled bet ($0.85) returned to bc46bb6c
*** SHOWDOWN ***
bc46bb6c collected $0.57 from pot
*** SUMMARY ***
Total pot $0.6 | Rake $0.03 | Jackpot $0 | Bingo $0 | Fortune $0 | Tax $0
Seat 1: Hero (button) folded before Flop
Seat 2: bc46bb6c (small blind) collected ($0.57)
Seat 3: a6fdbe1b (big blind) folded before Flop
Seat 4: f383ae87 folded before Flop (didn't bet)
Seat 5: 59de94fc folded before Flop (didn't bet)
Seat 6: 334d3992 folded before Flop (didn't bet)


Poker Hand #RC3141727428: Hold'em No Limit ($0.05/$0.1) - 2024/12/12 13:16:06
Table 'RushAndCash22322688' 6-max Seat #1 is the button
Seat 1: c6999b53 ($4.13 in chips)
Seat 2: d25ababb ($10.43 in chips)
Seat 3: 59de94fc ($16.41 in chips)
Seat 4: d827b781 ($10.77 in chips)
Seat 5: cb6a7240 ($10.69 in chips)
Seat 6: Hero ($10.83 in chips)
d25ababb: posts small blind $0.05
59de94fc: posts big blind $0.1
*** HOLE CARDS ***
Dealt to c6999b53 
Dealt to d25ababb 
Dealt to 59de94fc 
Dealt to d827b781 
Dealt to cb6a7240 
Dealt to Hero [Ks 6s]
d827b781: folds
cb6a7240: folds
Hero: raises $0.15 to $0.25
c6999b53: folds
d25ababb: folds
59de94fc: calls $0.15
*** FLOP *** [Kc Jd 5d]
59de94fc: checks
Hero: bets $0.19
59de94fc: calls $0.19
*** TURN *** [Kc Jd 5d] [2h]
59de94fc: checks
Hero: checks
*** RIVER *** [Kc Jd 5d 2h] [5s]
59de94fc: checks
Hero: bets $0.4
59de94fc: calls $0.4
Hero: shows [Ks 6s] (Pair of Kings and Pair of Fives)
59de94fc: shows [Ac Jh] (Pair of Jacks and Pair of Fives)
*** SHOWDOWN ***
Hero collected $1.65 from pot
*** SUMMARY ***
Total pot $1.73 | Rake $0.08 | Jackpot $0 | Bingo $0 | Fortune $0 | Tax $0
Board [Kc Jd 5d 2h 5s]
Seat 1: c6999b53 (button) folded before Flop (didn't bet)
Seat 2: d25ababb (small blind) folded before Flop
Seat 3: 59de94fc (big blind) showed [Ac Jh] and lost with Pair of Jacks and Pair of Fives
Seat 4: d827b781 folded before Flop (didn't bet)
Seat 5: cb6a7240 folded before Flop (didn't bet)
Seat 6: Hero showed [Ks 6s] and won ($1.65) with Pair of Kings and Pair of Fives


Poker Hand #RC3141727392: Hold'em No Limit ($0.05/$0.1) - 2024/12/12 13:15:58
Table 'RushAndCash22322652' 6-max Seat #1 is the button
Seat 1: 526323fa ($10 in chips)
Seat 2: 6d89c9cc ($23.72 in chips)
Seat 3: 101c026b ($34.68 in chips)
Seat 4: Hero ($10.68 in chips)
Seat 5: cfe70ef2 ($11.44 in chips)
Seat 6: 6d63b808 ($10.93 in chips)
6d89c9cc: posts small blind $0.05
101c026b: posts big blind $0.1
*** HOLE CARDS ***
Dealt to 526323fa 
Dealt to 6d89c9cc 
Dealt to 101c026b 
Dealt to Hero [Kc Ah]
Dealt to cfe70ef2 
Dealt to 6d63b808 
Hero: raises $0.1 to $0.2
cfe70ef2: folds
6d63b808: folds
526323fa: folds
6d89c9cc: folds
101c026b: folds
Uncalled bet ($0.1) returned to Hero
*** SHOWDOWN ***
Hero collected $0.25 from pot
*** SUMMARY ***
Total pot $0.25 | Rake $0 | Jackpot $0 | Bingo $0 | Fortune $0 | Tax $0
Seat 1: 526323fa (button) folded before Flop (didn't bet)
Seat 2: 6d89c9cc (small blind) folded before Flop
Seat 3: 101c026b (big blind) folded before Flop
Seat 4: Hero collected ($0.25)
Seat 5: cfe70ef2 folded before Flop (didn't bet)
Seat 6: 6d63b808 folded before Flop (didn't bet)


Poker Hand #RC3141727341: Hold'em No Limit ($0.05/$0.1) - 2024/12/12 13:15:48
Table 'RushAndCash22322601' 6-max Seat #1 is the button
Seat 1: d6b17ac7 ($12.04 in chips)
Seat 2: cf2fd778 ($10 in chips)
Seat 3: Hero ($10.78 in chips)
Seat 4: c2b852ae ($7.46 in chips)
Seat 5: ea3eb4a4 ($10 in chips)
Seat 6: 418b0280 ($10 in chips)
cf2fd778: posts small blind $0.05
Hero: posts big blind $0.1
*** HOLE CARDS ***
Dealt to d6b17ac7 
Dealt to cf2fd778 
Dealt to Hero [Kh 3h]
Dealt to c2b852ae 
Dealt to ea3eb4a4 
Dealt to 418b0280 
c2b852ae: raises $0.12 to $0.22
ea3eb4a4: folds
418b0280: folds
d6b17ac7: folds
cf2fd778: folds
Hero: folds
Uncalled bet ($0.12) returned to c2b852ae
*** SHOWDOWN ***
c2b852ae collected $0.25 from pot
*** SUMMARY ***
Total pot $0.25 | Rake $0 | Jackpot $0 | Bingo $0 | Fortune $0 | Tax $0
Seat 1: d6b17ac7 (button) folded before Flop (didn't bet)
Seat 2: cf2fd778 (small blind) folded before Flop
Seat 3: Hero (big blind) folded before Flop
Seat 4: c2b852ae collected ($0.25)
Seat 5: ea3eb4a4 folded before Flop (didn't bet)
Seat 6: 418b0280 folded before Flop (didn't bet)


Poker Hand #RC3141727275: Hold'em No Limit ($0.05/$0.1) - 2024/12/12 13:15:35
Table 'RushAndCash22322535' 6-max Seat #1 is the button
Seat 1: 838a6109 ($10 in chips)
Seat 2: 3b1bb7c0 ($13.64 in chips)
Seat 3: 61709362 ($10 in chips)
Seat 4: aecd8c87 ($19.81 in chips)
Seat 5: c6786b68 ($6.28 in chips)
Seat 6: Hero ($10.63 in chips)
3b1bb7c0: posts small blind $0.05
61709362: posts big blind $0.1
*** HOLE CARDS ***
Dealt to 838a6109 
Dealt to 3b1bb7c0 
Dealt to 61709362 
Dealt to aecd8c87 
Dealt to c6786b68 
Dealt to Hero [8d Td]
aecd8c87: folds
c6786b68: folds
Hero: raises $0.15 to $0.25
838a6109: folds
3b1bb7c0: folds
61709362: folds
Uncalled bet ($0.15) returned to Hero
*** SHOWDOWN ***
Hero collected $0.25 from pot
*** SUMMARY ***
Total pot $0.25 | Rake $0 | Jackpot $0 | Bingo $0 | Fortune $0 | Tax $0
Seat 1: 838a6109 (button) folded before Flop (didn't bet)
Seat 2: 3b1bb7c0 (small blind) folded before Flop
Seat 3: 61709362 (big blind) folded before Flop
Seat 4: aecd8c87 folded before Flop (didn't bet)
Seat 5: c6786b68 folded before Flop (didn't bet)
Seat 6: Hero collected ($0.25)


Poker Hand #RC3141727259: Hold'em No Limit ($0.05/$0.1) - 2024/12/12 13:15:31
Table 'RushAndCash22322519' 6-max Seat #1 is the button
Seat 1: 78428b92 ($78.83 in chips)
Seat 2: 81834a2f ($13.73 in chips)
Seat 3: 6d840025 ($10.69 in chips)
Seat 4: af2d4efe ($12.31 in chips)
Seat 5: c6786b68 ($6.28 in chips)
Seat 6: Hero ($10.63 in chips)
81834a2f: posts small blind $0.05
6d840025: posts big blind $0.1
*** HOLE CARDS ***
Dealt to 78428b92 
Dealt to 81834a2f 
Dealt to 6d840025 
Dealt to af2d4efe 
Dealt to c6786b68 
Dealt to Hero [5s 3h]
af2d4efe: folds
c6786b68: folds
Hero: folds
78428b92: folds
81834a2f: raises $0.2 to $0.3
6d840025: folds
Uncalled bet ($0.2) returned to 81834a2f
*** SHOWDOWN ***
81834a2f collected $0.2 from pot
*** SUMMARY ***
Total pot $0.2 | Rake $0 | Jackpot $0 | Bingo $0 | Fortune $0 | Tax $0
Seat 1: 78428b92 (button) folded before Flop (didn't bet)
Seat 2: 81834a2f (small blind) collected ($0.2)
Seat 3: 6d840025 (big blind) folded before Flop
Seat 4: af2d4efe folded before Flop (didn't bet)
Seat 5: c6786b68 folded before Flop (didn't bet)
Seat 6: Hero folded before Flop (didn't bet)


Poker Hand #RC3141727243: Hold'em No Limit ($0.05/$0.1) - 2024/12/12 13:15:28
Table 'RushAndCash22322503' 6-max Seat #1 is the button
Seat 1: 3f7822ab ($20.28 in chips)
Seat 2: cc07b659 ($10.83 in chips)
Seat 3: f5628a04 ($11.79 in chips)
Seat 4: aecd8c87 ($19.81 in chips)
Seat 5: 2852ea1c ($10.72 in chips)
Seat 6: Hero ($10.63 in chips)
cc07b659: posts small blind $0.05
f5628a04: posts big blind $0.1
*** HOLE CARDS ***
Dealt to 3f7822ab 
Dealt to cc07b659 
Dealt to f5628a04 
Dealt to aecd8c87 
Dealt to 2852ea1c 
Dealt to Hero [9c 8s]
aecd8c87: folds
2852ea1c: folds
Hero: folds
3f7822ab: folds
cc07b659: folds
Uncalled bet ($0.05) returned to f5628a04
*** SHOWDOWN ***
f5628a04 collected $0.1 from pot
*** SUMMARY ***
Total pot $0.1 | Rake $0 | Jackpot $0 | Bingo $0 | Fortune $0 | Tax $0
Seat 1: 3f7822ab (button) folded before Flop (didn't bet)
Seat 2: cc07b659 (small blind) folded before Flop
Seat 3: f5628a04 (big blind) collected ($0.1)
Seat 4: aecd8c87 folded before Flop (didn't bet)
Seat 5: 2852ea1c folded before Flop (didn't bet)
Seat 6: Hero folded before Flop (didn't bet)


Poker Hand #RC3141727227: Hold'em No Limit ($0.05/$0.1) - 2024/12/12 13:15:24
Table 'RushAndCash22322487' 6-max Seat #1 is the button
Seat 1: 2852ea1c ($10.72 in chips)
Seat 2: e0a099ae ($13.18 in chips)
Seat 3: 9c716b19 ($37.47 in chips)
Seat 4: 974940e1 ($18.16 in chips)
Seat 5: Hero ($10.63 in chips)
Seat 6: 9a76e865 ($10.26 in chips)
e0a099ae: posts small blind $0.05
9c716b19: posts big blind $0.1
*** HOLE CARDS ***
Dealt to 2852ea1c 
Dealt to e0a099ae 
Dealt to 9c716b19 
Dealt to 974940e1 
Dealt to Hero [4h Td]
Dealt to 9a76e865 
974940e1: folds
Hero: folds
9a76e865: folds
2852ea1c: folds
e0a099ae: folds
Uncalled bet ($0.05) returned to 9c716b19
*** SHOWDOWN ***
9c716b19 collected $0.1 from pot
*** SUMMARY ***
Total pot $0.1 | Rake $0 | Jackpot $0 | Bingo $0 | Fortune $0 | Tax $0
Seat 1: 2852ea1c (button) folded before Flop (didn't bet)
Seat 2: e0a099ae (small blind) folded before Flop
Seat 3: 9c716b19 (big blind) collected ($0.1)
Seat 4: 974940e1 folded before Flop (didn't bet)
Seat 5: Hero folded before Flop (didn't bet)
Seat 6: 9a76e865 folded before Flop (didn't bet)


Poker Hand #RC3141727201: Hold'em No Limit ($0.05/$0.1) - 2024/12/12 13:15:19
Table 'RushAndCash22322461' 6-max Seat #1 is the button
Seat 1: 58381e93 ($9.9 in chips)
Seat 2: Hero ($10.68 in chips)
Seat 3: aecd8c87 ($19.76 in chips)
Seat 4: 73df44d1 ($10.15 in chips)
Seat 5: b863ea8c ($29.65 in chips)
Seat 6: 9cfbee05 ($10.28 in chips)
Hero: posts small blind $0.05
aecd8c87: posts big blind $0.1
*** HOLE CARDS ***
Dealt to 58381e93 
Dealt to Hero [Kd 3h]
Dealt to aecd8c87 
Dealt to 73df44d1 
Dealt to b863ea8c 
Dealt to 9cfbee05 
73df44d1: folds
b863ea8c: folds
9cfbee05: folds
58381e93: folds
Hero: folds
Uncalled bet ($0.05) returned to aecd8c87
*** SHOWDOWN ***
aecd8c87 collected $0.1 from pot
*** SUMMARY ***
Total pot $0.1 | Rake $0 | Jackpot $0 | Bingo $0 | Fortune $0 | Tax $0
Seat 1: 58381e93 (button) folded before Flop (didn't bet)
Seat 2: Hero (small blind) folded before Flop
Seat 3: aecd8c87 (big blind) collected ($0.1)
Seat 4: 73df44d1 folded before Flop (didn't bet)
Seat 5: b863ea8c folded before Flop (didn't bet)
Seat 6: 9cfbee05 folded before Flop (didn't bet)


Poker Hand #RC3141727141: Hold'em No Limit ($0.05/$0.1) - 2024/12/12 13:15:04
Table 'RushAndCash22322401' 6-max Seat #1 is the button
Seat 1: d84cc2a6 ($12.16 in chips)
Seat 2: d1122f42 ($10.35 in chips)
Seat 3: Hero ($10.78 in chips)
Seat 4: df82aa12 ($10.99 in chips)
Seat 5: 254fead6 ($4.79 in chips)
Seat 6: 3f7822ab ($20.23 in chips)
d1122f42: posts small blind $0.05
Hero: posts big blind $0.1
*** HOLE CARDS ***
Dealt to d84cc2a6 
Dealt to d1122f42 
Dealt to Hero [5d 3d]
Dealt to df82aa12 
Dealt to 254fead6 
Dealt to 3f7822ab 
df82aa12: folds
254fead6: calls $0.1
3f7822ab: folds
d84cc2a6: raises $0.27 to $0.37
d1122f42: folds
Hero: folds
254fead6: calls $0.27
*** FLOP *** [8d 5c 2h]
254fead6: checks
d84cc2a6: checks
*** TURN *** [8d 5c 2h] [Kd]
254fead6: checks
d84cc2a6: bets $0.45
254fead6: calls $0.45
*** RIVER *** [8d 5c 2h Kd] [4s]
254fead6: bets $1.79
d84cc2a6: folds
Uncalled bet ($1.79) returned to 254fead6
*** SHOWDOWN ***
254fead6 collected $1.69 from pot
*** SUMMARY ***
Total pot $1.79 | Rake $0.1 | Jackpot $0 | Bingo $0 | Fortune $0 | Tax $0
Board [8d 5c 2h Kd 4s]
Seat 1: d84cc2a6 (button) folded on the River
Seat 2: d1122f42 (small blind) folded before Flop
Seat 3: Hero (big blind) folded before Flop
Seat 4: df82aa12 folded before Flop (didn't bet)
Seat 5: 254fead6 won ($1.69)
Seat 6: 3f7822ab folded before Flop (didn't bet)


Poker Hand #RC3141727124: Hold'em No Limit ($0.05/$0.1) - 2024/12/12 13:15:01
Table 'RushAndCash22322384' 6-max Seat #1 is the button
Seat 1: Hero ($10.78 in chips)
Seat 2: ac9f5f4 ($10.09 in chips)
Seat 3: 6731d495 ($13.5 in chips)
Seat 4: d1122f42 ($10.35 in chips)
Seat 5: b828e7ee ($11.8 in chips)
Seat 6: d6b17ac7 ($12.34 in chips)
ac9f5f4: posts small blind $0.05
6731d495: posts big blind $0.1
*** HOLE CARDS ***
Dealt to Hero [5c 8h]
Dealt to ac9f5f4 
Dealt to 6731d495 
Dealt to d1122f42 
Dealt to b828e7ee 
Dealt to d6b17ac7 
d1122f42: folds
b828e7ee: folds
d6b17ac7: folds
Hero: folds
ac9f5f4: calls $0.05
6731d495: checks
*** FLOP *** [9d 3d Qd]
ac9f5f4: checks
6731d495: bets $0.1
ac9f5f4: folds
Uncalled bet ($0.1) returned to 6731d495
*** SHOWDOWN ***
6731d495 collected $0.19 from pot
*** SUMMARY ***
Total pot $0.2 | Rake $0.01 | Jackpot $0 | Bingo $0 | Fortune $0 | Tax $0
Board [9d 3d Qd]
Seat 1: Hero (button) folded before Flop (didn't bet)
Seat 2: ac9f5f4 (small blind) folded on the Flop
Seat 3: 6731d495 (big blind) won ($0.19)
Seat 4: d1122f42 folded before Flop (didn't bet)
Seat 5: b828e7ee folded before Flop (didn't bet)
Seat 6: d6b17ac7 folded before Flop (didn't bet)


Poker Hand #RC3141727102: Hold'em No Limit ($0.05/$0.1) - 2024/12/12 13:14:56
Table 'RushAndCash22322362' 6-max Seat #1 is the button
Seat 1: 3b12e634 ($12.13 in chips)
Seat 2: 3606b70a ($11.31 in chips)
Seat 3: 248d80e1 ($10 in chips)
Seat 4: Hero ($10.78 in chips)
Seat 5: f1e9bea0 ($38.14 in chips)
Seat 6: 216abb36 ($10.71 in chips)
3606b70a: posts small blind $0.05
248d80e1: posts big blind $0.1
*** HOLE CARDS ***
Dealt to 3b12e634 
Dealt to 3606b70a 
Dealt to 248d80e1 
Dealt to Hero [5c 7c]
Dealt to f1e9bea0 
Dealt to 216abb36 
Hero: folds
f1e9bea0: folds
216abb36: folds
3b12e634: raises $0.14 to $0.24
3606b70a: raises $0.76 to $1
248d80e1: folds
3b12e634: folds
Uncalled bet ($0.76) returned to 3606b70a
*** SHOWDOWN ***
3606b70a collected $0.56 from pot
*** SUMMARY ***
Total pot $0.58 | Rake $0.02 | Jackpot $0 | Bingo $0 | Fortune $0 | Tax $0
Seat 1: 3b12e634 (button) folded before Flop
Seat 2: 3606b70a (small blind) collected ($0.56)
Seat 3: 248d80e1 (big blind) folded before Flop
Seat 4: Hero folded before Flop (didn't bet)
Seat 5: f1e9bea0 folded before Flop (didn't bet)
Seat 6: 216abb36 folded before Flop (didn't bet)


Poker Hand #RC3141727081: Hold'em No Limit ($0.05/$0.1) - 2024/12/12 13:14:52
Table 'RushAndCash22322341' 6-max Seat #1 is the button
Seat 1: 17b5c9c3 ($10.25 in chips)
Seat 2: 2897fa7f ($19.83 in chips)
Seat 3: 19a20066 ($10 in chips)
Seat 4: Hero ($10.78 in chips)
Seat 5: c4d674fe ($14.66 in chips)
Seat 6: 3f1c4e6e ($16.37 in chips)
2897fa7f: posts small blind $0.05
19a20066: posts big blind $0.1
*** HOLE CARDS ***
Dealt to 17b5c9c3 
Dealt to 2897fa7f 
Dealt to 19a20066 
Dealt to Hero [9c 7c]
Dealt to c4d674fe 
Dealt to 3f1c4e6e 
Hero: folds
c4d674fe: folds
3f1c4e6e: raises $0.1 to $0.2
17b5c9c3: raises $0.45 to $0.65
2897fa7f: folds
19a20066: folds
3f1c4e6e: folds
Uncalled bet ($0.45) returned to 17b5c9c3
*** SHOWDOWN ***
17b5c9c3 collected $0.53 from pot
*** SUMMARY ***
Total pot $0.55 | Rake $0.02 | Jackpot $0 | Bingo $0 | Fortune $0 | Tax $0
Seat 1: 17b5c9c3 (button) collected ($0.53)
Seat 2: 2897fa7f (small blind) folded before Flop
Seat 3: 19a20066 (big blind) folded before Flop
Seat 4: Hero folded before Flop (didn't bet)
Seat 5: c4d674fe folded before Flop (didn't bet)
Seat 6: 3f1c4e6e folded before Flop


Poker Hand #RC3141727065: Hold'em No Limit ($0.05/$0.1) - 2024/12/12 13:14:49
Table 'RushAndCash22322325' 6-max Seat #1 is the button
Seat 1: 55251e59 ($19.94 in chips)
Seat 2: c8c2a1e ($10.73 in chips)
Seat 3: 418b0280 ($10.93 in chips)
Seat 4: d6b17ac7 ($12.34 in chips)
Seat 5: cfe70ef2 ($11.44 in chips)
Seat 6: Hero ($10.78 in chips)
c8c2a1e: posts small blind $0.05
418b0280: posts big blind $0.1
*** HOLE CARDS ***
Dealt to 55251e59 
Dealt to c8c2a1e 
Dealt to 418b0280 
Dealt to d6b17ac7 
Dealt to cfe70ef2 
Dealt to Hero [2c Jh]
d6b17ac7: folds
cfe70ef2: folds
Hero: folds
55251e59: folds
c8c2a1e: raises $0.15 to $0.25
418b0280: raises $0.75 to $1
c8c2a1e: raises $9.73 to $10.73 and is all-in
418b0280: folds
Uncalled bet ($9.73) returned to c8c2a1e
*** SHOWDOWN ***
c8c2a1e collected $1.9 from pot
*** SUMMARY ***
Total pot $2 | Rake $0.1 | Jackpot $0 | Bingo $0 | Fortune $0 | Tax $0
Seat 1: 55251e59 (button) folded before Flop (didn't bet)
Seat 2: c8c2a1e (small blind) collected ($1.9)
Seat 3: 418b0280 (big blind) folded before Flop
Seat 4: d6b17ac7 folded before Flop (didn't bet)
Seat 5: cfe70ef2 folded before Flop (didn't bet)
Seat 6: Hero folded before Flop (didn't bet)


Poker Hand #RC3141727050: Hold'em No Limit ($0.05/$0.1) - 2024/12/12 13:14:46
Table 'RushAndCash22322310' 6-max Seat #1 is the button
Seat 1: ea3eb4a4 ($10 in chips)
Seat 2: Hero ($10.83 in chips)
Seat 3: c2b852ae ($7.56 in chips)
Seat 4: 8ebc9879 ($10.18 in chips)
Seat 5: d8699a3 ($10.85 in chips)
Seat 6: 84849e11 ($88.84 in chips)
Hero: posts small blind $0.05
c2b852ae: posts big blind $0.1
*** HOLE CARDS ***
Dealt to ea3eb4a4 
Dealt to Hero [Qd 9c]
Dealt to c2b852ae 
Dealt to 8ebc9879 
Dealt to d8699a3 
Dealt to 84849e11 
8ebc9879: folds
d8699a3: folds
84849e11: folds
ea3eb4a4: folds
Hero: folds
Uncalled bet ($0.05) returned to c2b852ae
*** SHOWDOWN ***
c2b852ae collected $0.1 from pot
*** SUMMARY ***
Total pot $0.1 | Rake $0 | Jackpot $0 | Bingo $0 | Fortune $0 | Tax $0
Seat 1: ea3eb4a4 (button) folded before Flop (didn't bet)
Seat 2: Hero (small blind) folded before Flop
Seat 3: c2b852ae (big blind) collected ($0.1)
Seat 4: 8ebc9879 folded before Flop (didn't bet)
Seat 5: d8699a3 folded before Flop (didn't bet)
Seat 6: 84849e11 folded before Flop (didn't bet)


Poker Hand #RC3141727018: Hold'em No Limit ($0.05/$0.1) - 2024/12/12 13:14:38
Table 'RushAndCash22322278' 6-max Seat #1 is the button
Seat 1: 84849e11 ($88.84 in chips)
Seat 2: f564c212 ($11.43 in chips)
Seat 3: Hero ($10.78 in chips)
Seat 4: 8fc49c26 ($45.3 in chips)
Seat 5: 4c1c8756 ($10 in chips)
Seat 6: 1dc50d10 ($10 in chips)
f564c212: posts small blind $0.05
Hero: posts big blind $0.1
*** HOLE CARDS ***
Dealt to 84849e11 
Dealt to f564c212 
Dealt to Hero [Ts Qc]
Dealt to 8fc49c26 
Dealt to 4c1c8756 
Dealt to 1dc50d10 
8fc49c26: folds
4c1c8756: folds
1dc50d10: folds
84849e11: folds
f564c212: folds
Uncalled bet ($0.05) returned to Hero
*** SHOWDOWN ***
Hero collected $0.1 from pot
*** SUMMARY ***
Total pot $0.1 | Rake $0 | Jackpot $0 | Bingo $0 | Fortune $0 | Tax $0
Seat 1: 84849e11 (button) folded before Flop (didn't bet)
Seat 2: f564c212 (small blind) folded before Flop
Seat 3: Hero (big blind) collected ($0.1)
Seat 4: 8fc49c26 folded before Flop (didn't bet)
Seat 5: 4c1c8756 folded before Flop (didn't bet)
Seat 6: 1dc50d10 folded before Flop (didn't bet)


Poker Hand #RC3141727003: Hold'em No Limit ($0.05/$0.1) - 2024/12/12 13:14:34
Table 'RushAndCash22322263' 6-max Seat #1 is the button
Seat 1: Hero ($10.78 in chips)
Seat 2: 3f1c4e6e ($16.52 in chips)
Seat 3: eafba4c7 ($10 in chips)
Seat 4: 58381e93 ($9.9 in chips)
Seat 5: 56e396a1 ($10 in chips)
Seat 6: 84849e11 ($88.84 in chips)
3f1c4e6e: posts small blind $0.05
eafba4c7: posts big blind $0.1
*** HOLE CARDS ***
Dealt to Hero [8d Tc]
Dealt to 3f1c4e6e 
Dealt to eafba4c7 
Dealt to 58381e93 
Dealt to 56e396a1 
Dealt to 84849e11 
58381e93: folds
56e396a1: raises $0.15 to $0.25
84849e11: folds
Hero: folds
3f1c4e6e: folds
eafba4c7: folds
Uncalled bet ($0.15) returned to 56e396a1
*** SHOWDOWN ***
56e396a1 collected $0.25 from pot
*** SUMMARY ***
Total pot $0.25 | Rake $0 | Jackpot $0 | Bingo $0 | Fortune $0 | Tax $0
Seat 1: Hero (button) folded before Flop (didn't bet)
Seat 2: 3f1c4e6e (small blind) folded before Flop
Seat 3: eafba4c7 (big blind) folded before Flop
Seat 4: 58381e93 folded before Flop (didn't bet)
Seat 5: 56e396a1 collected ($0.25)
Seat 6: 84849e11 folded before Flop (didn't bet)


Poker Hand #RC3141726728: Hold'em No Limit ($0.05/$0.1) - 2024/12/12 13:13:25
Table 'RushAndCash22321988' 6-max Seat #1 is the button
Seat 1: Hero ($10 in chips)
Seat 2: 37236510 ($9.21 in chips)
Seat 3: 8a31e4cb ($10.35 in chips)
Seat 4: 4d1634eb ($13.6 in chips)
Seat 5: c8c2a1e ($10.78 in chips)
Seat 6: 4c1c8756 ($10 in chips)
37236510: posts small blind $0.05
8a31e4cb: posts big blind $0.1
*** HOLE CARDS ***
Dealt to Hero [Td Ts]
Dealt to 37236510 
Dealt to 8a31e4cb 
Dealt to 4d1634eb 
Dealt to c8c2a1e 
Dealt to 4c1c8756 
4d1634eb: folds
c8c2a1e: folds
4c1c8756: raises $0.1 to $0.2
Hero: raises $0.5 to $0.7
37236510: folds
8a31e4cb: folds
4c1c8756: calls $0.5
*** FLOP *** [6s 2h 5s]
4c1c8756: checks
Hero: checks
*** TURN *** [6s 2h 5s] [2s]
4c1c8756: checks
Hero: checks
*** RIVER *** [6s 2h 5s 2s] [Tc]
4c1c8756: checks
Hero: bets $1.5
4c1c8756: folds
Uncalled bet ($1.5) returned to Hero
*** SHOWDOWN ***
Hero collected $1.48 from pot
*** SUMMARY ***
Total pot $1.55 | Rake $0.07 | Jackpot $0 | Bingo $0 | Fortune $0 | Tax $0
Board [6s 2h 5s 2s Tc]
Seat 1: Hero (button) won ($1.48)
Seat 2: 37236510 (small blind) folded before Flop
Seat 3: 8a31e4cb (big blind) folded before Flop
Seat 4: 4d1634eb folded before Flop (didn't bet)
Seat 5: c8c2a1e folded before Flop (didn't bet)
Seat 6: 4c1c8756 folded on the River


Poker Hand #RC3141726545: Hold'em No Limit ($0.05/$0.1) - 2024/12/12 13:12:41
Table 'RushAndCash22321805' 6-max Seat #1 is the button
Seat 1: cc8462b1 ($10 in chips)
Seat 2: d27812f5 ($10.19 in chips)
Seat 3: Hero ($10.1 in chips)
Seat 4: 3b1bb7c0 ($13.97 in chips)
Seat 5: 506e90c1 ($10 in chips)
Seat 6: 81834a2f ($13.25 in chips)
d27812f5: posts small blind $0.05
Hero: posts big blind $0.1
*** HOLE CARDS ***
Dealt to cc8462b1 
Dealt to d27812f5 
Dealt to Hero [6c 6s]
Dealt to 3b1bb7c0 
Dealt to 506e90c1 
Dealt to 81834a2f 
3b1bb7c0: folds
506e90c1: folds
81834a2f: folds
cc8462b1: raises $0.15 to $0.25
d27812f5: calls $0.2
Hero: calls $0.15
*** FLOP *** [2d 9d Qs]
d27812f5: checks
Hero: checks
cc8462b1: bets $0.35
d27812f5: calls $0.35
Hero: folds
*** TURN *** [2d 9d Qs] [4c]
d27812f5: checks
cc8462b1: bets $0.9
d27812f5: raises $1.7 to $2.6
cc8462b1: folds
Uncalled bet ($1.7) returned to d27812f5
*** SHOWDOWN ***
d27812f5 collected $2.95 from pot
*** SUMMARY ***
Total pot $3.25 | Rake $0.15 | Jackpot $0.15 | Bingo $0 | Fortune $0 | Tax $0
Board [2d 9d Qs 4c]
Seat 1: cc8462b1 (button) folded on the Turn
Seat 2: d27812f5 (small blind) won ($2.95)
Seat 3: Hero (big blind) folded on the Flop
Seat 4: 3b1bb7c0 folded before Flop (didn't bet)
Seat 5: 506e90c1 folded before Flop (didn't bet)
Seat 6: 81834a2f folded before Flop (didn't bet)


Poker Hand #RC3141726490: Hold'em No Limit ($0.05/$0.1) - 2024/12/12 13:12:26
Table 'RushAndCash22321750' 6-max Seat #1 is the button
Seat 1: 607eb8c2 ($10.37 in chips)
Seat 2: Hero ($10 in chips)
Seat 3: ff1406c1 ($14.02 in chips)
Seat 4: 4b71434f ($10.29 in chips)
Seat 5: c8c2a1e ($12.31 in chips)
Seat 6: c6352e1c ($11.78 in chips)
Hero: posts small blind $0.05
ff1406c1: posts big blind $0.1
*** HOLE CARDS ***
Dealt to 607eb8c2 
Dealt to Hero [Ts As]
Dealt to ff1406c1 
Dealt to 4b71434f 
Dealt to c8c2a1e 
Dealt to c6352e1c 
4b71434f: folds
c8c2a1e: folds
c6352e1c: folds
607eb8c2: folds
Hero: raises $0.2 to $0.3
ff1406c1: folds
Uncalled bet ($0.2) returned to Hero
*** SHOWDOWN ***
Hero collected $0.2 from pot
*** SUMMARY ***
Total pot $0.2 | Rake $0 | Jackpot $0 | Bingo $0 | Fortune $0 | Tax $0
Seat 1: 607eb8c2 (button) folded before Flop (didn't bet)
Seat 2: Hero (small blind) collected ($0.2)
Seat 3: ff1406c1 (big blind) folded before Flop
Seat 4: 4b71434f folded before Flop (didn't bet)
Seat 5: c8c2a1e folded before Flop (didn't bet)
Seat 6: c6352e1c folded before Flop (didn't bet)


Poker Hand #RC3141726475: Hold'em No Limit ($0.05/$0.1) - 2024/12/12 13:12:23
Table 'RushAndCash22321735' 6-max Seat #1 is the button
Seat 1: 51acfaf6 ($19.4 in chips)
Seat 2: 607eb8c2 ($10.42 in chips)
Seat 3: a212e67a ($10 in chips)
Seat 4: c6352e1c ($11.78 in chips)
Seat 5: ff1406c1 ($14.02 in chips)
Seat 6: Hero ($10 in chips)
607eb8c2: posts small blind $0.05
a212e67a: posts big blind $0.1
*** HOLE CARDS ***
Dealt to 51acfaf6 
Dealt to 607eb8c2 
Dealt to a212e67a 
Dealt to c6352e1c 
Dealt to ff1406c1 
Dealt to Hero [7c Td]
c6352e1c: folds
ff1406c1: folds
Hero: folds
51acfaf6: raises $0.1 to $0.2
607eb8c2: folds
a212e67a: folds
Uncalled bet ($0.1) returned to 51acfaf6
*** SHOWDOWN ***
51acfaf6 collected $0.25 from pot
*** SUMMARY ***
Total pot $0.25 | Rake $0 | Jackpot $0 | Bingo $0 | Fortune $0 | Tax $0
Seat 1: 51acfaf6 (button) collected ($0.25)
Seat 2: 607eb8c2 (small blind) folded before Flop
Seat 3: a212e67a (big blind) folded before Flop
Seat 4: c6352e1c folded before Flop (didn't bet)
Seat 5: ff1406c1 folded before Flop (didn't bet)
Seat 6: Hero folded before Flop (didn't bet)


Poker Hand #RC3141726459: Hold'em No Limit ($0.05/$0.1) - 2024/12/12 13:12:19
Table 'RushAndCash22321719' 6-max Seat #1 is the button
Seat 1: a6717311 ($10 in chips)
Seat 2: ff1406c1 ($14.07 in chips)
Seat 3: 526323fa ($13.12 in chips)
Seat 4: 228a039d ($12.63 in chips)
Seat 5: Hero ($10 in chips)
Seat 6: 506e90c1 ($10 in chips)
ff1406c1: posts small blind $0.05
526323fa: posts big blind $0.1
*** HOLE CARDS ***
Dealt to a6717311 
Dealt to ff1406c1 
Dealt to 526323fa 
Dealt to 228a039d 
Dealt to Hero [4c Th]
Dealt to 506e90c1 
228a039d: folds
Hero: folds
506e90c1: folds
a6717311: folds
ff1406c1: folds
Uncalled bet ($0.05) returned to 526323fa
*** SHOWDOWN ***
526323fa collected $0.1 from pot
*** SUMMARY ***
Total pot $0.1 | Rake $0 | Jackpot $0 | Bingo $0 | Fortune $0 | Tax $0
Seat 1: a6717311 (button) folded before Flop (didn't bet)
Seat 2: ff1406c1 (small blind) folded before Flop
Seat 3: 526323fa (big blind) collected ($0.1)
Seat 4: 228a039d folded before Flop (didn't bet)
Seat 5: Hero folded before Flop (didn't bet)
Seat 6: 506e90c1 folded before Flop (didn't bet)


Poker Hand #RC3141726324: Hold'em No Limit ($0.05/$0.1) - 2024/12/12 13:11:40
Table 'RushAndCash22321584' 6-max Seat #1 is the button
Seat 1: 216abb36 ($10.15 in chips)
Seat 2: b863ea8c ($27.47 in chips)
Seat 3: 2e3105a5 ($11.85 in chips)
Seat 4: Hero ($10.2 in chips)
Seat 5: 526323fa ($12.79 in chips)
Seat 6: 8fc49c26 ($44.97 in chips)
b863ea8c: posts small blind $0.05
2e3105a5: posts big blind $0.1
*** HOLE CARDS ***
Dealt to 216abb36 
Dealt to b863ea8c 
Dealt to 2e3105a5 
Dealt to Hero [Ac Js]
Dealt to 526323fa 
Dealt to 8fc49c26 
Hero: raises $0.1 to $0.2
526323fa: calls $0.2
8fc49c26: folds
216abb36: folds
b863ea8c: folds
2e3105a5: folds
*** FLOP *** [Kc Td Jh]
Hero: checks
526323fa: bets $0.42
Hero: folds
Uncalled bet ($0.42) returned to 526323fa
*** SHOWDOWN ***
526323fa collected $0.53 from pot
*** SUMMARY ***
Total pot $0.55 | Rake $0.02 | Jackpot $0 | Bingo $0 | Fortune $0 | Tax $0
Board [Kc Td Jh]
Seat 1: 216abb36 (button) folded before Flop (didn't bet)
Seat 2: b863ea8c (small blind) folded before Flop
Seat 3: 2e3105a5 (big blind) folded before Flop
Seat 4: Hero folded on the Flop
Seat 5: 526323fa won ($0.53)
Seat 6: 8fc49c26 folded before Flop (didn't bet)


Poker Hand #RC3141726308: Hold'em No Limit ($0.05/$0.1) - 2024/12/12 13:11:34
Table 'RushAndCash22321568' 6-max Seat #1 is the button
Seat 1: 5b32d7fc ($12.48 in chips)
Seat 2: 8422b573 ($10.23 in chips)
Seat 3: 1dc34506 ($12.57 in chips)
Seat 4: 41ad32d3 ($22.93 in chips)
Seat 5: 4dd7bc95 ($10.3 in chips)
Seat 6: Hero ($10.2 in chips)
8422b573: posts small blind $0.05
1dc34506: posts big blind $0.1
*** HOLE CARDS ***
Dealt to 5b32d7fc 
Dealt to 8422b573 
Dealt to 1dc34506 
Dealt to 41ad32d3 
Dealt to 4dd7bc95 
Dealt to Hero [Qs 5s]
41ad32d3: folds
4dd7bc95: folds
Hero: folds
5b32d7fc: raises $0.1 to $0.2
8422b573: folds
1dc34506: folds
Uncalled bet ($0.1) returned to 5b32d7fc
*** SHOWDOWN ***
5b32d7fc collected $0.25 from pot
*** SUMMARY ***
Total pot $0.25 | Rake $0 | Jackpot $0 | Bingo $0 | Fortune $0 | Tax $0
Seat 1: 5b32d7fc (button) collected ($0.25)
Seat 2: 8422b573 (small blind) folded before Flop
Seat 3: 1dc34506 (big blind) folded before Flop
Seat 4: 41ad32d3 folded before Flop (didn't bet)
Seat 5: 4dd7bc95 folded before Flop (didn't bet)
Seat 6: Hero folded before Flop (didn't bet)


Poker Hand #RC3141726283: Hold'em No Limit ($0.05/$0.1) - 2024/12/12 13:11:28
Table 'RushAndCash22321543' 6-max Seat #1 is the button
Seat 1: b82279c3 ($26.66 in chips)
Seat 2: 8fc49c26 ($45.02 in chips)
Seat 3: f1e9bea0 ($39.16 in chips)
Seat 4: b738541f ($11.26 in chips)
Seat 5: Hero ($10.2 in chips)
Seat 6: 6731d495 ($14.47 in chips)
8fc49c26: posts small blind $0.05
f1e9bea0: posts big blind $0.1
*** HOLE CARDS ***
Dealt to b82279c3 
Dealt to 8fc49c26 
Dealt to f1e9bea0 
Dealt to b738541f 
Dealt to Hero [As 6d]
Dealt to 6731d495 
b738541f: folds
Hero: folds
6731d495: raises $0.1 to $0.2
b82279c3: folds
8fc49c26: folds
f1e9bea0: folds
Uncalled bet ($0.1) returned to 6731d495
*** SHOWDOWN ***
6731d495 collected $0.25 from pot
*** SUMMARY ***
Total pot $0.25 | Rake $0 | Jackpot $0 | Bingo $0 | Fortune $0 | Tax $0
Seat 1: b82279c3 (button) folded before Flop (didn't bet)
Seat 2: 8fc49c26 (small blind) folded before Flop
Seat 3: f1e9bea0 (big blind) folded before Flop
Seat 4: b738541f folded before Flop (didn't bet)
Seat 5: Hero folded before Flop (didn't bet)
Seat 6: 6731d495 collected ($0.25)


Poker Hand #RC3141726269: Hold'em No Limit ($0.05/$0.1) - 2024/12/12 13:11:24
Table 'RushAndCash22321529' 6-max Seat #1 is the button
Seat 1: 52c6c741 ($12.3 in chips)
Seat 2: 264523b9 ($20.57 in chips)
Seat 3: 2441c176 ($10.79 in chips)
Seat 4: Hero ($10.2 in chips)
Seat 5: 84cc5caa ($10.65 in chips)
Seat 6: 643f85e7 ($10.63 in chips)
264523b9: posts small blind $0.05
2441c176: posts big blind $0.1
*** HOLE CARDS ***
Dealt to 52c6c741 
Dealt to 264523b9 
Dealt to 2441c176 
Dealt to Hero [Ad 2d]
Dealt to 84cc5caa 
Dealt to 643f85e7 
Hero: folds
84cc5caa: folds
643f85e7: folds
52c6c741: folds
264523b9: raises $0.2 to $0.3
2441c176: raises $0.6 to $0.9
264523b9: folds
Uncalled bet ($0.6) returned to 2441c176
*** SHOWDOWN ***
2441c176 collected $0.57 from pot
*** SUMMARY ***
Total pot $0.6 | Rake $0.03 | Jackpot $0 | Bingo $0 | Fortune $0 | Tax $0
Seat 1: 52c6c741 (button) folded before Flop (didn't bet)
Seat 2: 264523b9 (small blind) folded before Flop
Seat 3: 2441c176 (big blind) collected ($0.57)
Seat 4: Hero folded before Flop (didn't bet)
Seat 5: 84cc5caa folded before Flop (didn't bet)
Seat 6: 643f85e7 folded before Flop (didn't bet)


Poker Hand #RC3141726255: Hold'em No Limit ($0.05/$0.1) - 2024/12/12 13:11:21
Table 'RushAndCash22321515' 6-max Seat #1 is the button
Seat 1: 4859226e ($7.66 in chips)
Seat 2: ed5370bd ($11.21 in chips)
Seat 3: 6dcb955a ($13.03 in chips)
Seat 4: 2ffa3e66 ($10 in chips)
Seat 5: c67e237e ($18.68 in chips)
Seat 6: Hero ($10.2 in chips)
ed5370bd: posts small blind $0.05
6dcb955a: posts big blind $0.1
*** HOLE CARDS ***
Dealt to 4859226e 
Dealt to ed5370bd 
Dealt to 6dcb955a 
Dealt to 2ffa3e66 
Dealt to c67e237e 
Dealt to Hero [6s Kd]
2ffa3e66: folds
c67e237e: folds
Hero: folds
4859226e: raises $0.2 to $0.3
ed5370bd: folds
6dcb955a: folds
Uncalled bet ($0.2) returned to 4859226e
*** SHOWDOWN ***
4859226e collected $0.25 from pot
*** SUMMARY ***
Total pot $0.25 | Rake $0 | Jackpot $0 | Bingo $0 | Fortune $0 | Tax $0
Seat 1: 4859226e (button) collected ($0.25)
Seat 2: ed5370bd (small blind) folded before Flop
Seat 3: 6dcb955a (big blind) folded before Flop
Seat 4: 2ffa3e66 folded before Flop (didn't bet)
Seat 5: c67e237e folded before Flop (didn't bet)
Seat 6: Hero folded before Flop (didn't bet)


Poker Hand #RC3141726173: Hold'em No Limit ($0.05/$0.1) - 2024/12/12 13:11:00
Table 'RushAndCash22321433' 6-max Seat #1 is the button
Seat 1: b51a8683 ($10 in chips)
Seat 2: 647dd971 ($2.5 in chips)
Seat 3: Hero ($10.15 in chips)
Seat 4: 84cc5caa ($10.8 in chips)
Seat 5: 6dcb955a ($13.08 in chips)
Seat 6: 593f64c7 ($4 in chips)
647dd971: posts small blind $0.05
Hero: posts big blind $0.1
*** HOLE CARDS ***
Dealt to b51a8683 
Dealt to 647dd971 
Dealt to Hero [Js Qd]
Dealt to 84cc5caa 
Dealt to 6dcb955a 
Dealt to 593f64c7 
84cc5caa: folds
6dcb955a: folds
593f64c7: folds
b51a8683: folds
647dd971: folds
Uncalled bet ($0.05) returned to Hero
*** SHOWDOWN ***
Hero collected $0.1 from pot
*** SUMMARY ***
Total pot $0.1 | Rake $0 | Jackpot $0 | Bingo $0 | Fortune $0 | Tax $0
Seat 1: b51a8683 (button) folded before Flop (didn't bet)
Seat 2: 647dd971 (small blind) folded before Flop
Seat 3: Hero (big blind) collected ($0.1)
Seat 4: 84cc5caa folded before Flop (didn't bet)
Seat 5: 6dcb955a folded before Flop (didn't bet)
Seat 6: 593f64c7 folded before Flop (didn't bet)


Poker Hand #RC3141726162: Hold'em No Limit ($0.05/$0.1) - 2024/12/12 13:10:57
Table 'RushAndCash22321422' 6-max Seat #1 is the button
Seat 1: Hero ($10.15 in chips)
Seat 2: 2a6446ed ($12.57 in chips)
Seat 3: ed5370bd ($11.31 in chips)
Seat 4: ee394d0a ($10.89 in chips)
Seat 5: 468bfba8 ($10 in chips)
Seat 6: 9d398432 ($13.36 in chips)
2a6446ed: posts small blind $0.05
ed5370bd: posts big blind $0.1
*** HOLE CARDS ***
Dealt to Hero [3d Ks]
Dealt to 2a6446ed 
Dealt to ed5370bd 
Dealt to ee394d0a 
Dealt to 468bfba8 
Dealt to 9d398432 
ee394d0a: folds
468bfba8: folds
9d398432: folds
Hero: folds
2a6446ed: raises $0.2 to $0.3
ed5370bd: folds
Uncalled bet ($0.2) returned to 2a6446ed
*** SHOWDOWN ***
2a6446ed collected $0.2 from pot
*** SUMMARY ***
Total pot $0.2 | Rake $0 | Jackpot $0 | Bingo $0 | Fortune $0 | Tax $0
Seat 1: Hero (button) folded before Flop (didn't bet)
Seat 2: 2a6446ed (small blind) collected ($0.2)
Seat 3: ed5370bd (big blind) folded before Flop
Seat 4: ee394d0a folded before Flop (didn't bet)
Seat 5: 468bfba8 folded before Flop (didn't bet)
Seat 6: 9d398432 folded before Flop (didn't bet)


Poker Hand #RC3141726152: Hold'em No Limit ($0.05/$0.1) - 2024/12/12 13:10:54
Table 'RushAndCash22321412' 6-max Seat #1 is the button
Seat 1: 4cf26e8f ($12.58 in chips)
Seat 2: 3b1bb7c0 ($14.79 in chips)
Seat 3: d1122f42 ($10.97 in chips)
Seat 4: Hero ($10.15 in chips)
Seat 5: 9d398432 ($13.36 in chips)
Seat 6: 71ddee08 ($10.95 in chips)
3b1bb7c0: posts small blind $0.05
d1122f42: posts big blind $0.1
*** HOLE CARDS ***
Dealt to 4cf26e8f 
Dealt to 3b1bb7c0 
Dealt to d1122f42 
Dealt to Hero [4s 8d]
Dealt to 9d398432 
Dealt to 71ddee08 
Hero: folds
9d398432: folds
71ddee08: raises $0.2 to $0.3
4cf26e8f: folds
3b1bb7c0: folds
d1122f42: calls $0.2
*** FLOP *** [Th 9c Qc]
d1122f42: checks
71ddee08: checks
*** TURN *** [Th 9c Qc] [9d]
d1122f42: bets $0.2
71ddee08: folds
Uncalled bet ($0.2) returned to d1122f42
*** SHOWDOWN ***
d1122f42 collected $0.62 from pot
*** SUMMARY ***
Total pot $0.65 | Rake $0.03 | Jackpot $0 | Bingo $0 | Fortune $0 | Tax $0
Board [Th 9c Qc 9d]
Seat 1: 4cf26e8f (button) folded before Flop (didn't bet)
Seat 2: 3b1bb7c0 (small blind) folded before Flop
Seat 3: d1122f42 (big blind) won ($0.62)
Seat 4: Hero folded before Flop (didn't bet)
Seat 5: 9d398432 folded before Flop (didn't bet)
Seat 6: 71ddee08 folded on the Turn


Poker Hand #RC3141726138: Hold'em No Limit ($0.05/$0.1) - 2024/12/12 13:10:50
Table 'RushAndCash22321398' 6-max Seat #1 is the button
Seat 1: bc092e13 ($11.07 in chips)
Seat 2: Hero ($10 in chips)
Seat 3: 8424fd65 ($15.87 in chips)
Seat 4: 7b43c302 ($10 in chips)
Seat 5: 84cc5caa ($10.8 in chips)
Seat 6: 506e90c1 ($10.06 in chips)
Hero: posts small blind $0.05
8424fd65: posts big blind $0.1
*** HOLE CARDS ***
Dealt to bc092e13 
Dealt to Hero [7h Qs]
Dealt to 8424fd65 
Dealt to 7b43c302 
Dealt to 84cc5caa 
Dealt to 506e90c1 
7b43c302: raises $0.15 to $0.25
84cc5caa: folds
506e90c1: folds
bc092e13: folds
Hero: folds
8424fd65: calls $0.15
*** FLOP *** [Js 7s Qd]
8424fd65: checks
7b43c302: bets $0.28
8424fd65: folds
Uncalled bet ($0.28) returned to 7b43c302
*** SHOWDOWN ***
7b43c302 collected $0.53 from pot
*** SUMMARY ***
Total pot $0.55 | Rake $0.02 | Jackpot $0 | Bingo $0 | Fortune $0 | Tax $0
Board [Js 7s Qd]
Seat 1: bc092e13 (button) folded before Flop (didn't bet)
Seat 2: Hero (small blind) folded before Flop
Seat 3: 8424fd65 (big blind) folded on the Flop
Seat 4: 7b43c302 won ($0.53)
Seat 5: 84cc5caa folded before Flop (didn't bet)
Seat 6: 506e90c1 folded before Flop (didn't bet)


Poker Hand #RC3141726127: Hold'em No Limit ($0.05/$0.1) - 2024/12/12 13:10:46
Table 'RushAndCash22321387' 6-max Seat #1 is the button
Seat 1: 8424fd65 ($15.87 in chips)
Seat 2: ee394d0a ($10.94 in chips)
Seat 3: Hero ($10.1 in chips)
Seat 4: 264523b9 ($20.93 in chips)
Seat 5: 506e90c1 ($10.06 in chips)
Seat 6: e04e7077 ($10 in chips)
ee394d0a: posts small blind $0.05
Hero: posts big blind $0.1
*** HOLE CARDS ***
Dealt to 8424fd65 
Dealt to ee394d0a 
Dealt to Hero [Kh 3d]
Dealt to 264523b9 
Dealt to 506e90c1 
Dealt to e04e7077 
264523b9: folds
506e90c1: folds
e04e7077: folds
8424fd65: folds
ee394d0a: folds
Uncalled bet ($0.05) returned to Hero
*** SHOWDOWN ***
Hero collected $0.1 from pot
*** SUMMARY ***
Total pot $0.1 | Rake $0 | Jackpot $0 | Bingo $0 | Fortune $0 | Tax $0
Seat 1: 8424fd65 (button) folded before Flop (didn't bet)
Seat 2: ee394d0a (small blind) folded before Flop
Seat 3: Hero (big blind) collected ($0.1)
Seat 4: 264523b9 folded before Flop (didn't bet)
Seat 5: 506e90c1 folded before Flop (didn't bet)
Seat 6: e04e7077 folded before Flop (didn't bet)


Poker Hand #RC3141726115: Hold'em No Limit ($0.05/$0.1) - 2024/12/12 13:10:43
Table 'RushAndCash22321375' 6-max Seat #1 is the button
Seat 1: f2b49ec ($11.42 in chips)
Seat 2: 1677a3f4 ($13.79 in chips)
Seat 3: 7fe88fe3 ($11.39 in chips)
Seat 4: c6786b68 ($12.36 in chips)
Seat 5: Hero ($10.1 in chips)
Seat 6: 637471ad ($10 in chips)
1677a3f4: posts small blind $0.05
7fe88fe3: posts big blind $0.1
*** HOLE CARDS ***
Dealt to f2b49ec 
Dealt to 1677a3f4 
Dealt to 7fe88fe3 
Dealt to c6786b68 
Dealt to Hero [Js Qc]
Dealt to 637471ad 
c6786b68: raises $0.15 to $0.25
Hero: folds
637471ad: folds
f2b49ec: calls $0.25
1677a3f4: folds
7fe88fe3: folds
*** FLOP *** [Td 7d 6h]
c6786b68: bets $0.65
f2b49ec: calls $0.65
*** TURN *** [Td 7d 6h] [8s]
c6786b68: checks
f2b49ec: bets $1.47
c6786b68: calls $1.47
*** RIVER *** [Td 7d 6h 8s] [7c]
c6786b68: checks
f2b49ec: bets $3.67
c6786b68: calls $3.67
f2b49ec: shows [8d 7h] (Sevens Full over Eights)
c6786b68: shows [Kh Kc] (Pair of Kings and Pair of Sevens)
*** SHOWDOWN ***
f2b49ec collected $11.78 from pot
*** SUMMARY ***
Total pot $12.23 | Rake $0.3 | Jackpot $0.15 | Bingo $0 | Fortune $0 | Tax $0
Board [Td 7d 6h 8s 7c]
Seat 1: f2b49ec (button) showed [8d 7h] and won ($11.78) with Sevens Full over Eights
Seat 2: 1677a3f4 (small blind) folded before Flop
Seat 3: 7fe88fe3 (big blind) folded before Flop
Seat 4: c6786b68 showed [Kh Kc] and lost with Pair of Kings and Pair of Sevens
Seat 5: Hero folded before Flop (didn't bet)
Seat 6: 637471ad folded before Flop (didn't bet)


Poker Hand #RC3141726091: Hold'em No Limit ($0.05/$0.1) - 2024/12/12 13:10:37
Table 'RushAndCash22321351' 6-max Seat #1 is the button
Seat 1: 3c7673d9 ($11.73 in chips)
Seat 2: Hero ($10.15 in chips)
Seat 3: 52c6c741 ($12.12 in chips)
Seat 4: 713307d1 ($8.47 in chips)
Seat 5: 1d2dacdf ($10 in chips)
Seat 6: 6a8aff3d ($40.37 in chips)
Hero: posts small blind $0.05
52c6c741: posts big blind $0.1
*** HOLE CARDS ***
Dealt to 3c7673d9 
Dealt to Hero [2c 3h]
Dealt to 52c6c741 
Dealt to 713307d1 
Dealt to 1d2dacdf 
Dealt to 6a8aff3d 
713307d1: folds
1d2dacdf: raises $0.1 to $0.2
6a8aff3d: folds
3c7673d9: folds
Hero: folds
52c6c741: folds
Uncalled bet ($0.1) returned to 1d2dacdf
*** SHOWDOWN ***
1d2dacdf collected $0.25 from pot
*** SUMMARY ***
Total pot $0.25 | Rake $0 | Jackpot $0 | Bingo $0 | Fortune $0 | Tax $0
Seat 1: 3c7673d9 (button) folded before Flop (didn't bet)
Seat 2: Hero (small blind) folded before Flop
Seat 3: 52c6c741 (big blind) folded before Flop
Seat 4: 713307d1 folded before Flop (didn't bet)
Seat 5: 1d2dacdf collected ($0.25)
Seat 6: 6a8aff3d folded before Flop (didn't bet)


Poker Hand #RC3141726072: Hold'em No Limit ($0.05/$0.1) - 2024/12/12 13:10:32
Table 'RushAndCash22321332' 6-max Seat #1 is the button
Seat 1: 721d2ee6 ($13.04 in chips)
Seat 2: f1e9bea0 ($40.33 in chips)
Seat 3: 1677a3f4 ($13.89 in chips)
Seat 4: a7936163 ($25 in chips)
Seat 5: d8ef6e0b ($10 in chips)
Seat 6: Hero ($10.15 in chips)
f1e9bea0: posts small blind $0.05
1677a3f4: posts big blind $0.1
*** HOLE CARDS ***
Dealt to 721d2ee6 
Dealt to f1e9bea0 
Dealt to 1677a3f4 
Dealt to a7936163 
Dealt to d8ef6e0b 
Dealt to Hero [2d Ks]
a7936163: folds
d8ef6e0b: raises $0.1 to $0.2
Hero: folds
721d2ee6: calls $0.2
f1e9bea0: folds
1677a3f4: folds
*** FLOP *** [Ad Kc 8s]
d8ef6e0b: checks
721d2ee6: bets $0.19
d8ef6e0b: calls $0.19
*** TURN *** [Ad Kc 8s] [4h]
d8ef6e0b: checks
721d2ee6: checks
*** RIVER *** [Ad Kc 8s 4h] [Qs]
d8ef6e0b: checks
721d2ee6: checks
d8ef6e0b: shows [9s 9d] (Pair of Nines)
721d2ee6: shows [9h 9c] (Pair of Nines)
*** SHOWDOWN ***
d8ef6e0b collected $0.45 from pot
721d2ee6 collected $0.44 from pot
*** SUMMARY ***
Total pot $0.93 | Rake $0.04 | Jackpot $0 | Bingo $0 | Fortune $0 | Tax $0
Board [Ad Kc 8s 4h Qs]
Seat 1: 721d2ee6 (button) showed [9h 9c] and won ($0.44) with Pair of Nines
Seat 2: f1e9bea0 (small blind) folded before Flop
Seat 3: 1677a3f4 (big blind) folded before Flop
Seat 4: a7936163 folded before Flop (didn't bet)
Seat 5: d8ef6e0b showed [9s 9d] and won ($0.45) with Pair of Nines
Seat 6: Hero folded before Flop (didn't bet)


Poker Hand #RC3141725986: Hold'em No Limit ($0.05/$0.1) - 2024/12/12 13:10:12
Table 'RushAndCash22321246' 6-max Seat #1 is the button
Seat 1: Hero ($10 in chips)
Seat 2: 3e729116 ($12.91 in chips)
Seat 3: 1dc34506 ($11.96 in chips)
Seat 4: 37686872 ($15.02 in chips)
Seat 5: 70f16de6 ($9.73 in chips)
Seat 6: b0559006 ($4.33 in chips)
3e729116: posts small blind $0.05
1dc34506: posts big blind $0.1
*** HOLE CARDS ***
Dealt to Hero [8c 7c]
Dealt to 3e729116 
Dealt to 1dc34506 
Dealt to 37686872 
Dealt to 70f16de6 
Dealt to b0559006 
37686872: folds
70f16de6: folds
b0559006: folds
Hero: raises $0.15 to $0.25
3e729116: folds
1dc34506: folds
Uncalled bet ($0.15) returned to Hero
*** SHOWDOWN ***
Hero collected $0.25 from pot
*** SUMMARY ***
Total pot $0.25 | Rake $0 | Jackpot $0 | Bingo $0 | Fortune $0 | Tax $0
Seat 1: Hero (button) collected ($0.25)
Seat 2: 3e729116 (small blind) folded before Flop
Seat 3: 1dc34506 (big blind) folded before Flop
Seat 4: 37686872 folded before Flop (didn't bet)
Seat 5: 70f16de6 folded before Flop (didn't bet)
Seat 6: b0559006 folded before Flop (didn't bet)


Poker Hand #RC3141725923: Hold'em No Limit ($0.05/$0.1) - 2024/12/12 13:09:57
Table 'RushAndCash22321183' 6-max Seat #1 is the button
Seat 1: 54a8e111 ($13.13 in chips)
Seat 2: Hero ($10 in chips)
Seat 3: 9ab5b010 ($25.1 in chips)
Seat 4: 8d92b14e ($10 in chips)
Seat 5: 4c1c8756 ($10 in chips)
Seat 6: 3f7822ab ($20.22 in chips)
Hero: posts small blind $0.05
9ab5b010: posts big blind $0.1
*** HOLE CARDS ***
Dealt to 54a8e111 
Dealt to Hero [Jc Jd]
Dealt to 9ab5b010 
Dealt to 8d92b14e 
Dealt to 4c1c8756 
Dealt to 3f7822ab 
8d92b14e: raises $0.1 to $0.2
4c1c8756: folds
3f7822ab: folds
54a8e111: raises $0.42 to $0.62
Hero: folds
9ab5b010: folds
8d92b14e: folds
Uncalled bet ($0.42) returned to 54a8e111
*** SHOWDOWN ***
54a8e111 collected $0.53 from pot
*** SUMMARY ***
Total pot $0.55 | Rake $0.02 | Jackpot $0 | Bingo $0 | Fortune $0 | Tax $0
Seat 1: 54a8e111 (button) collected ($0.53)
Seat 2: Hero (small blind) folded before Flop
Seat 3: 9ab5b010 (big blind) folded before Flop
Seat 4: 8d92b14e folded before Flop
Seat 5: 4c1c8756 folded before Flop (didn't bet)
Seat 6: 3f7822ab folded before Flop (didn't bet)


Poker Hand #RC3141725907: Hold'em No Limit ($0.05/$0.1) - 2024/12/12 13:09:54
Table 'RushAndCash22321167' 6-max Seat #1 is the button
Seat 1: Hero ($10 in chips)
Seat 2: 264523b9 ($20.98 in chips)
Seat 3: bc641322 ($3.02 in chips)
Seat 4: 11a00985 ($18.06 in chips)
Seat 5: 54a8e111 ($13.13 in chips)
Seat 6: 7576a2e9 ($12.84 in chips)
264523b9: posts small blind $0.05
bc641322: posts big blind $0.1
*** HOLE CARDS ***
Dealt to Hero [6d 3d]
Dealt to 264523b9 
Dealt to bc641322 
Dealt to 11a00985 
Dealt to 54a8e111 
Dealt to 7576a2e9 
11a00985: raises $0.1 to $0.2
54a8e111: folds
7576a2e9: folds
Hero: folds
264523b9: folds
bc641322: raises $2.82 to $3.02 and is all-in
11a00985: folds
Uncalled bet ($2.82) returned to bc641322
*** SHOWDOWN ***
bc641322 collected $0.43 from pot
*** SUMMARY ***
Total pot $0.45 | Rake $0.02 | Jackpot $0 | Bingo $0 | Fortune $0 | Tax $0
Seat 1: Hero (button) folded before Flop (didn't bet)
Seat 2: 264523b9 (small blind) folded before Flop
Seat 3: bc641322 (big blind) collected ($0.43)
Seat 4: 11a00985 folded before Flop
Seat 5: 54a8e111 folded before Flop (didn't bet)
Seat 6: 7576a2e9 folded before Flop (didn't bet)


Poker Hand #RC3141725889: Hold'em No Limit ($0.05/$0.1) - 2024/12/12 13:09:50
Table 'RushAndCash22321149' 6-max Seat #1 is the button
Seat 1: 37c4dd3d ($11.58 in chips)
Seat 2: 893fb5b9 ($10 in chips)
Seat 3: b17f5bfe ($7.7 in chips)
Seat 4: 28704252 ($10 in chips)
Seat 5: 671b32fd ($14.26 in chips)
Seat 6: Hero ($10 in chips)
893fb5b9: posts small blind $0.05
b17f5bfe: posts big blind $0.1
*** HOLE CARDS ***
Dealt to 37c4dd3d 
Dealt to 893fb5b9 
Dealt to b17f5bfe 
Dealt to 28704252 
Dealt to 671b32fd 
Dealt to Hero [5c 2h]
28704252: raises $0.1 to $0.2
671b32fd: raises $0.5 to $0.7
Hero: folds
37c4dd3d: folds
893fb5b9: folds
b17f5bfe: folds
28704252: folds
Uncalled bet ($0.5) returned to 671b32fd
*** SHOWDOWN ***
671b32fd collected $0.53 from pot
*** SUMMARY ***
Total pot $0.55 | Rake $0.02 | Jackpot $0 | Bingo $0 | Fortune $0 | Tax $0
Seat 1: 37c4dd3d (button) folded before Flop (didn't bet)
Seat 2: 893fb5b9 (small blind) folded before Flop
Seat 3: b17f5bfe (big blind) folded before Flop
Seat 4: 28704252 folded before Flop
Seat 5: 671b32fd collected ($0.53)
Seat 6: Hero folded before Flop (didn't bet)


Poker Hand #RC3141725873: Hold'em No Limit ($0.05/$0.1) - 2024/12/12 13:09:47
Table 'RushAndCash22321133' 6-max Seat #1 is the button
Seat 1: dd68a104 ($17.65 in chips)
Seat 2: 77162ce3 ($11.68 in chips)
Seat 3: d7f68c0e ($10.18 in chips)
Seat 4: Hero ($10 in chips)
Seat 5: bc2007a2 ($20.38 in chips)
Seat 6: 22e8274e ($23.67 in chips)
77162ce3: posts small blind $0.05
d7f68c0e: posts big blind $0.1
*** HOLE CARDS ***
Dealt to dd68a104 
Dealt to 77162ce3 
Dealt to d7f68c0e 
Dealt to Hero [Ts 6h]
Dealt to bc2007a2 
Dealt to 22e8274e 
Hero: folds
bc2007a2: folds
22e8274e: folds
dd68a104: folds
77162ce3: folds
Uncalled bet ($0.05) returned to d7f68c0e
*** SHOWDOWN ***
d7f68c0e collected $0.1 from pot
*** SUMMARY ***
Total pot $0.1 | Rake $0 | Jackpot $0 | Bingo $0 | Fortune $0 | Tax $0
Seat 1: dd68a104 (button) folded before Flop (didn't bet)
Seat 2: 77162ce3 (small blind) folded before Flop
Seat 3: d7f68c0e (big blind) collected ($0.1)
Seat 4: Hero folded before Flop (didn't bet)
Seat 5: bc2007a2 folded before Flop (didn't bet)
Seat 6: 22e8274e folded before Flop (didn't bet)


Poker Hand #RC3141725638: Hold'em No Limit ($0.05/$0.1) - 2024/12/12 13:08:51
Table 'RushAndCash22320898' 6-max Seat #1 is the button
Seat 1: 4f76bae1 ($12.11 in chips)
Seat 2: 1e25b5bb ($15.31 in chips)
Seat 3: Hero ($10.15 in chips)
Seat 4: 73df44d1 ($10.53 in chips)
Seat 5: 406f58e4 ($11.29 in chips)
Seat 6: 22e8274e ($23.44 in chips)
1e25b5bb: posts small blind $0.05
Hero: posts big blind $0.1
*** HOLE CARDS ***
Dealt to 4f76bae1 
Dealt to 1e25b5bb 
Dealt to Hero [3c Ac]
Dealt to 73df44d1 
Dealt to 406f58e4 
Dealt to 22e8274e 
73df44d1: folds
406f58e4: folds
22e8274e: raises $0.1 to $0.2
4f76bae1: folds
1e25b5bb: folds
Hero: calls $0.1
*** FLOP *** [2s Qs 8d]
Hero: checks
22e8274e: checks
*** TURN *** [2s Qs 8d] [Td]
Hero: checks
22e8274e: bets $0.23
Hero: folds
Uncalled bet ($0.23) returned to 22e8274e
*** SHOWDOWN ***
22e8274e collected $0.43 from pot
*** SUMMARY ***
Total pot $0.45 | Rake $0.02 | Jackpot $0 | Bingo $0 | Fortune $0 | Tax $0
Board [2s Qs 8d Td]
Seat 1: 4f76bae1 (button) folded before Flop (didn't bet)
Seat 2: 1e25b5bb (small blind) folded before Flop
Seat 3: Hero (big blind) folded on the Turn
Seat 4: 73df44d1 folded before Flop (didn't bet)
Seat 5: 406f58e4 folded before Flop (didn't bet)
Seat 6: 22e8274e won ($0.43)


Poker Hand #RC3141725625: Hold'em No Limit ($0.05/$0.1) - 2024/12/12 13:08:48
Table 'RushAndCash22320885' 6-max Seat #1 is the button
Seat 1: 893fb5b9 ($10 in chips)
Seat 2: c0d18d50 ($5.37 in chips)
Seat 3: f2b49ec ($11.47 in chips)
Seat 4: aa6f9192 ($10 in chips)
Seat 5: Hero ($10.15 in chips)
Seat 6: 1e25b5bb ($15.31 in chips)
c0d18d50: posts small blind $0.05
f2b49ec: posts big blind $0.1
*** HOLE CARDS ***
Dealt to 893fb5b9 
Dealt to c0d18d50 
Dealt to f2b49ec 
Dealt to aa6f9192 
Dealt to Hero [Kh 5c]
Dealt to 1e25b5bb 
aa6f9192: raises $0.12 to $0.22
Hero: folds
1e25b5bb: folds
893fb5b9: folds
c0d18d50: folds
f2b49ec: folds
Uncalled bet ($0.12) returned to aa6f9192
*** SHOWDOWN ***
aa6f9192 collected $0.25 from pot
*** SUMMARY ***
Total pot $0.25 | Rake $0 | Jackpot $0 | Bingo $0 | Fortune $0 | Tax $0
Seat 1: 893fb5b9 (button) folded before Flop (didn't bet)
Seat 2: c0d18d50 (small blind) folded before Flop
Seat 3: f2b49ec (big blind) folded before Flop
Seat 4: aa6f9192 collected ($0.25)
Seat 5: Hero folded before Flop (didn't bet)
Seat 6: 1e25b5bb folded before Flop (didn't bet)


Poker Hand #RC3141725575: Hold'em No Limit ($0.05/$0.1) - 2024/12/12 13:08:36
Table 'RushAndCash22320835' 6-max Seat #1 is the button
Seat 1: b73105eb ($10 in chips)
Seat 2: 1cefc6e8 ($14.3 in chips)
Seat 3: c6786b68 ($11.52 in chips)
Seat 4: 3f1c4e6e ($11.85 in chips)
Seat 5: Hero ($10 in chips)
Seat 6: 264523b9 ($10.74 in chips)
1cefc6e8: posts small blind $0.05
c6786b68: posts big blind $0.1
*** HOLE CARDS ***
Dealt to b73105eb 
Dealt to 1cefc6e8 
Dealt to c6786b68 
Dealt to 3f1c4e6e 
Dealt to Hero [Ks Kc]
Dealt to 264523b9 
3f1c4e6e: folds
Hero: raises $0.1 to $0.2
264523b9: folds
b73105eb: folds
1cefc6e8: folds
c6786b68: folds
Uncalled bet ($0.1) returned to Hero
*** SHOWDOWN ***
Hero collected $0.25 from pot
*** SUMMARY ***
Total pot $0.25 | Rake $0 | Jackpot $0 | Bingo $0 | Fortune $0 | Tax $0
Seat 1: b73105eb (button) folded before Flop (didn't bet)
Seat 2: 1cefc6e8 (small blind) folded before Flop
Seat 3: c6786b68 (big blind) folded before Flop
Seat 4: 3f1c4e6e folded before Flop (didn't bet)
Seat 5: Hero collected ($0.25)
Seat 6: 264523b9 folded before Flop (didn't bet)


Poker Hand #RC3141725559: Hold'em No Limit ($0.05/$0.1) - 2024/12/12 13:08:32
Table 'RushAndCash22320819' 6-max Seat #1 is the button
Seat 1: 1d8dcfab ($32.84 in chips)
Seat 2: afe10f69 ($10.91 in chips)
Seat 3: 48b7cbb7 ($10 in chips)
Seat 4: Hero ($10 in chips)
Seat 5: a6717311 ($10 in chips)
Seat 6: ed5370bd ($10.66 in chips)
afe10f69: posts small blind $0.05
48b7cbb7: posts big blind $0.1
*** HOLE CARDS ***
Dealt to 1d8dcfab 
Dealt to afe10f69 
Dealt to 48b7cbb7 
Dealt to Hero [3c Jc]
Dealt to a6717311 
Dealt to ed5370bd 
Hero: folds
a6717311: folds
ed5370bd: folds
1d8dcfab: folds
afe10f69: raises $0.2 to $0.3
48b7cbb7: folds
Uncalled bet ($0.2) returned to afe10f69
*** SHOWDOWN ***
afe10f69 collected $0.2 from pot
*** SUMMARY ***
Total pot $0.2 | Rake $0 | Jackpot $0 | Bingo $0 | Fortune $0 | Tax $0
Seat 1: 1d8dcfab (button) folded before Flop (didn't bet)
Seat 2: afe10f69 (small blind) collected ($0.2)
Seat 3: 48b7cbb7 (big blind) folded before Flop
Seat 4: Hero folded before Flop (didn't bet)
Seat 5: a6717311 folded before Flop (didn't bet)
Seat 6: ed5370bd folded before Flop (didn't bet)


Poker Hand #RC3141725521: Hold'em No Limit ($0.05/$0.1) - 2024/12/12 13:08:21
Table 'RushAndCash22320781' 6-max Seat #1 is the button
Seat 1: bc6d42d6 ($7.38 in chips)
Seat 2: Hero ($10 in chips)
Seat 3: 5ab2e15d ($10.31 in chips)
Seat 4: d07ab82c ($11.82 in chips)
Seat 5: 4f76bae1 ($12.26 in chips)
Seat 6: b2132e5f ($10 in chips)
Hero: posts small blind $0.05
5ab2e15d: posts big blind $0.1
*** HOLE CARDS ***
Dealt to bc6d42d6 
Dealt to Hero [6h Qh]
Dealt to 5ab2e15d 
Dealt to d07ab82c 
Dealt to 4f76bae1 
Dealt to b2132e5f 
d07ab82c: folds
4f76bae1: folds
b2132e5f: raises $0.15 to $0.25
bc6d42d6: folds
Hero: folds
5ab2e15d: folds
Uncalled bet ($0.15) returned to b2132e5f
*** SHOWDOWN ***
b2132e5f collected $0.25 from pot
*** SUMMARY ***
Total pot $0.25 | Rake $0 | Jackpot $0 | Bingo $0 | Fortune $0 | Tax $0
Seat 1: bc6d42d6 (button) folded before Flop (didn't bet)
Seat 2: Hero (small blind) folded before Flop
Seat 3: 5ab2e15d (big blind) folded before Flop
Seat 4: d07ab82c folded before Flop (didn't bet)
Seat 5: 4f76bae1 folded before Flop (didn't bet)
Seat 6: b2132e5f collected ($0.25)


Poker Hand #RC3141725506: Hold'em No Limit ($0.05/$0.1) - 2024/12/12 13:08:17
Table 'RushAndCash22320766' 6-max Seat #1 is the button
Seat 1: 55e95fce ($10.29 in chips)
Seat 2: d27812f5 ($10.35 in chips)
Seat 3: Hero ($10.07 in chips)
Seat 4: b8e03e64 ($10.14 in chips)
Seat 5: d09451f5 ($13.94 in chips)
Seat 6: 68283690 ($18.41 in chips)
d27812f5: posts small blind $0.05
Hero: posts big blind $0.1
*** HOLE CARDS ***
Dealt to 55e95fce 
Dealt to d27812f5 
Dealt to Hero [Ks 4d]
Dealt to b8e03e64 
Dealt to d09451f5 
Dealt to 68283690 
b8e03e64: folds
d09451f5: raises $0.12 to $0.22
68283690: folds
55e95fce: folds
d27812f5: folds
Hero: folds
Uncalled bet ($0.12) returned to d09451f5
*** SHOWDOWN ***
d09451f5 collected $0.25 from pot
*** SUMMARY ***
Total pot $0.25 | Rake $0 | Jackpot $0 | Bingo $0 | Fortune $0 | Tax $0
Seat 1: 55e95fce (button) folded before Flop (didn't bet)
Seat 2: d27812f5 (small blind) folded before Flop
Seat 3: Hero (big blind) folded before Flop
Seat 4: b8e03e64 folded before Flop (didn't bet)
Seat 5: d09451f5 collected ($0.25)
Seat 6: 68283690 folded before Flop (didn't bet)


Poker Hand #RC3141725488: Hold'em No Limit ($0.05/$0.1) - 2024/12/12 13:08:13
Table 'RushAndCash22320748' 6-max Seat #1 is the button
Seat 1: Hero ($10.07 in chips)
Seat 2: 55e95fce ($10.34 in chips)
Seat 3: 26077f2f ($10.41 in chips)
Seat 4: 77162ce3 ($12.29 in chips)
Seat 5: 2c35e76a ($13.13 in chips)
Seat 6: 8efbf75 ($11.74 in chips)
55e95fce: posts small blind $0.05
26077f2f: posts big blind $0.1
*** HOLE CARDS ***
Dealt to Hero [8d 2d]
Dealt to 55e95fce 
Dealt to 26077f2f 
Dealt to 77162ce3 
Dealt to 2c35e76a 
Dealt to 8efbf75 
77162ce3: raises $0.15 to $0.25
2c35e76a: calls $0.25
8efbf75: folds
Hero: folds
55e95fce: folds
26077f2f: calls $0.15
*** FLOP *** [3s Jd 5s]
26077f2f: checks
77162ce3: checks
2c35e76a: checks
*** TURN *** [3s Jd 5s] [Jc]
26077f2f: checks
77162ce3: checks
2c35e76a: bets $0.26
26077f2f: folds
77162ce3: calls $0.26
*** RIVER *** [3s Jd 5s Jc] [8c]
77162ce3: checks
2c35e76a: checks
77162ce3: shows [Ks Ts] (Pair of Jacks)
2c35e76a: shows [Qd Kh] (Pair of Jacks)
*** SHOWDOWN ***
2c35e76a collected $1.26 from pot
*** SUMMARY ***
Total pot $1.32 | Rake $0.06 | Jackpot $0 | Bingo $0 | Fortune $0 | Tax $0
Board [3s Jd 5s Jc 8c]
Seat 1: Hero (button) folded before Flop (didn't bet)
Seat 2: 55e95fce (small blind) folded before Flop
Seat 3: 26077f2f (big blind) folded on the Turn
Seat 4: 77162ce3 showed [Ks Ts] and lost with Pair of Jacks
Seat 5: 2c35e76a showed [Qd Kh] and won ($1.26) with Pair of Jacks
Seat 6: 8efbf75 folded before Flop (didn't bet)


Poker Hand #RC3141725458: Hold'em No Limit ($0.05/$0.1) - 2024/12/12 13:08:06
Table 'RushAndCash22320718' 6-max Seat #1 is the button
Seat 1: a212e67a ($10.23 in chips)
Seat 2: 639a9874 ($10.23 in chips)
Seat 3: 73e84fa ($27.38 in chips)
Seat 4: 8a55880e ($17.82 in chips)
Seat 5: 1d2be4c9 ($9.65 in chips)
Seat 6: Hero ($10.07 in chips)
639a9874: posts small blind $0.05
73e84fa: posts big blind $0.1
*** HOLE CARDS ***
Dealt to a212e67a 
Dealt to 639a9874 
Dealt to 73e84fa 
Dealt to 8a55880e 
Dealt to 1d2be4c9 
Dealt to Hero [Ks 9c]
8a55880e: folds
1d2be4c9: folds
Hero: folds
a212e67a: folds
639a9874: raises $0.15 to $0.25
73e84fa: raises $0.58 to $0.83
639a9874: calls $0.58
*** FLOP *** [8h 4s 2h]
639a9874: checks
73e84fa: bets $0.54
639a9874: calls $0.54
*** TURN *** [8h 4s 2h] [Td]
639a9874: checks
73e84fa: checks
*** RIVER *** [8h 4s 2h Td] [Ac]
639a9874: checks
73e84fa: bets $1.43
639a9874: calls $1.43
73e84fa: shows [3h As] (Pair of Aces)
639a9874: shows [9s Th] (Pair of Tens)
*** SHOWDOWN ***
73e84fa collected $5.18 from pot
*** SUMMARY ***
Total pot $5.6 | Rake $0.27 | Jackpot $0.15 | Bingo $0 | Fortune $0 | Tax $0
Board [8h 4s 2h Td Ac]
Seat 1: a212e67a (button) folded before Flop (didn't bet)
Seat 2: 639a9874 (small blind) showed [9s Th] and lost with Pair of Tens
Seat 3: 73e84fa (big blind) showed [3h As] and won ($5.18) with Pair of Aces
Seat 4: 8a55880e folded before Flop (didn't bet)
Seat 5: 1d2be4c9 folded before Flop (didn't bet)
Seat 6: Hero folded before Flop (didn't bet)


Poker Hand #RC3141725445: Hold'em No Limit ($0.05/$0.1) - 2024/12/12 13:08:02
Table 'RushAndCash22320705' 6-max Seat #1 is the button
Seat 1: e2a23377 ($10.47 in chips)
Seat 2: caa14983 ($14.46 in chips)
Seat 3: 1dc50d10 ($10.15 in chips)
Seat 4: e896e324 ($10 in chips)
Seat 5: 73e84fa ($27.38 in chips)
Seat 6: Hero ($10.07 in chips)
caa14983: posts small blind $0.05
1dc50d10: posts big blind $0.1
*** HOLE CARDS ***
Dealt to e2a23377 
Dealt to caa14983 
Dealt to 1dc50d10 
Dealt to e896e324 
Dealt to 73e84fa 
Dealt to Hero [Kh 8c]
e896e324: raises $0.1 to $0.2
73e84fa: folds
Hero: folds
e2a23377: raises $0.42 to $0.62
caa14983: calls $0.57
1dc50d10: folds
e896e324: raises $1.88 to $2.5
e2a23377: folds
caa14983: folds
Uncalled bet ($1.88) returned to e896e324
*** SHOWDOWN ***
e896e324 collected $1.87 from pot
*** SUMMARY ***
Total pot $1.96 | Rake $0.09 | Jackpot $0 | Bingo $0 | Fortune $0 | Tax $0
Seat 1: e2a23377 (button) folded before Flop
Seat 2: caa14983 (small blind) folded before Flop
Seat 3: 1dc50d10 (big blind) folded before Flop
Seat 4: e896e324 collected ($1.87)
Seat 5: 73e84fa folded before Flop (didn't bet)
Seat 6: Hero folded before Flop (didn't bet)


Poker Hand #RC3141725429: Hold'em No Limit ($0.05/$0.1) - 2024/12/12 13:07:59
Table 'RushAndCash22320689' 6-max Seat #1 is the button
Seat 1: Hero ($10.07 in chips)
Seat 2: cc8462b1 ($10 in chips)
Seat 3: f879c2d8 ($10.04 in chips)
Seat 4: 95a503e1 ($15.49 in chips)
Seat 5: d07ab82c ($11.72 in chips)
Seat 6: 14311dad ($10 in chips)
cc8462b1: posts small blind $0.05
f879c2d8: posts big blind $0.1
*** HOLE CARDS ***
Dealt to Hero [4d 2d]
Dealt to cc8462b1 
Dealt to f879c2d8 
Dealt to 95a503e1 
Dealt to d07ab82c 
Dealt to 14311dad 
95a503e1: folds
d07ab82c: folds
14311dad: folds
Hero: folds
cc8462b1: raises $0.2 to $0.3
f879c2d8: raises $0.7 to $1
cc8462b1: calls $0.7
*** FLOP *** [Jc 3s 9s]
cc8462b1: checks
f879c2d8: bets $0.66
cc8462b1: calls $0.66
*** TURN *** [Jc 3s 9s] [Kd]
cc8462b1: checks
f879c2d8: bets $1.66
cc8462b1: raises $6.68 to $8.34 and is all-in
f879c2d8: calls $6.68
cc8462b1: shows [Qs Ac] (Ace-High)
f879c2d8: shows [Kc Jh] (Pair of Kings and Pair of Jacks)
*** RIVER *** [Jc 3s 9s Kd] [4c]
*** SHOWDOWN ***
f879c2d8 collected $19.55 from pot
*** SUMMARY ***
Total pot $20 | Rake $0.3 | Jackpot $0.15 | Bingo $0 | Fortune $0 | Tax $0
Board [Jc 3s 9s Kd 4c]
Seat 1: Hero (button) folded before Flop (didn't bet)
Seat 2: cc8462b1 (small blind) showed [Qs Ac] and lost with Ace-High
Seat 3: f879c2d8 (big blind) showed [Kc Jh] and won ($19.55) with Pair of Kings and Pair of Jacks
Seat 4: 95a503e1 folded before Flop (didn't bet)
Seat 5: d07ab82c folded before Flop (didn't bet)
Seat 6: 14311dad folded before Flop (didn't bet)


Poker Hand #RC3141725381: Hold'em No Limit ($0.05/$0.1) - 2024/12/12 13:07:47
Table 'RushAndCash22320641' 6-max Seat #1 is the button
Seat 1: 3b1bb7c0 ($12 in chips)
Seat 2: 2ad815d2 ($6.39 in chips)
Seat 3: b17f5bfe ($8.45 in chips)
Seat 4: 844091a0 ($10.27 in chips)
Seat 5: 1dc50d10 ($10 in chips)
Seat 6: Hero ($10.07 in chips)
2ad815d2: posts small blind $0.05
b17f5bfe: posts big blind $0.1
*** HOLE CARDS ***
Dealt to 3b1bb7c0 
Dealt to 2ad815d2 
Dealt to b17f5bfe 
Dealt to 844091a0 
Dealt to 1dc50d10 
Dealt to Hero [Kc 7c]
844091a0: folds
1dc50d10: raises $0.15 to $0.25
Hero: folds
3b1bb7c0: folds
2ad815d2: folds
b17f5bfe: folds
Uncalled bet ($0.15) returned to 1dc50d10
*** SHOWDOWN ***
1dc50d10 collected $0.25 from pot
*** SUMMARY ***
Total pot $0.25 | Rake $0 | Jackpot $0 | Bingo $0 | Fortune $0 | Tax $0
Seat 1: 3b1bb7c0 (button) folded before Flop (didn't bet)
Seat 2: 2ad815d2 (small blind) folded before Flop
Seat 3: b17f5bfe (big blind) folded before Flop
Seat 4: 844091a0 folded before Flop (didn't bet)
Seat 5: 1dc50d10 collected ($0.25)
Seat 6: Hero folded before Flop (didn't bet)


Poker Hand #RC3141725297: Hold'em No Limit ($0.05/$0.1) - 2024/12/12 13:07:25
Table 'RushAndCash22320557' 6-max Seat #1 is the button
Seat 1: b0bb79df ($10 in chips)
Seat 2: Hero ($10.37 in chips)
Seat 3: 844091a0 ($10 in chips)
Seat 4: 59d8dcea ($10.15 in chips)
Seat 5: b863ea8c ($23.68 in chips)
Seat 6: 4b71434f ($10 in chips)
Hero: posts small blind $0.05
844091a0: posts big blind $0.1
*** HOLE CARDS ***
Dealt to b0bb79df 
Dealt to Hero [Td Ac]
Dealt to 844091a0 
Dealt to 59d8dcea 
Dealt to b863ea8c 
Dealt to 4b71434f 
59d8dcea: folds
b863ea8c: folds
4b71434f: folds
b0bb79df: folds
Hero: raises $0.2 to $0.3
844091a0: raises $0.6 to $0.9
Hero: folds
Uncalled bet ($0.6) returned to 844091a0
*** SHOWDOWN ***
844091a0 collected $0.57 from pot
*** SUMMARY ***
Total pot $0.6 | Rake $0.03 | Jackpot $0 | Bingo $0 | Fortune $0 | Tax $0
Seat 1: b0bb79df (button) folded before Flop (didn't bet)
Seat 2: Hero (small blind) folded before Flop
Seat 3: 844091a0 (big blind) collected ($0.57)
Seat 4: 59d8dcea folded before Flop (didn't bet)
Seat 5: b863ea8c folded before Flop (didn't bet)
Seat 6: 4b71434f folded before Flop (didn't bet)


Poker Hand #RC3141725284: Hold'em No Limit ($0.05/$0.1) - 2024/12/12 13:07:22
Table 'RushAndCash22320544' 6-max Seat #1 is the button
Seat 1: 52c6c741 ($12.64 in chips)
Seat 2: 6a806110 ($10.37 in chips)
Seat 3: c036357d ($13.38 in chips)
Seat 4: b0bb79df ($10 in chips)
Seat 5: Hero ($10.37 in chips)
Seat 6: 1dc34506 ($12.08 in chips)
6a806110: posts small blind $0.05
c036357d: posts big blind $0.1
*** HOLE CARDS ***
Dealt to 52c6c741 
Dealt to 6a806110 
Dealt to c036357d 
Dealt to b0bb79df 
Dealt to Hero [6h 7s]
Dealt to 1dc34506 
b0bb79df: folds
Hero: folds
1dc34506: folds
52c6c741: raises $0.15 to $0.25
6a806110: raises $0.75 to $1
c036357d: folds
52c6c741: folds
Uncalled bet ($0.75) returned to 6a806110
*** SHOWDOWN ***
6a806110 collected $0.57 from pot
*** SUMMARY ***
Total pot $0.6 | Rake $0.03 | Jackpot $0 | Bingo $0 | Fortune $0 | Tax $0
Seat 1: 52c6c741 (button) folded before Flop
Seat 2: 6a806110 (small blind) collected ($0.57)
Seat 3: c036357d (big blind) folded before Flop
Seat 4: b0bb79df folded before Flop (didn't bet)
Seat 5: Hero folded before Flop (didn't bet)
Seat 6: 1dc34506 folded before Flop (didn't bet)


Poker Hand #RC3141725232: Hold'em No Limit ($0.05/$0.1) - 2024/12/12 13:07:09
Table 'RushAndCash22320492' 6-max Seat #1 is the button
Seat 1: 60b2f955 ($10 in chips)
Seat 2: bb835227 ($12.8 in chips)
Seat 3: Hero ($10.47 in chips)
Seat 4: 6c4ba3fb ($17.12 in chips)
Seat 5: 20a8d101 ($38.14 in chips)
Seat 6: 506e90c1 ($10.26 in chips)
bb835227: posts small blind $0.05
Hero: posts big blind $0.1
*** HOLE CARDS ***
Dealt to 60b2f955 
Dealt to bb835227 
Dealt to Hero [Qh 7d]
Dealt to 6c4ba3fb 
Dealt to 20a8d101 
Dealt to 506e90c1 
6c4ba3fb: raises $0.1 to $0.2
20a8d101: folds
506e90c1: folds
60b2f955: folds
bb835227: calls $0.15
Hero: folds
*** FLOP *** [6c 3d Js]
bb835227: checks
6c4ba3fb: bets $0.25
bb835227: calls $0.25
*** TURN *** [6c 3d Js] [9d]
bb835227: checks
6c4ba3fb: checks
*** RIVER *** [6c 3d Js 9d] [5d]
bb835227: checks
6c4ba3fb: bets $0.33
bb835227: folds
Uncalled bet ($0.33) returned to 6c4ba3fb
*** SHOWDOWN ***
6c4ba3fb collected $0.95 from pot
*** SUMMARY ***
Total pot $1 | Rake $0.05 | Jackpot $0 | Bingo $0 | Fortune $0 | Tax $0
Board [6c 3d Js 9d 5d]
Seat 1: 60b2f955 (button) folded before Flop (didn't bet)
Seat 2: bb835227 (small blind) folded on the River
Seat 3: Hero (big blind) folded before Flop
Seat 4: 6c4ba3fb won ($0.95)
Seat 5: 20a8d101 folded before Flop (didn't bet)
Seat 6: 506e90c1 folded before Flop (didn't bet)


Poker Hand #RC3141725218: Hold'em No Limit ($0.05/$0.1) - 2024/12/12 13:07:06
Table 'RushAndCash22320478' 6-max Seat #1 is the button
Seat 1: 1dc34506 ($12.08 in chips)
Seat 2: 86ee8e36 ($29.77 in chips)
Seat 3: 1d8dcfab ($33.54 in chips)
Seat 4: Hero ($10.47 in chips)
Seat 5: dea1301e ($34.54 in chips)
Seat 6: 593f64c7 ($2.42 in chips)
86ee8e36: posts small blind $0.05
1d8dcfab: posts big blind $0.1
*** HOLE CARDS ***
Dealt to 1dc34506 
Dealt to 86ee8e36 
Dealt to 1d8dcfab 
Dealt to Hero [7h 5c]
Dealt to dea1301e 
Dealt to 593f64c7 
Hero: folds
dea1301e: folds
593f64c7: folds
1dc34506: folds
86ee8e36: folds
Uncalled bet ($0.05) returned to 1d8dcfab
*** SHOWDOWN ***
1d8dcfab collected $0.1 from pot
*** SUMMARY ***
Total pot $0.1 | Rake $0 | Jackpot $0 | Bingo $0 | Fortune $0 | Tax $0
Seat 1: 1dc34506 (button) folded before Flop (didn't bet)
Seat 2: 86ee8e36 (small blind) folded before Flop
Seat 3: 1d8dcfab (big blind) collected ($0.1)
Seat 4: Hero folded before Flop (didn't bet)
Seat 5: dea1301e folded before Flop (didn't bet)
Seat 6: 593f64c7 folded before Flop (didn't bet)


Poker Hand #RC3141725171: Hold'em No Limit ($0.05/$0.1) - 2024/12/12 13:06:55
Table 'RushAndCash22320431' 6-max Seat #1 is the button
Seat 1: 295cc1bc ($14.41 in chips)
Seat 2: Hero ($10.52 in chips)
Seat 3: 637471ad ($10.57 in chips)
Seat 4: c036357d ($13.28 in chips)
Seat 5: 481b7ef8 ($29.48 in chips)
Seat 6: 671b32fd ($14.81 in chips)
Hero: posts small blind $0.05
637471ad: posts big blind $0.1
*** HOLE CARDS ***
Dealt to 295cc1bc 
Dealt to Hero [9s Kh]
Dealt to 637471ad 
Dealt to c036357d 
Dealt to 481b7ef8 
Dealt to 671b32fd 
c036357d: raises $0.3 to $0.4
481b7ef8: folds
671b32fd: folds
295cc1bc: folds
Hero: folds
637471ad: folds
Uncalled bet ($0.3) returned to c036357d
*** SHOWDOWN ***
c036357d collected $0.25 from pot
*** SUMMARY ***
Total pot $0.25 | Rake $0 | Jackpot $0 | Bingo $0 | Fortune $0 | Tax $0
Seat 1: 295cc1bc (button) folded before Flop (didn't bet)
Seat 2: Hero (small blind) folded before Flop
Seat 3: 637471ad (big blind) folded before Flop
Seat 4: c036357d collected ($0.25)
Seat 5: 481b7ef8 folded before Flop (didn't bet)
Seat 6: 671b32fd folded before Flop (didn't bet)


Poker Hand #RC3141725153: Hold'em No Limit ($0.05/$0.1) - 2024/12/12 13:06:51
Table 'RushAndCash22320413' 6-max Seat #1 is the button
Seat 1: c036357d ($13.28 in chips)
Seat 2: 26077f2f ($10.58 in chips)
Seat 3: 671b32fd ($14.91 in chips)
Seat 4: 51c5666 ($13.04 in chips)
Seat 5: 8a31e4cb ($9.92 in chips)
Seat 6: Hero ($10.52 in chips)
26077f2f: posts small blind $0.05
671b32fd: posts big blind $0.1
*** HOLE CARDS ***
Dealt to c036357d 
Dealt to 26077f2f 
Dealt to 671b32fd 
Dealt to 51c5666 
Dealt to 8a31e4cb 
Dealt to Hero [9d 6c]
51c5666: folds
8a31e4cb: folds
Hero: folds
c036357d: folds
26077f2f: raises $0.15 to $0.25
671b32fd: folds
Uncalled bet ($0.15) returned to 26077f2f
*** SHOWDOWN ***
26077f2f collected $0.2 from pot
*** SUMMARY ***
Total pot $0.2 | Rake $0 | Jackpot $0 | Bingo $0 | Fortune $0 | Tax $0
Seat 1: c036357d (button) folded before Flop (didn't bet)
Seat 2: 26077f2f (small blind) collected ($0.2)
Seat 3: 671b32fd (big blind) folded before Flop
Seat 4: 51c5666 folded before Flop (didn't bet)
Seat 5: 8a31e4cb folded before Flop (didn't bet)
Seat 6: Hero folded before Flop (didn't bet)


Poker Hand #RC3141725133: Hold'em No Limit ($0.05/$0.1) - 2024/12/12 13:06:47
Table 'RushAndCash22320393' 6-max Seat #1 is the button
Seat 1: 14311dad ($10 in chips)
Seat 2: 84cc5caa ($10.66 in chips)
Seat 3: Hero ($10.62 in chips)
Seat 4: 5c1d4f73 ($10.15 in chips)
Seat 5: f1e9bea0 ($38.66 in chips)
Seat 6: cfe70ef2 ($10.22 in chips)
84cc5caa: posts small blind $0.05
Hero: posts big blind $0.1
*** HOLE CARDS ***
Dealt to 14311dad 
Dealt to 84cc5caa 
Dealt to Hero [5s 9s]
Dealt to 5c1d4f73 
Dealt to f1e9bea0 
Dealt to cfe70ef2 
5c1d4f73: folds
f1e9bea0: folds
cfe70ef2: raises $0.1 to $0.2
14311dad: folds
84cc5caa: folds
Hero: folds
Uncalled bet ($0.1) returned to cfe70ef2
*** SHOWDOWN ***
cfe70ef2 collected $0.25 from pot
*** SUMMARY ***
Total pot $0.25 | Rake $0 | Jackpot $0 | Bingo $0 | Fortune $0 | Tax $0
Seat 1: 14311dad (button) folded before Flop (didn't bet)
Seat 2: 84cc5caa (small blind) folded before Flop
Seat 3: Hero (big blind) folded before Flop
Seat 4: 5c1d4f73 folded before Flop (didn't bet)
Seat 5: f1e9bea0 folded before Flop (didn't bet)
Seat 6: cfe70ef2 collected ($0.25)


Poker Hand #RC3141725118: Hold'em No Limit ($0.05/$0.1) - 2024/12/12 13:06:44
Table 'RushAndCash22320378' 6-max Seat #1 is the button
Seat 1: f4a0e033 ($10 in chips)
Seat 2: 3f1c4e6e ($11.45 in chips)
Seat 3: 47ae29b2 ($10.22 in chips)
Seat 4: 5b982aa5 ($10.51 in chips)
Seat 5: Hero ($10.62 in chips)
Seat 6: f347a136 ($10.09 in chips)
3f1c4e6e: posts small blind $0.05
47ae29b2: posts big blind $0.1
*** HOLE CARDS ***
Dealt to f4a0e033 
Dealt to 3f1c4e6e 
Dealt to 47ae29b2 
Dealt to 5b982aa5 
Dealt to Hero [7d Kc]
Dealt to f347a136 
5b982aa5: raises $0.15 to $0.25
Hero: folds
f347a136: raises $0.55 to $0.8
f4a0e033: folds
3f1c4e6e: folds
47ae29b2: folds
5b982aa5: folds
Uncalled bet ($0.55) returned to f347a136
*** SHOWDOWN ***
f347a136 collected $0.62 from pot
*** SUMMARY ***
Total pot $0.65 | Rake $0.03 | Jackpot $0 | Bingo $0 | Fortune $0 | Tax $0
Seat 1: f4a0e033 (button) folded before Flop (didn't bet)
Seat 2: 3f1c4e6e (small blind) folded before Flop
Seat 3: 47ae29b2 (big blind) folded before Flop
Seat 4: 5b982aa5 folded before Flop
Seat 5: Hero folded before Flop (didn't bet)
Seat 6: f347a136 collected ($0.62)


Poker Hand #RC3141725102: Hold'em No Limit ($0.05/$0.1) - 2024/12/12 13:06:40
Table 'RushAndCash22320362' 6-max Seat #1 is the button
Seat 1: 7f65d70 ($10 in chips)
Seat 2: 6dcb955a ($10 in chips)
Seat 3: 84cc5caa ($10.76 in chips)
Seat 4: af208717 ($10.47 in chips)
Seat 5: 47ae29b2 ($10.22 in chips)
Seat 6: Hero ($10.62 in chips)
6dcb955a: posts small blind $0.05
84cc5caa: posts big blind $0.1
*** HOLE CARDS ***
Dealt to 7f65d70 
Dealt to 6dcb955a 
Dealt to 84cc5caa 
Dealt to af208717 
Dealt to 47ae29b2 
Dealt to Hero [6s 2h]
af208717: folds
47ae29b2: folds
Hero: folds
7f65d70: raises $0.1 to $0.2
6dcb955a: folds
84cc5caa: folds
Uncalled bet ($0.1) returned to 7f65d70
*** SHOWDOWN ***
7f65d70 collected $0.25 from pot
*** SUMMARY ***
Total pot $0.25 | Rake $0 | Jackpot $0 | Bingo $0 | Fortune $0 | Tax $0
Seat 1: 7f65d70 (button) collected ($0.25)
Seat 2: 6dcb955a (small blind) folded before Flop
Seat 3: 84cc5caa (big blind) folded before Flop
Seat 4: af208717 folded before Flop (didn't bet)
Seat 5: 47ae29b2 folded before Flop (didn't bet)
Seat 6: Hero folded before Flop (didn't bet)


Poker Hand #RC3141725087: Hold'em No Limit ($0.05/$0.1) - 2024/12/12 13:06:37
Table 'RushAndCash22320347' 6-max Seat #1 is the button
Seat 1: bb0086cf ($10 in chips)
Seat 2: 7f65d70 ($10.05 in chips)
Seat 3: c4d674fe ($13.64 in chips)
Seat 4: 6dcb955a ($10 in chips)
Seat 5: 3b1bb7c0 ($10.33 in chips)
Seat 6: Hero ($10.62 in chips)
7f65d70: posts small blind $0.05
c4d674fe: posts big blind $0.1
*** HOLE CARDS ***
Dealt to bb0086cf 
Dealt to 7f65d70 
Dealt to c4d674fe 
Dealt to 6dcb955a 
Dealt to 3b1bb7c0 
Dealt to Hero [2d 5h]
6dcb955a: folds
3b1bb7c0: raises $0.12 to $0.22
Hero: folds
bb0086cf: folds
7f65d70: folds
c4d674fe: folds
Uncalled bet ($0.12) returned to 3b1bb7c0
*** SHOWDOWN ***
3b1bb7c0 collected $0.25 from pot
*** SUMMARY ***
Total pot $0.25 | Rake $0 | Jackpot $0 | Bingo $0 | Fortune $0 | Tax $0
Seat 1: bb0086cf (button) folded before Flop (didn't bet)
Seat 2: 7f65d70 (small blind) folded before Flop
Seat 3: c4d674fe (big blind) folded before Flop
Seat 4: 6dcb955a folded before Flop (didn't bet)
Seat 5: 3b1bb7c0 collected ($0.25)
Seat 6: Hero folded before Flop (didn't bet)


Poker Hand #RC3141725075: Hold'em No Limit ($0.05/$0.1) - 2024/12/12 13:06:34
Table 'RushAndCash22320335' 6-max Seat #1 is the button
Seat 1: 228a039d ($13.56 in chips)
Seat 2: Hero ($10.67 in chips)
Seat 3: f9bba8ef ($11.16 in chips)
Seat 4: 727f0a35 ($10.52 in chips)
Seat 5: 1eed6c31 ($8.5 in chips)
Seat 6: f347a136 ($10.09 in chips)
Hero: posts small blind $0.05
f9bba8ef: posts big blind $0.1
*** HOLE CARDS ***
Dealt to 228a039d 
Dealt to Hero [3h 7s]
Dealt to f9bba8ef 
Dealt to 727f0a35 
Dealt to 1eed6c31 
Dealt to f347a136 
727f0a35: folds
1eed6c31: raises $0.1 to $0.2
f347a136: folds
228a039d: folds
Hero: folds
f9bba8ef: folds
Uncalled bet ($0.1) returned to 1eed6c31
*** SHOWDOWN ***
1eed6c31 collected $0.25 from pot
*** SUMMARY ***
Total pot $0.25 | Rake $0 | Jackpot $0 | Bingo $0 | Fortune $0 | Tax $0
Seat 1: 228a039d (button) folded before Flop (didn't bet)
Seat 2: Hero (small blind) folded before Flop
Seat 3: f9bba8ef (big blind) folded before Flop
Seat 4: 727f0a35 folded before Flop (didn't bet)
Seat 5: 1eed6c31 collected ($0.25)
Seat 6: f347a136 folded before Flop (didn't bet)


Poker Hand #RC3141725063: Hold'em No Limit ($0.05/$0.1) - 2024/12/12 13:06:30
Table 'RushAndCash22320323' 6-max Seat #1 is the button
Seat 1: Hero ($10.67 in chips)
Seat 2: 24c2159e ($11.39 in chips)
Seat 3: 88a9583f ($49.16 in chips)
Seat 4: 47ae29b2 ($10.22 in chips)
Seat 5: a9a0489e ($11.59 in chips)
Seat 6: 3b1bb7c0 ($10.33 in chips)
24c2159e: posts small blind $0.05
88a9583f: posts big blind $0.1
*** HOLE CARDS ***
Dealt to Hero [Td 8c]
Dealt to 24c2159e 
Dealt to 88a9583f 
Dealt to 47ae29b2 
Dealt to a9a0489e 
Dealt to 3b1bb7c0 
47ae29b2: folds
a9a0489e: folds
3b1bb7c0: folds
Hero: folds
24c2159e: folds
Uncalled bet ($0.05) returned to 88a9583f
*** SHOWDOWN ***
88a9583f collected $0.1 from pot
*** SUMMARY ***
Total pot $0.1 | Rake $0 | Jackpot $0 | Bingo $0 | Fortune $0 | Tax $0
Seat 1: Hero (button) folded before Flop (didn't bet)
Seat 2: 24c2159e (small blind) folded before Flop
Seat 3: 88a9583f (big blind) collected ($0.1)
Seat 4: 47ae29b2 folded before Flop (didn't bet)
Seat 5: a9a0489e folded before Flop (didn't bet)
Seat 6: 3b1bb7c0 folded before Flop (didn't bet)


Poker Hand #RC3141725018: Hold'em No Limit ($0.05/$0.1) - 2024/12/12 13:06:19
Table 'RushAndCash22320278' 6-max Seat #1 is the button
Seat 1: bc092e13 ($10 in chips)
Seat 2: e3914f0b ($29.2 in chips)
Seat 3: Hero ($10.77 in chips)
Seat 4: ae2a34aa ($10 in chips)
Seat 5: d2714301 ($7.48 in chips)
Seat 6: 36e85ed3 ($12.55 in chips)
e3914f0b: posts small blind $0.05
Hero: posts big blind $0.1
*** HOLE CARDS ***
Dealt to bc092e13 
Dealt to e3914f0b 
Dealt to Hero [Jc Ad]
Dealt to ae2a34aa 
Dealt to d2714301 
Dealt to 36e85ed3 
ae2a34aa: raises $0.1 to $0.2
d2714301: folds
36e85ed3: raises $0.55 to $0.75
bc092e13: folds
e3914f0b: folds
Hero: folds
ae2a34aa: folds
Uncalled bet ($0.55) returned to 36e85ed3
*** SHOWDOWN ***
36e85ed3 collected $0.53 from pot
*** SUMMARY ***
Total pot $0.55 | Rake $0.02 | Jackpot $0 | Bingo $0 | Fortune $0 | Tax $0
Seat 1: bc092e13 (button) folded before Flop (didn't bet)
Seat 2: e3914f0b (small blind) folded before Flop
Seat 3: Hero (big blind) folded before Flop
Seat 4: ae2a34aa folded before Flop
Seat 5: d2714301 folded before Flop (didn't bet)
Seat 6: 36e85ed3 collected ($0.53)


Poker Hand #RC3141725006: Hold'em No Limit ($0.05/$0.1) - 2024/12/12 13:06:16
Table 'RushAndCash22320266' 6-max Seat #1 is the button
Seat 1: Hero ($10.77 in chips)
Seat 2: cc8462b1 ($11.51 in chips)
Seat 3: 1d8dcfab ($33.69 in chips)
Seat 4: 5041f166 ($9.48 in chips)
Seat 5: e3914f0b ($29.2 in chips)
Seat 6: c46a27c1 ($14.73 in chips)
cc8462b1: posts small blind $0.05
1d8dcfab: posts big blind $0.1
*** HOLE CARDS ***
Dealt to Hero [2h 8h]
Dealt to cc8462b1 
Dealt to 1d8dcfab 
Dealt to 5041f166 
Dealt to e3914f0b 
Dealt to c46a27c1 
5041f166: raises $0.1 to $0.2
e3914f0b: folds
c46a27c1: folds
Hero: folds
cc8462b1: folds
1d8dcfab: folds
Uncalled bet ($0.1) returned to 5041f166
*** SHOWDOWN ***
5041f166 collected $0.25 from pot
*** SUMMARY ***
Total pot $0.25 | Rake $0 | Jackpot $0 | Bingo $0 | Fortune $0 | Tax $0
Seat 1: Hero (button) folded before Flop (didn't bet)
Seat 2: cc8462b1 (small blind) folded before Flop
Seat 3: 1d8dcfab (big blind) folded before Flop
Seat 4: 5041f166 collected ($0.25)
Seat 5: e3914f0b folded before Flop (didn't bet)
Seat 6: c46a27c1 folded before Flop (didn't bet)


Poker Hand #RC3141724972: Hold'em No Limit ($0.05/$0.1) - 2024/12/12 13:06:07
Table 'RushAndCash22320232' 6-max Seat #1 is the button
Seat 1: b82279c3 ($24.15 in chips)
Seat 2: 1d8dcfab ($33.74 in chips)
Seat 3: ee992e7e ($24.65 in chips)
Seat 4: d2714301 ($7.33 in chips)
Seat 5: 7bad2adb ($10 in chips)
Seat 6: Hero ($10.77 in chips)
1d8dcfab: posts small blind $0.05
ee992e7e: posts big blind $0.1
*** HOLE CARDS ***
Dealt to b82279c3 
Dealt to 1d8dcfab 
Dealt to ee992e7e 
Dealt to d2714301 
Dealt to 7bad2adb 
Dealt to Hero [Ad 6h]
d2714301: raises $0.1 to $0.2
7bad2adb: folds
Hero: folds
b82279c3: folds
1d8dcfab: folds
ee992e7e: folds
Uncalled bet ($0.1) returned to d2714301
*** SHOWDOWN ***
d2714301 collected $0.25 from pot
*** SUMMARY ***
Total pot $0.25 | Rake $0 | Jackpot $0 | Bingo $0 | Fortune $0 | Tax $0
Seat 1: b82279c3 (button) folded before Flop (didn't bet)
Seat 2: 1d8dcfab (small blind) folded before Flop
Seat 3: ee992e7e (big blind) folded before Flop
Seat 4: d2714301 collected ($0.25)
Seat 5: 7bad2adb folded before Flop (didn't bet)
Seat 6: Hero folded before Flop (didn't bet)


Poker Hand #RC3141724961: Hold'em No Limit ($0.05/$0.1) - 2024/12/12 13:06:03
Table 'RushAndCash22320221' 6-max Seat #1 is the button
Seat 1: e3914f0b ($29.2 in chips)
Seat 2: 794721cd ($10 in chips)
Seat 3: ae47099b ($13.66 in chips)
Seat 4: Hero ($10.77 in chips)
Seat 5: 2c35e76a ($12.85 in chips)
Seat 6: 7b43c302 ($10.15 in chips)
794721cd: posts small blind $0.05
ae47099b: posts big blind $0.1
*** HOLE CARDS ***
Dealt to e3914f0b 
Dealt to 794721cd 
Dealt to ae47099b 
Dealt to Hero [5h Th]
Dealt to 2c35e76a 
Dealt to 7b43c302 
Hero: folds
2c35e76a: raises $0.1 to $0.2
7b43c302: folds
e3914f0b: folds
794721cd: folds
ae47099b: folds
Uncalled bet ($0.1) returned to 2c35e76a
*** SHOWDOWN ***
2c35e76a collected $0.25 from pot
*** SUMMARY ***
Total pot $0.25 | Rake $0 | Jackpot $0 | Bingo $0 | Fortune $0 | Tax $0
Seat 1: e3914f0b (button) folded before Flop (didn't bet)
Seat 2: 794721cd (small blind) folded before Flop
Seat 3: ae47099b (big blind) folded before Flop
Seat 4: Hero folded before Flop (didn't bet)
Seat 5: 2c35e76a collected ($0.25)
Seat 6: 7b43c302 folded before Flop (didn't bet)


Poker Hand #RC3141724947: Hold'em No Limit ($0.05/$0.1) - 2024/12/12 13:06:00
Table 'RushAndCash22320207' 6-max Seat #1 is the button
Seat 1: a9eb45fc ($10 in chips)
Seat 2: 175b201a ($3.95 in chips)
Seat 3: f323cdf3 ($11.09 in chips)
Seat 4: Hero ($10.77 in chips)
Seat 5: 4dd7bc95 ($11.67 in chips)
Seat 6: e2a23377 ($10.15 in chips)
175b201a: posts small blind $0.05
f323cdf3: posts big blind $0.1
*** HOLE CARDS ***
Dealt to a9eb45fc 
Dealt to 175b201a 
Dealt to f323cdf3 
Dealt to Hero [6d 7s]
Dealt to 4dd7bc95 
Dealt to e2a23377 
Hero: folds
4dd7bc95: raises $0.12 to $0.22
e2a23377: folds
a9eb45fc: folds
175b201a: folds
f323cdf3: calls $0.12
*** FLOP *** [2c 2h 8d]
f323cdf3: checks
4dd7bc95: bets $0.17
f323cdf3: calls $0.17
*** TURN *** [2c 2h 8d] [3c]
f323cdf3: checks
4dd7bc95: checks
*** RIVER *** [2c 2h 8d 3c] [9h]
f323cdf3: checks
4dd7bc95: checks
f323cdf3: shows [As 4d] (Pair of Twos)
4dd7bc95: shows [Qs Ac] (Pair of Twos)
*** SHOWDOWN ***
4dd7bc95 collected $0.79 from pot
*** SUMMARY ***
Total pot $0.83 | Rake $0.04 | Jackpot $0 | Bingo $0 | Fortune $0 | Tax $0
Board [2c 2h 8d 3c 9h]
Seat 1: a9eb45fc (button) folded before Flop (didn't bet)
Seat 2: 175b201a (small blind) folded before Flop
Seat 3: f323cdf3 (big blind) showed [As 4d] and lost with Pair of Twos
Seat 4: Hero folded before Flop (didn't bet)
Seat 5: 4dd7bc95 showed [Qs Ac] and won ($0.79) with Pair of Twos
Seat 6: e2a23377 folded before Flop (didn't bet)


Poker Hand #RC3141724932: Hold'em No Limit ($0.05/$0.1) - 2024/12/12 13:05:57
Table 'RushAndCash22320192' 6-max Seat #1 is the button
Seat 1: Hero ($10.77 in chips)
Seat 2: d1122f42 ($11.92 in chips)
Seat 3: c8c2a1e ($10.05 in chips)
Seat 4: a9eb45fc ($10 in chips)
Seat 5: 643f85e7 ($10.83 in chips)
Seat 6: 4dd7bc95 ($11.67 in chips)
d1122f42: posts small blind $0.05
c8c2a1e: posts big blind $0.1
*** HOLE CARDS ***
Dealt to Hero [5s 7d]
Dealt to d1122f42 
Dealt to c8c2a1e 
Dealt to a9eb45fc 
Dealt to 643f85e7 
Dealt to 4dd7bc95 
a9eb45fc: folds
643f85e7: folds
4dd7bc95: folds
Hero: folds
d1122f42: raises $0.18 to $0.28
c8c2a1e: calls $0.18
*** FLOP *** [8h 4h 5c]
d1122f42: checks
c8c2a1e: checks
*** TURN *** [8h 4h 5c] [3h]
d1122f42: checks
c8c2a1e: bets $0.4
d1122f42: folds
Uncalled bet ($0.4) returned to c8c2a1e
*** SHOWDOWN ***
c8c2a1e collected $0.54 from pot
*** SUMMARY ***
Total pot $0.56 | Rake $0.02 | Jackpot $0 | Bingo $0 | Fortune $0 | Tax $0
Board [8h 4h 5c 3h]
Seat 1: Hero (button) folded before Flop (didn't bet)
Seat 2: d1122f42 (small blind) folded on the Turn
Seat 3: c8c2a1e (big blind) won ($0.54)
Seat 4: a9eb45fc folded before Flop (didn't bet)
Seat 5: 643f85e7 folded before Flop (didn't bet)
Seat 6: 4dd7bc95 folded before Flop (didn't bet)


Poker Hand #RC3141724897: Hold'em No Limit ($0.05/$0.1) - 2024/12/12 13:05:48
Table 'RushAndCash22320157' 6-max Seat #1 is the button
Seat 1: 605c108c ($10.61 in chips)
Seat 2: Hero ($10.82 in chips)
Seat 3: a2fc0fa3 ($10 in chips)
Seat 4: 24c2159e ($11.21 in chips)
Seat 5: 47ae29b2 ($10.37 in chips)
Seat 6: 1d2dacdf ($11.34 in chips)
Hero: posts small blind $0.05
a2fc0fa3: posts big blind $0.1
*** HOLE CARDS ***
Dealt to 605c108c 
Dealt to Hero [5d 8s]
Dealt to a2fc0fa3 
Dealt to 24c2159e 
Dealt to 47ae29b2 
Dealt to 1d2dacdf 
24c2159e: folds
47ae29b2: raises $0.1 to $0.2
1d2dacdf: folds
605c108c: folds
Hero: folds
a2fc0fa3: folds
Uncalled bet ($0.1) returned to 47ae29b2
*** SHOWDOWN ***
47ae29b2 collected $0.25 from pot
*** SUMMARY ***
Total pot $0.25 | Rake $0 | Jackpot $0 | Bingo $0 | Fortune $0 | Tax $0
Seat 1: 605c108c (button) folded before Flop (didn't bet)
Seat 2: Hero (small blind) folded before Flop
Seat 3: a2fc0fa3 (big blind) folded before Flop
Seat 4: 24c2159e folded before Flop (didn't bet)
Seat 5: 47ae29b2 collected ($0.25)
Seat 6: 1d2dacdf folded before Flop (didn't bet)


Poker Hand #RC3141724851: Hold'em No Limit ($0.05/$0.1) - 2024/12/12 13:05:36
Table 'RushAndCash22320111' 6-max Seat #1 is the button
Seat 1: d037fd58 ($12.33 in chips)
Seat 2: 4b9faa96 ($10.09 in chips)
Seat 3: Hero ($10.92 in chips)
Seat 4: bacbbd0c ($8.63 in chips)
Seat 5: f1e9bea0 ($38.33 in chips)
Seat 6: 9cfbee05 ($11.05 in chips)
4b9faa96: posts small blind $0.05
Hero: posts big blind $0.1
*** HOLE CARDS ***
Dealt to d037fd58 
Dealt to 4b9faa96 
Dealt to Hero [Qh 9d]
Dealt to bacbbd0c 
Dealt to f1e9bea0 
Dealt to 9cfbee05 
bacbbd0c: folds
f1e9bea0: folds
9cfbee05: raises $0.15 to $0.25
d037fd58: folds
4b9faa96: raises $0.8 to $1.05
Hero: folds
9cfbee05: folds
Uncalled bet ($0.8) returned to 4b9faa96
*** SHOWDOWN ***
4b9faa96 collected $0.57 from pot
*** SUMMARY ***
Total pot $0.6 | Rake $0.03 | Jackpot $0 | Bingo $0 | Fortune $0 | Tax $0
Seat 1: d037fd58 (button) folded before Flop (didn't bet)
Seat 2: 4b9faa96 (small blind) collected ($0.57)
Seat 3: Hero (big blind) folded before Flop
Seat 4: bacbbd0c folded before Flop (didn't bet)
Seat 5: f1e9bea0 folded before Flop (didn't bet)
Seat 6: 9cfbee05 folded before Flop


Poker Hand #RC3141724814: Hold'em No Limit ($0.05/$0.1) - 2024/12/12 13:05:27
Table 'RushAndCash22320074' 6-max Seat #1 is the button
Seat 1: ceedbd4f ($10.19 in chips)
Seat 2: c75bf164 ($9.9 in chips)
Seat 3: 1e0385e8 ($10 in chips)
Seat 4: bf6a4250 ($10.75 in chips)
Seat 5: Hero ($10.92 in chips)
Seat 6: 24af28af ($11.09 in chips)
c75bf164: posts small blind $0.05
1e0385e8: posts big blind $0.1
*** HOLE CARDS ***
Dealt to ceedbd4f 
Dealt to c75bf164 
Dealt to 1e0385e8 
Dealt to bf6a4250 
Dealt to Hero [Kh Tc]
Dealt to 24af28af 
bf6a4250: folds
Hero: folds
24af28af: raises $0.1 to $0.2
ceedbd4f: folds
c75bf164: folds
1e0385e8: folds
Uncalled bet ($0.1) returned to 24af28af
*** SHOWDOWN ***
24af28af collected $0.25 from pot
*** SUMMARY ***
Total pot $0.25 | Rake $0 | Jackpot $0 | Bingo $0 | Fortune $0 | Tax $0
Seat 1: ceedbd4f (button) folded before Flop (didn't bet)
Seat 2: c75bf164 (small blind) folded before Flop
Seat 3: 1e0385e8 (big blind) folded before Flop
Seat 4: bf6a4250 folded before Flop (didn't bet)
Seat 5: Hero folded before Flop (didn't bet)
Seat 6: 24af28af collected ($0.25)


Poker Hand #RC3141724803: Hold'em No Limit ($0.05/$0.1) - 2024/12/12 13:05:23
Table 'RushAndCash22320063' 6-max Seat #1 is the button
Seat 1: 4cf26e8f ($10 in chips)
Seat 2: e896e324 ($10 in chips)
Seat 3: c75bf164 ($7.71 in chips)
Seat 4: aecd8c87 ($11.89 in chips)
Seat 5: Hero ($10.92 in chips)
Seat 6: dea1301e ($34.59 in chips)
e896e324: posts small blind $0.05
c75bf164: posts big blind $0.1
*** HOLE CARDS ***
Dealt to 4cf26e8f 
Dealt to e896e324 
Dealt to c75bf164 
Dealt to aecd8c87 
Dealt to Hero [Th 2d]
Dealt to dea1301e 
aecd8c87: folds
Hero: folds
dea1301e: raises $0.1 to $0.2
4cf26e8f: folds
e896e324: folds
c75bf164: folds
Uncalled bet ($0.1) returned to dea1301e
*** SHOWDOWN ***
dea1301e collected $0.25 from pot
*** SUMMARY ***
Total pot $0.25 | Rake $0 | Jackpot $0 | Bingo $0 | Fortune $0 | Tax $0
Seat 1: 4cf26e8f (button) folded before Flop (didn't bet)
Seat 2: e896e324 (small blind) folded before Flop
Seat 3: c75bf164 (big blind) folded before Flop
Seat 4: aecd8c87 folded before Flop (didn't bet)
Seat 5: Hero folded before Flop (didn't bet)
Seat 6: dea1301e collected ($0.25)


Poker Hand #RC3141724792: Hold'em No Limit ($0.05/$0.1) - 2024/12/12 13:05:20
Table 'RushAndCash22320052' 6-max Seat #1 is the button
Seat 1: 718b4a9 ($13.48 in chips)
Seat 2: 2746c1f0 ($12.66 in chips)
Seat 3: 23d20ac6 ($15.75 in chips)
Seat 4: c75bf164 ($7.71 in chips)
Seat 5: Hero ($10.92 in chips)
Seat 6: 175b201a ($4 in chips)
2746c1f0: posts small blind $0.05
23d20ac6: posts big blind $0.1
*** HOLE CARDS ***
Dealt to 718b4a9 
Dealt to 2746c1f0 
Dealt to 23d20ac6 
Dealt to c75bf164 
Dealt to Hero [5d 4c]
Dealt to 175b201a 
c75bf164: folds
Hero: folds
175b201a: raises $0.1 to $0.2
718b4a9: folds
2746c1f0: raises $0.9 to $1.1
23d20ac6: folds
175b201a: folds
Uncalled bet ($0.9) returned to 2746c1f0
*** SHOWDOWN ***
2746c1f0 collected $0.48 from pot
*** SUMMARY ***
Total pot $0.5 | Rake $0.02 | Jackpot $0 | Bingo $0 | Fortune $0 | Tax $0
Seat 1: 718b4a9 (button) folded before Flop (didn't bet)
Seat 2: 2746c1f0 (small blind) collected ($0.48)
Seat 3: 23d20ac6 (big blind) folded before Flop
Seat 4: c75bf164 folded before Flop (didn't bet)
Seat 5: Hero folded before Flop (didn't bet)
Seat 6: 175b201a folded before Flop


Poker Hand #RC3141724764: Hold'em No Limit ($0.05/$0.1) - 2024/12/12 13:05:12
Table 'RushAndCash22320024' 6-max Seat #1 is the button
Seat 1: 844091a0 ($10.19 in chips)
Seat 2: ae47099b ($13.78 in chips)
Seat 3: 5c1d4f73 ($10.51 in chips)
Seat 4: Hero ($10.77 in chips)
Seat 5: 41ef6e45 ($8.61 in chips)
Seat 6: 59363533 ($7.17 in chips)
ae47099b: posts small blind $0.05
5c1d4f73: posts big blind $0.1
*** HOLE CARDS ***
Dealt to 844091a0 
Dealt to ae47099b 
Dealt to 5c1d4f73 
Dealt to Hero [7c 7d]
Dealt to 41ef6e45 
Dealt to 59363533 
Hero: raises $0.1 to $0.2
41ef6e45: folds
59363533: folds
844091a0: folds
ae47099b: folds
5c1d4f73: folds
Uncalled bet ($0.1) returned to Hero
*** SHOWDOWN ***
Hero collected $0.25 from pot
*** SUMMARY ***
Total pot $0.25 | Rake $0 | Jackpot $0 | Bingo $0 | Fortune $0 | Tax $0
Seat 1: 844091a0 (button) folded before Flop (didn't bet)
Seat 2: ae47099b (small blind) folded before Flop
Seat 3: 5c1d4f73 (big blind) folded before Flop
Seat 4: Hero collected ($0.25)
Seat 5: 41ef6e45 folded before Flop (didn't bet)
Seat 6: 59363533 folded before Flop (didn't bet)


Poker Hand #RC3141724750: Hold'em No Limit ($0.05/$0.1) - 2024/12/12 13:05:08
Table 'RushAndCash22320010' 6-max Seat #1 is the button
Seat 1: 418b0280 ($10.17 in chips)
Seat 2: d037fd58 ($12.48 in chips)
Seat 3: Hero ($10.87 in chips)
Seat 4: d940390d ($19.07 in chips)
Seat 5: 506e90c1 ($10.15 in chips)
Seat 6: 4cf26e8f ($10 in chips)
d037fd58: posts small blind $0.05
Hero: posts big blind $0.1
*** HOLE CARDS ***
Dealt to 418b0280 
Dealt to d037fd58 
Dealt to Hero [9s 3s]
Dealt to d940390d 
Dealt to 506e90c1 
Dealt to 4cf26e8f 
d940390d: folds
506e90c1: raises $0.1 to $0.2
4cf26e8f: folds
418b0280: folds
d037fd58: folds
Hero: folds
Uncalled bet ($0.1) returned to 506e90c1
*** SHOWDOWN ***
506e90c1 collected $0.25 from pot
*** SUMMARY ***
Total pot $0.25 | Rake $0 | Jackpot $0 | Bingo $0 | Fortune $0 | Tax $0
Seat 1: 418b0280 (button) folded before Flop (didn't bet)
Seat 2: d037fd58 (small blind) folded before Flop
Seat 3: Hero (big blind) folded before Flop
Seat 4: d940390d folded before Flop (didn't bet)
Seat 5: 506e90c1 collected ($0.25)
Seat 6: 4cf26e8f folded before Flop (didn't bet)


Poker Hand #RC3141674736: Hold'em No Limit ($0.05/$0.1) - 2024/12/12 13:05:04
Table 'RushAndCash22319996' 6-max Seat #1 is the button
Seat 1: Hero ($10.87 in chips)
Seat 2: b9ea8dd9 ($5.48 in chips)
Seat 3: 1d8dcfab ($35.41 in chips)
Seat 4: 566d8ba0 ($14.13 in chips)
Seat 5: 9ef3daf1 ($16.44 in chips)
Seat 6: 6c4ba3fb ($17.01 in chips)
b9ea8dd9: posts small blind $0.05
1d8dcfab: posts big blind $0.1
*** HOLE CARDS ***
Dealt to Hero [7h 5d]
Dealt to b9ea8dd9 
Dealt to 1d8dcfab 
Dealt to 566d8ba0 
Dealt to 9ef3daf1 
Dealt to 6c4ba3fb 
566d8ba0: raises $0.1 to $0.2
9ef3daf1: raises $0.5 to $0.7
6c4ba3fb: calls $0.7
Hero: folds
b9ea8dd9: folds
1d8dcfab: folds
566d8ba0: calls $0.5
*** FLOP *** [Qd 2h 3d]
566d8ba0: checks
9ef3daf1: bets $0.75
6c4ba3fb: folds
566d8ba0: folds
Uncalled bet ($0.75) returned to 9ef3daf1
*** SHOWDOWN ***
9ef3daf1 collected $2.14 from pot
*** SUMMARY ***
Total pot $2.25 | Rake $0.11 | Jackpot $0 | Bingo $0 | Fortune $0 | Tax $0
Board [Qd 2h 3d]
Seat 1: Hero (button) folded before Flop (didn't bet)
Seat 2: b9ea8dd9 (small blind) folded before Flop
Seat 3: 1d8dcfab (big blind) folded before Flop
Seat 4: 566d8ba0 folded on the Flop
Seat 5: 9ef3daf1 won ($2.14)
Seat 6: 6c4ba3fb folded on the Flop


Poker Hand #RC3141674722: Hold'em No Limit ($0.05/$0.1) - 2024/12/12 13:05:00
Table 'RushAndCash22319982' 6-max Seat #1 is the button
Seat 1: 58f45f04 ($11.32 in chips)
Seat 2: Hero ($10.92 in chips)
Seat 3: 70f16de6 ($10 in chips)
Seat 4: c44f394 ($10.49 in chips)
Seat 5: 718b4a9 ($13.63 in chips)
Seat 6: c7bc4949 ($8.82 in chips)
Hero: posts small blind $0.05
70f16de6: posts big blind $0.1
*** HOLE CARDS ***
Dealt to 58f45f04 
Dealt to Hero [9d 2h]
Dealt to 70f16de6 
Dealt to c44f394 
Dealt to 718b4a9 
Dealt to c7bc4949 
c44f394: folds
718b4a9: folds
c7bc4949: folds
58f45f04: raises $0.1 to $0.2
Hero: folds
70f16de6: calls $0.1
*** FLOP *** [Jd 8c Ad]
70f16de6: checks
58f45f04: checks
*** TURN *** [Jd 8c Ad] [6s]
70f16de6: checks
58f45f04: checks
*** RIVER *** [Jd 8c Ad 6s] [Ac]
70f16de6: checks
58f45f04: checks
70f16de6: shows [Qs Kh] (Pair of Aces)
58f45f04: shows [8s Qh] (Pair of Aces and Pair of Eights)
*** SHOWDOWN ***
58f45f04 collected $0.43 from pot
*** SUMMARY ***
Total pot $0.45 | Rake $0.02 | Jackpot $0 | Bingo $0 | Fortune $0 | Tax $0
Board [Jd 8c Ad 6s Ac]
Seat 1: 58f45f04 (button) showed [8s Qh] and won ($0.43) with Pair of Aces and Pair of Eights
Seat 2: Hero (small blind) folded before Flop
Seat 3: 70f16de6 (big blind) showed [Qs Kh] and lost with Pair of Aces
Seat 4: c44f394 folded before Flop (didn't bet)
Seat 5: 718b4a9 folded before Flop (didn't bet)
Seat 6: c7bc4949 folded before Flop (didn't bet)


Poker Hand #RC3141674710: Hold'em No Limit ($0.05/$0.1) - 2024/12/12 13:04:57
Table 'RushAndCash22319970' 6-max Seat #1 is the button
Seat 1: cf64da1a ($22.31 in chips)
Seat 2: 295cc1bc ($12.6 in chips)
Seat 3: 4d1634eb ($13.73 in chips)
Seat 4: 718b4a9 ($13.63 in chips)
Seat 5: Hero ($10.92 in chips)
Seat 6: 671b32fd ($16.51 in chips)
295cc1bc: posts small blind $0.05
4d1634eb: posts big blind $0.1
*** HOLE CARDS ***
Dealt to cf64da1a 
Dealt to 295cc1bc 
Dealt to 4d1634eb 
Dealt to 718b4a9 
Dealt to Hero [4d 6h]
Dealt to 671b32fd 
718b4a9: folds
Hero: folds
671b32fd: folds
cf64da1a: folds
295cc1bc: folds
Uncalled bet ($0.05) returned to 4d1634eb
*** SHOWDOWN ***
4d1634eb collected $0.1 from pot
*** SUMMARY ***
Total pot $0.1 | Rake $0 | Jackpot $0 | Bingo $0 | Fortune $0 | Tax $0
Seat 1: cf64da1a (button) folded before Flop (didn't bet)
Seat 2: 295cc1bc (small blind) folded before Flop
Seat 3: 4d1634eb (big blind) collected ($0.1)
Seat 4: 718b4a9 folded before Flop (didn't bet)
Seat 5: Hero folded before Flop (didn't bet)
Seat 6: 671b32fd folded before Flop (didn't bet)


Poker Hand #RC3141674663: Hold'em No Limit ($0.05/$0.1) - 2024/12/12 13:04:42
Table 'RushAndCash22319923' 6-max Seat #1 is the button
Seat 1: c6352e1c ($10 in chips)
Seat 2: Hero ($10.82 in chips)
Seat 3: 8efbf75 ($9.95 in chips)
Seat 4: d07ab82c ($12.44 in chips)
Seat 5: 84cc5caa ($10.79 in chips)
Seat 6: 8a31e4cb ($10.64 in chips)
Hero: posts small blind $0.05
8efbf75: posts big blind $0.1
*** HOLE CARDS ***
Dealt to c6352e1c 
Dealt to Hero [4h Ah]
Dealt to 8efbf75 
Dealt to d07ab82c 
Dealt to 84cc5caa 
Dealt to 8a31e4cb 
d07ab82c: folds
84cc5caa: folds
8a31e4cb: folds
c6352e1c: folds
Hero: raises $0.2 to $0.3
8efbf75: folds
Uncalled bet ($0.2) returned to Hero
*** SHOWDOWN ***
Hero collected $0.2 from pot
*** SUMMARY ***
Total pot $0.2 | Rake $0 | Jackpot $0 | Bingo $0 | Fortune $0 | Tax $0
Seat 1: c6352e1c (button) folded before Flop (didn't bet)
Seat 2: Hero (small blind) collected ($0.2)
Seat 3: 8efbf75 (big blind) folded before Flop
Seat 4: d07ab82c folded before Flop (didn't bet)
Seat 5: 84cc5caa folded before Flop (didn't bet)
Seat 6: 8a31e4cb folded before Flop (didn't bet)


Poker Hand #RC3141674640: Hold'em No Limit ($0.05/$0.1) - 2024/12/12 13:04:35
Table 'RushAndCash22319900' 6-max Seat #1 is the button
Seat 1: Hero ($10.82 in chips)
Seat 2: a730cdce ($10.41 in chips)
Seat 3: cacc74b2 ($11.06 in chips)
Seat 4: e12528c0 ($30.89 in chips)
Seat 5: 3b12e634 ($12.64 in chips)
Seat 6: 77907fc4 ($16.73 in chips)
a730cdce: posts small blind $0.05
cacc74b2: posts big blind $0.1
*** HOLE CARDS ***
Dealt to Hero [4d 6d]
Dealt to a730cdce 
Dealt to cacc74b2 
Dealt to e12528c0 
Dealt to 3b12e634 
Dealt to 77907fc4 
e12528c0: folds
3b12e634: folds
77907fc4: folds
Hero: folds
a730cdce: raises $0.2 to $0.3
cacc74b2: calls $0.2
*** FLOP *** [2c Ts Ah]
a730cdce: checks
cacc74b2: checks
*** TURN *** [2c Ts Ah] [3h]
a730cdce: checks
cacc74b2: checks
*** RIVER *** [2c Ts Ah 3h] [7d]
a730cdce: checks
cacc74b2: checks
a730cdce: shows [Qh Td] (Pair of Tens)
cacc74b2: shows [Kd 9c] (Ace-High)
*** SHOWDOWN ***
a730cdce collected $0.57 from pot
*** SUMMARY ***
Total pot $0.6 | Rake $0.03 | Jackpot $0 | Bingo $0 | Fortune $0 | Tax $0
Board [2c Ts Ah 3h 7d]
Seat 1: Hero (button) folded before Flop (didn't bet)
Seat 2: a730cdce (small blind) showed [Qh Td] and won ($0.57) with Pair of Tens
Seat 3: cacc74b2 (big blind) showed [Kd 9c] and lost with Ace-High
Seat 4: e12528c0 folded before Flop (didn't bet)
Seat 5: 3b12e634 folded before Flop (didn't bet)
Seat 6: 77907fc4 folded before Flop (didn't bet)


Poker Hand #RC3141674628: Hold'em No Limit ($0.05/$0.1) - 2024/12/12 13:04:32
Table 'RushAndCash22319888' 6-max Seat #1 is the button
Seat 1: 481b7ef8 ($30.21 in chips)
Seat 2: 6b0057b1 ($10.47 in chips)
Seat 3: 6731d495 ($10 in chips)
Seat 4: 54a8e111 ($12.7 in chips)
Seat 5: Hero ($10.82 in chips)
Seat 6: d4deed2f ($11.3 in chips)
6b0057b1: posts small blind $0.05
6731d495: posts big blind $0.1
*** HOLE CARDS ***
Dealt to 481b7ef8 
Dealt to 6b0057b1 
Dealt to 6731d495 
Dealt to 54a8e111 
Dealt to Hero [4d 3h]
Dealt to d4deed2f 
54a8e111: raises $0.1 to $0.2
Hero: folds
d4deed2f: folds
481b7ef8: calls $0.2
6b0057b1: folds
6731d495: folds
*** FLOP *** [5d 3d 4h]
54a8e111: bets $0.28
481b7ef8: calls $0.28
*** TURN *** [5d 3d 4h] [Th]
54a8e111: bets $0.56
481b7ef8: folds
Uncalled bet ($0.56) returned to 54a8e111
*** SHOWDOWN ***
54a8e111 collected $1.06 from pot
*** SUMMARY ***
Total pot $1.11 | Rake $0.05 | Jackpot $0 | Bingo $0 | Fortune $0 | Tax $0
Board [5d 3d 4h Th]
Seat 1: 481b7ef8 (button) folded on the Turn
Seat 2: 6b0057b1 (small blind) folded before Flop
Seat 3: 6731d495 (big blind) folded before Flop
Seat 4: 54a8e111 won ($1.06)
Seat 5: Hero folded before Flop (didn't bet)
Seat 6: d4deed2f folded before Flop (didn't bet)


Poker Hand #RC3141674588: Hold'em No Limit ($0.05/$0.1) - 2024/12/12 13:04:22
Table 'RushAndCash22319848' 6-max Seat #1 is the button
Seat 1: ae47099b ($15.18 in chips)
Seat 2: d6b17ac7 ($16.13 in chips)
Seat 3: Hero ($10.77 in chips)
Seat 4: 893fb5b9 ($10.87 in chips)
Seat 5: e4fc8b12 ($14.88 in chips)
Seat 6: 605c108c ($9.85 in chips)
d6b17ac7: posts small blind $0.05
Hero: posts big blind $0.1
*** HOLE CARDS ***
Dealt to ae47099b 
Dealt to d6b17ac7 
Dealt to Hero [Ah As]
Dealt to 893fb5b9 
Dealt to e4fc8b12 
Dealt to 605c108c 
893fb5b9: folds
e4fc8b12: folds
605c108c: folds
ae47099b: folds
d6b17ac7: folds
Uncalled bet ($0.05) returned to Hero
*** SHOWDOWN ***
Hero collected $0.1 from pot
*** SUMMARY ***
Total pot $0.1 | Rake $0 | Jackpot $0 | Bingo $0 | Fortune $0 | Tax $0
Seat 1: ae47099b (button) folded before Flop (didn't bet)
Seat 2: d6b17ac7 (small blind) folded before Flop
Seat 3: Hero (big blind) collected ($0.1)
Seat 4: 893fb5b9 folded before Flop (didn't bet)
Seat 5: e4fc8b12 folded before Flop (didn't bet)
Seat 6: 605c108c folded before Flop (didn't bet)


Poker Hand #RC3141674575: Hold'em No Limit ($0.05/$0.1) - 2024/12/12 13:04:19
Table 'RushAndCash22319835' 6-max Seat #1 is the button
Seat 1: 264523b9 ($9.83 in chips)
Seat 2: 6904b57e ($16.87 in chips)
Seat 3: ceedbd4f ($10 in chips)
Seat 4: Hero ($10.77 in chips)
Seat 5: 14311dad ($10 in chips)
Seat 6: ae47099b ($15.18 in chips)
6904b57e: posts small blind $0.05
ceedbd4f: posts big blind $0.1
*** HOLE CARDS ***
Dealt to 264523b9 
Dealt to 6904b57e 
Dealt to ceedbd4f 
Dealt to Hero [Qd 5h]
Dealt to 14311dad 
Dealt to ae47099b 
Hero: folds
14311dad: raises $0.1 to $0.2
ae47099b: folds
264523b9: folds
6904b57e: folds
ceedbd4f: folds
Uncalled bet ($0.1) returned to 14311dad
*** SHOWDOWN ***
14311dad collected $0.25 from pot
*** SUMMARY ***
Total pot $0.25 | Rake $0 | Jackpot $0 | Bingo $0 | Fortune $0 | Tax $0
Seat 1: 264523b9 (button) folded before Flop (didn't bet)
Seat 2: 6904b57e (small blind) folded before Flop
Seat 3: ceedbd4f (big blind) folded before Flop
Seat 4: Hero folded before Flop (didn't bet)
Seat 5: 14311dad collected ($0.25)
Seat 6: ae47099b folded before Flop (didn't bet)


Poker Hand #RC3141674474: Hold'em No Limit ($0.05/$0.1) - 2024/12/12 13:03:57
Table 'RushAndCash22319734' 6-max Seat #1 is the button
Seat 1: Hero ($10.43 in chips)
Seat 2: 5b32d7fc ($14.38 in chips)
Seat 3: 6904b57e ($16.97 in chips)
Seat 4: cfe70ef2 ($10 in chips)
Seat 5: 5ab2e15d ($11.91 in chips)
Seat 6: 264523b9 ($10.04 in chips)
5b32d7fc: posts small blind $0.05
6904b57e: posts big blind $0.1
*** HOLE CARDS ***
Dealt to Hero [8c 8d]
Dealt to 5b32d7fc 
Dealt to 6904b57e 
Dealt to cfe70ef2 
Dealt to 5ab2e15d 
Dealt to 264523b9 
cfe70ef2: folds
5ab2e15d: folds
264523b9: raises $0.11 to $0.21
Hero: raises $0.49 to $0.7
5b32d7fc: folds
6904b57e: folds
264523b9: folds
Uncalled bet ($0.49) returned to Hero
*** SHOWDOWN ***
Hero collected $0.55 from pot
*** SUMMARY ***
Total pot $0.57 | Rake $0.02 | Jackpot $0 | Bingo $0 | Fortune $0 | Tax $0
Seat 1: Hero (button) collected ($0.55)
Seat 2: 5b32d7fc (small blind) folded before Flop
Seat 3: 6904b57e (big blind) folded before Flop
Seat 4: cfe70ef2 folded before Flop (didn't bet)
Seat 5: 5ab2e15d folded before Flop (didn't bet)
Seat 6: 264523b9 folded before Flop


Poker Hand #RC3141674337: Hold'em No Limit ($0.05/$0.1) - 2024/12/12 13:03:22
Table 'RushAndCash22319597' 6-max Seat #1 is the button
Seat 1: 5b32d7fc ($14.58 in chips)
Seat 2: Hero ($10.15 in chips)
Seat 3: cc8462b1 ($11.64 in chips)
Seat 4: b8e03e64 ($14.63 in chips)
Seat 5: 264523b9 ($10.09 in chips)
Seat 6: f347a136 ($11.6 in chips)
Hero: posts small blind $0.05
cc8462b1: posts big blind $0.1
*** HOLE CARDS ***
Dealt to 5b32d7fc 
Dealt to Hero [Js Ks]
Dealt to cc8462b1 
Dealt to b8e03e64 
Dealt to 264523b9 
Dealt to f347a136 
b8e03e64: folds
264523b9: folds
f347a136: folds
5b32d7fc: raises $0.1 to $0.2
Hero: raises $0.8 to $1
cc8462b1: folds
5b32d7fc: folds
Uncalled bet ($0.8) returned to Hero
*** SHOWDOWN ***
Hero collected $0.48 from pot
*** SUMMARY ***
Total pot $0.5 | Rake $0.02 | Jackpot $0 | Bingo $0 | Fortune $0 | Tax $0
Seat 1: 5b32d7fc (button) folded before Flop
Seat 2: Hero (small blind) collected ($0.48)
Seat 3: cc8462b1 (big blind) folded before Flop
Seat 4: b8e03e64 folded before Flop (didn't bet)
Seat 5: 264523b9 folded before Flop (didn't bet)
Seat 6: f347a136 folded before Flop (didn't bet)


Poker Hand #RC3141674295: Hold'em No Limit ($0.05/$0.1) - 2024/12/12 13:03:11
Table 'RushAndCash22319555' 6-max Seat #1 is the button
Seat 1: c6352e1c ($10.25 in chips)
Seat 2: b863ea8c ($21.98 in chips)
Seat 3: e4fc8b12 ($15.03 in chips)
Seat 4: Hero ($10 in chips)
Seat 5: 2ff0a04b ($46.97 in chips)
Seat 6: 97a1e12e ($21.88 in chips)
b863ea8c: posts small blind $0.05
e4fc8b12: posts big blind $0.1
*** HOLE CARDS ***
Dealt to c6352e1c 
Dealt to b863ea8c 
Dealt to e4fc8b12 
Dealt to Hero [As Qs]
Dealt to 2ff0a04b 
Dealt to 97a1e12e 
Hero: raises $0.1 to $0.2
2ff0a04b: folds
97a1e12e: folds
c6352e1c: folds
b863ea8c: folds
e4fc8b12: folds
Uncalled bet ($0.1) returned to Hero
*** SHOWDOWN ***
Hero collected $0.25 from pot
*** SUMMARY ***
Total pot $0.25 | Rake $0 | Jackpot $0 | Bingo $0 | Fortune $0 | Tax $0
Seat 1: c6352e1c (button) folded before Flop (didn't bet)
Seat 2: b863ea8c (small blind) folded before Flop
Seat 3: e4fc8b12 (big blind) folded before Flop
Seat 4: Hero collected ($0.25)
Seat 5: 2ff0a04b folded before Flop (didn't bet)
Seat 6: 97a1e12e folded before Flop (didn't bet)


Poker Hand #RC3141674144: Hold'em No Limit ($0.05/$0.1) - 2024/12/12 13:02:32
Table 'RushAndCash22319404' 6-max Seat #1 is the button
Seat 1: b863ea8c ($21.75 in chips)
Seat 2: c5141ec9 ($11.78 in chips)
Seat 3: Hero ($10 in chips)
Seat 4: e3914f0b ($27.4 in chips)
Seat 5: f564c212 ($10.11 in chips)
Seat 6: dcaacb33 ($3.5 in chips)
c5141ec9: posts small blind $0.05
Hero: posts big blind $0.1
*** HOLE CARDS ***
Dealt to b863ea8c 
Dealt to c5141ec9 
Dealt to Hero [8d 7d]
Dealt to e3914f0b 
Dealt to f564c212 
Dealt to dcaacb33 
e3914f0b: folds
f564c212: folds
dcaacb33: folds
b863ea8c: raises $0.1 to $0.2
c5141ec9: folds
Hero: calls $0.1
*** FLOP *** [5c Qd 3h]
Hero: checks
b863ea8c: bets $0.2
Hero: folds
Uncalled bet ($0.2) returned to b863ea8c
*** SHOWDOWN ***
b863ea8c collected $0.43 from pot
*** SUMMARY ***
Total pot $0.45 | Rake $0.02 | Jackpot $0 | Bingo $0 | Fortune $0 | Tax $0
Board [5c Qd 3h]
Seat 1: b863ea8c (button) won ($0.43)
Seat 2: c5141ec9 (small blind) folded before Flop
Seat 3: Hero (big blind) folded on the Flop
Seat 4: e3914f0b folded before Flop (didn't bet)
Seat 5: f564c212 folded before Flop (didn't bet)
Seat 6: dcaacb33 folded before Flop (didn't bet)


Poker Hand #RC3141674092: Hold'em No Limit ($0.05/$0.1) - 2024/12/12 13:02:21
Table 'RushAndCash22319352' 6-max Seat #1 is the button
Seat 1: 60b2f955 ($10 in chips)
Seat 2: 902b9d1a ($7.28 in chips)
Seat 3: 844091a0 ($10 in chips)
Seat 4: Hero ($10 in chips)
Seat 5: 6b0057b1 ($10.29 in chips)
Seat 6: 1d2dacdf ($10.38 in chips)
902b9d1a: posts small blind $0.05
844091a0: posts big blind $0.1
*** HOLE CARDS ***
Dealt to 60b2f955 
Dealt to 902b9d1a 
Dealt to 844091a0 
Dealt to Hero [7c 9c]
Dealt to 6b0057b1 
Dealt to 1d2dacdf 
Hero: folds
6b0057b1: folds
1d2dacdf: folds
60b2f955: folds
902b9d1a: raises $0.2 to $0.3
844091a0: folds
Uncalled bet ($0.2) returned to 902b9d1a
*** SHOWDOWN ***
902b9d1a collected $0.2 from pot
*** SUMMARY ***
Total pot $0.2 | Rake $0 | Jackpot $0 | Bingo $0 | Fortune $0 | Tax $0
Seat 1: 60b2f955 (button) folded before Flop (didn't bet)
Seat 2: 902b9d1a (small blind) collected ($0.2)
Seat 3: 844091a0 (big blind) folded before Flop
Seat 4: Hero folded before Flop (didn't bet)
Seat 5: 6b0057b1 folded before Flop (didn't bet)
Seat 6: 1d2dacdf folded before Flop (didn't bet)


Poker Hand #RC3141674076: Hold'em No Limit ($0.05/$0.1) - 2024/12/12 13:02:17
Table 'RushAndCash22319336' 6-max Seat #1 is the button
Seat 1: 1d8dcfab ($40.68 in chips)
Seat 2: ae47099b ($15.99 in chips)
Seat 3: 4d3004b8 ($17.9 in chips)
Seat 4: d9ccf407 ($10.4 in chips)
Seat 5: 1d2dacdf ($10.38 in chips)
Seat 6: Hero ($10 in chips)
ae47099b: posts small blind $0.05
4d3004b8: posts big blind $0.1
*** HOLE CARDS ***
Dealt to 1d8dcfab 
Dealt to ae47099b 
Dealt to 4d3004b8 
Dealt to d9ccf407 
Dealt to 1d2dacdf 
Dealt to Hero [2d 5c]
d9ccf407: folds
1d2dacdf: folds
Hero: folds
1d8dcfab: raises $0.1 to $0.2
ae47099b: folds
4d3004b8: calls $0.1
*** FLOP *** [Th 3c 9s]
4d3004b8: checks
1d8dcfab: checks
*** TURN *** [Th 3c 9s] [Tc]
4d3004b8: checks
1d8dcfab: checks
*** RIVER *** [Th 3c 9s Tc] [Ts]
4d3004b8: bets $0.34
1d8dcfab: calls $0.34
4d3004b8: shows [2c 2s] (Tens Full over Twos)
1d8dcfab: shows [Jd As] (Three Tens)
*** SHOWDOWN ***
4d3004b8 collected $1.08 from pot
*** SUMMARY ***
Total pot $1.13 | Rake $0.05 | Jackpot $0 | Bingo $0 | Fortune $0 | Tax $0
Board [Th 3c 9s Tc Ts]
Seat 1: 1d8dcfab (button) showed [Jd As] and lost with Three Tens
Seat 2: ae47099b (small blind) folded before Flop
Seat 3: 4d3004b8 (big blind) showed [2c 2s] and won ($1.08) with Tens Full over Twos
Seat 4: d9ccf407 folded before Flop (didn't bet)
Seat 5: 1d2dacdf folded before Flop (didn't bet)
Seat 6: Hero folded before Flop (didn't bet)


Poker Hand #RC3141674063: Hold'em No Limit ($0.05/$0.1) - 2024/12/12 13:02:14
Table 'RushAndCash22319323' 6-max Seat #1 is the button
Seat 1: b9463896 ($13.01 in chips)
Seat 2: e2a23377 ($10.22 in chips)
Seat 3: 8cfa2620 ($24.78 in chips)
Seat 4: 1d2dacdf ($10.38 in chips)
Seat 5: e12528c0 ($31.68 in chips)
Seat 6: Hero ($10 in chips)
e2a23377: posts small blind $0.05
8cfa2620: posts big blind $0.1
*** HOLE CARDS ***
Dealt to b9463896 
Dealt to e2a23377 
Dealt to 8cfa2620 
Dealt to 1d2dacdf 
Dealt to e12528c0 
Dealt to Hero [Tc 5c]
1d2dacdf: folds
e12528c0: raises $0.1 to $0.2
Hero: folds
b9463896: folds
e2a23377: folds
8cfa2620: folds
Uncalled bet ($0.1) returned to e12528c0
*** SHOWDOWN ***
e12528c0 collected $0.25 from pot
*** SUMMARY ***
Total pot $0.25 | Rake $0 | Jackpot $0 | Bingo $0 | Fortune $0 | Tax $0
Seat 1: b9463896 (button) folded before Flop (didn't bet)
Seat 2: e2a23377 (small blind) folded before Flop
Seat 3: 8cfa2620 (big blind) folded before Flop
Seat 4: 1d2dacdf folded before Flop (didn't bet)
Seat 5: e12528c0 collected ($0.25)
Seat 6: Hero folded before Flop (didn't bet)


Poker Hand #RC3141674036: Hold'em No Limit ($0.05/$0.1) - 2024/12/12 13:02:08
Table 'RushAndCash22319296' 6-max Seat #1 is the button
Seat 1: 15f3779a ($18.8 in chips)
Seat 2: Hero ($10.05 in chips)
Seat 3: cb8dca6d ($10 in chips)
Seat 4: 78854bfa ($10.59 in chips)
Seat 5: 6b0057b1 ($10.29 in chips)
Seat 6: c5b1fa72 ($11.16 in chips)
Hero: posts small blind $0.05
cb8dca6d: posts big blind $0.1
*** HOLE CARDS ***
Dealt to 15f3779a 
Dealt to Hero [Jc 8s]
Dealt to cb8dca6d 
Dealt to 78854bfa 
Dealt to 6b0057b1 
Dealt to c5b1fa72 
78854bfa: folds
6b0057b1: folds
c5b1fa72: raises $0.1 to $0.2
15f3779a: folds
Hero: folds
cb8dca6d: calls $0.1
*** FLOP *** [Jd 9h 4c]
cb8dca6d: checks
c5b1fa72: bets $0.23
cb8dca6d: folds
Uncalled bet ($0.23) returned to c5b1fa72
*** SHOWDOWN ***
c5b1fa72 collected $0.43 from pot
*** SUMMARY ***
Total pot $0.45 | Rake $0.02 | Jackpot $0 | Bingo $0 | Fortune $0 | Tax $0
Board [Jd 9h 4c]
Seat 1: 15f3779a (button) folded before Flop (didn't bet)
Seat 2: Hero (small blind) folded before Flop
Seat 3: cb8dca6d (big blind) folded on the Flop
Seat 4: 78854bfa folded before Flop (didn't bet)
Seat 5: 6b0057b1 folded before Flop (didn't bet)
Seat 6: c5b1fa72 won ($0.43)


Poker Hand #RC3141674020: Hold'em No Limit ($0.05/$0.1) - 2024/12/12 13:02:04
Table 'RushAndCash22319280' 6-max Seat #1 is the button
Seat 1: d037fd58 ($12.2 in chips)
Seat 2: 3f5e12f8 ($10.37 in chips)
Seat 3: 4f76bae1 ($10.46 in chips)
Seat 4: Hero ($10.05 in chips)
Seat 5: 4d3004b8 ($18.1 in chips)
Seat 6: f323cdf3 ($11.21 in chips)
3f5e12f8: posts small blind $0.05
4f76bae1: posts big blind $0.1
*** HOLE CARDS ***
Dealt to d037fd58 
Dealt to 3f5e12f8 
Dealt to 4f76bae1 
Dealt to Hero [6c Qc]
Dealt to 4d3004b8 
Dealt to f323cdf3 
Hero: folds
4d3004b8: raises $0.1 to $0.2
f323cdf3: raises $0.45 to $0.65
d037fd58: folds
3f5e12f8: folds
4f76bae1: folds
4d3004b8: folds
Uncalled bet ($0.45) returned to f323cdf3
*** SHOWDOWN ***
f323cdf3 collected $0.53 from pot
*** SUMMARY ***
Total pot $0.55 | Rake $0.02 | Jackpot $0 | Bingo $0 | Fortune $0 | Tax $0
Seat 1: d037fd58 (button) folded before Flop (didn't bet)
Seat 2: 3f5e12f8 (small blind) folded before Flop
Seat 3: 4f76bae1 (big blind) folded before Flop
Seat 4: Hero folded before Flop (didn't bet)
Seat 5: 4d3004b8 folded before Flop
Seat 6: f323cdf3 collected ($0.53)


Poker Hand #RC3141673974: Hold'em No Limit ($0.05/$0.1) - 2024/12/12 13:01:52
Table 'RushAndCash22319234' 6-max Seat #1 is the button
Seat 1: 1d8dcfab ($40.73 in chips)
Seat 2: f2b49ec ($11.49 in chips)
Seat 3: Hero ($10 in chips)
Seat 4: 9b962a1c ($10.53 in chips)
Seat 5: 11a00985 ($21.68 in chips)
Seat 6: cb6a7240 ($11.23 in chips)
f2b49ec: posts small blind $0.05
Hero: posts big blind $0.1
*** HOLE CARDS ***
Dealt to 1d8dcfab 
Dealt to f2b49ec 
Dealt to Hero [4c 3d]
Dealt to 9b962a1c 
Dealt to 11a00985 
Dealt to cb6a7240 
9b962a1c: folds
11a00985: folds
cb6a7240: folds
1d8dcfab: folds
f2b49ec: folds
Uncalled bet ($0.05) returned to Hero
*** SHOWDOWN ***
Hero collected $0.1 from pot
*** SUMMARY ***
Total pot $0.1 | Rake $0 | Jackpot $0 | Bingo $0 | Fortune $0 | Tax $0
Seat 1: 1d8dcfab (button) folded before Flop (didn't bet)
Seat 2: f2b49ec (small blind) folded before Flop
Seat 3: Hero (big blind) collected ($0.1)
Seat 4: 9b962a1c folded before Flop (didn't bet)
Seat 5: 11a00985 folded before Flop (didn't bet)
Seat 6: cb6a7240 folded before Flop (didn't bet)


Poker Hand #RC3141673960: Hold'em No Limit ($0.05/$0.1) - 2024/12/12 13:01:49
Table 'RushAndCash22319220' 6-max Seat #1 is the button
Seat 1: Hero ($10 in chips)
Seat 2: 4740c06b ($17.06 in chips)
Seat 3: e2a23377 ($10.42 in chips)
Seat 4: ed5538ab ($10 in chips)
Seat 5: cb6a7240 ($11.23 in chips)
Seat 6: b4bc8071 ($11.61 in chips)
4740c06b: posts small blind $0.05
e2a23377: posts big blind $0.1
*** HOLE CARDS ***
Dealt to Hero [3h 9c]
Dealt to 4740c06b 
Dealt to e2a23377 
Dealt to ed5538ab 
Dealt to cb6a7240 
Dealt to b4bc8071 
ed5538ab: raises $0.1 to $0.2
cb6a7240: folds
b4bc8071: folds
Hero: folds
4740c06b: folds
e2a23377: folds
Uncalled bet ($0.1) returned to ed5538ab
*** SHOWDOWN ***
ed5538ab collected $0.25 from pot
*** SUMMARY ***
Total pot $0.25 | Rake $0 | Jackpot $0 | Bingo $0 | Fortune $0 | Tax $0
Seat 1: Hero (button) folded before Flop (didn't bet)
Seat 2: 4740c06b (small blind) folded before Flop
Seat 3: e2a23377 (big blind) folded before Flop
Seat 4: ed5538ab collected ($0.25)
Seat 5: cb6a7240 folded before Flop (didn't bet)
Seat 6: b4bc8071 folded before Flop (didn't bet)


Poker Hand #RC3141673948: Hold'em No Limit ($0.05/$0.1) - 2024/12/12 13:01:45
Table 'RushAndCash22319208' 6-max Seat #1 is the button
Seat 1: e4fc8b12 ($11.42 in chips)
Seat 2: 2a6446ed ($15.77 in chips)
Seat 3: a1907a02 ($21.59 in chips)
Seat 4: 4740c06b ($17.06 in chips)
Seat 5: 647dd971 ($8.83 in chips)
Seat 6: Hero ($10 in chips)
2a6446ed: posts small blind $0.05
a1907a02: posts big blind $0.1
*** HOLE CARDS ***
Dealt to e4fc8b12 
Dealt to 2a6446ed 
Dealt to a1907a02 
Dealt to 4740c06b 
Dealt to 647dd971 
Dealt to Hero [5c 2c]
4740c06b: folds
647dd971: folds
Hero: folds
e4fc8b12: raises $0.1 to $0.2
2a6446ed: raises $0.8 to $1
a1907a02: folds
e4fc8b12: calls $0.8
*** FLOP *** [9s 5d 6d]
2a6446ed: bets $1.41
e4fc8b12: calls $1.41
*** TURN *** [9s 5d 6d] [Ah]
2a6446ed: bets $1.55
e4fc8b12: raises $2.65 to $4.2
2a6446ed: folds
Uncalled bet ($2.65) returned to e4fc8b12
*** SHOWDOWN ***
e4fc8b12 collected $7.57 from pot
*** SUMMARY ***
Total pot $8.02 | Rake $0.3 | Jackpot $0.15 | Bingo $0 | Fortune $0 | Tax $0
Board [9s 5d 6d Ah]
Seat 1: e4fc8b12 (button) won ($7.57)
Seat 2: 2a6446ed (small blind) folded on the Turn
Seat 3: a1907a02 (big blind) folded before Flop
Seat 4: 4740c06b folded before Flop (didn't bet)
Seat 5: 647dd971 folded before Flop (didn't bet)
Seat 6: Hero folded before Flop (didn't bet)


Poker Hand #RC3141673921: Hold'em No Limit ($0.05/$0.1) - 2024/12/12 13:01:39
Table 'RushAndCash22319181' 6-max Seat #1 is the button
Seat 1: 47ae29b2 ($10.15 in chips)
Seat 2: bb0086cf ($10.09 in chips)
Seat 3: 7b43c302 ($10 in chips)
Seat 4: f564c212 ($10.46 in chips)
Seat 5: e2a23377 ($10.42 in chips)
Seat 6: Hero ($10 in chips)
bb0086cf: posts small blind $0.05
7b43c302: posts big blind $0.1
*** HOLE CARDS ***
Dealt to 47ae29b2 
Dealt to bb0086cf 
Dealt to 7b43c302 
Dealt to f564c212 
Dealt to e2a23377 
Dealt to Hero [Tc 7d]
f564c212: folds
e2a23377: folds
Hero: folds
47ae29b2: folds
bb0086cf: raises $0.1 to $0.2
7b43c302: calls $0.1
*** FLOP *** [Ah 7c Ts]
bb0086cf: checks
7b43c302: bets $0.2
bb0086cf: calls $0.2
*** TURN *** [Ah 7c Ts] [4d]
bb0086cf: checks
7b43c302: bets $1.19
bb0086cf: folds
Uncalled bet ($1.19) returned to 7b43c302
*** SHOWDOWN ***
7b43c302 collected $0.76 from pot
*** SUMMARY ***
Total pot $0.8 | Rake $0.04 | Jackpot $0 | Bingo $0 | Fortune $0 | Tax $0
Board [Ah 7c Ts 4d]
Seat 1: 47ae29b2 (button) folded before Flop (didn't bet)
Seat 2: bb0086cf (small blind) folded on the Turn
Seat 3: 7b43c302 (big blind) won ($0.76)
Seat 4: f564c212 folded before Flop (didn't bet)
Seat 5: e2a23377 folded before Flop (didn't bet)
Seat 6: Hero folded before Flop (didn't bet)


Poker Hand #RC3141673866: Hold'em No Limit ($0.05/$0.1) - 2024/12/12 13:01:26
Table 'RushAndCash22319126' 6-max Seat #1 is the button
Seat 1: dd68a104 ($11.76 in chips)
Seat 2: Hero ($10 in chips)
Seat 3: 24af28af ($9.7 in chips)
Seat 4: bb0086cf ($10.19 in chips)
Seat 5: 968b2ad6 ($13.1 in chips)
Seat 6: 37686872 ($15.65 in chips)
Hero: posts small blind $0.05
24af28af: posts big blind $0.1
*** HOLE CARDS ***
Dealt to dd68a104 
Dealt to Hero [Jd Td]
Dealt to 24af28af 
Dealt to bb0086cf 
Dealt to 968b2ad6 
Dealt to 37686872 
bb0086cf: folds
968b2ad6: folds
37686872: folds
dd68a104: raises $0.1 to $0.2
Hero: folds
24af28af: folds
Uncalled bet ($0.1) returned to dd68a104
*** SHOWDOWN ***
dd68a104 collected $0.25 from pot
*** SUMMARY ***
Total pot $0.25 | Rake $0 | Jackpot $0 | Bingo $0 | Fortune $0 | Tax $0
Seat 1: dd68a104 (button) collected ($0.25)
Seat 2: Hero (small blind) folded before Flop
Seat 3: 24af28af (big blind) folded before Flop
Seat 4: bb0086cf folded before Flop (didn't bet)
Seat 5: 968b2ad6 folded before Flop (didn't bet)
Seat 6: 37686872 folded before Flop (didn't bet)


Poker Hand #RC3141673852: Hold'em No Limit ($0.05/$0.1) - 2024/12/12 13:01:23
Table 'RushAndCash22319112' 6-max Seat #1 is the button
Seat 1: Hero ($10 in chips)
Seat 2: dd68a104 ($11.81 in chips)
Seat 3: 61709362 ($10 in chips)
Seat 4: bb0086cf ($10.19 in chips)
Seat 5: 22e8274e ($16.27 in chips)
Seat 6: f347a136 ($11.13 in chips)
dd68a104: posts small blind $0.05
61709362: posts big blind $0.1
*** HOLE CARDS ***
Dealt to Hero [Ts 6d]
Dealt to dd68a104 
Dealt to 61709362 
Dealt to bb0086cf 
Dealt to 22e8274e 
Dealt to f347a136 
bb0086cf: folds
22e8274e: folds
f347a136: folds
Hero: folds
dd68a104: folds
Uncalled bet ($0.05) returned to 61709362
*** SHOWDOWN ***
61709362 collected $0.1 from pot
*** SUMMARY ***
Total pot $0.1 | Rake $0 | Jackpot $0 | Bingo $0 | Fortune $0 | Tax $0
Seat 1: Hero (button) folded before Flop (didn't bet)
Seat 2: dd68a104 (small blind) folded before Flop
Seat 3: 61709362 (big blind) collected ($0.1)
Seat 4: bb0086cf folded before Flop (didn't bet)
Seat 5: 22e8274e folded before Flop (didn't bet)
Seat 6: f347a136 folded before Flop (didn't bet)


Poker Hand #RC3141673726: Hold'em No Limit ($0.05/$0.1) - 2024/12/12 13:00:54
Table 'RushAndCash22318986' 6-max Seat #1 is the button
Seat 1: ec7ff353 ($10.15 in chips)
Seat 2: d940390d ($18.59 in chips)
Seat 3: Hero ($10 in chips)
Seat 4: 88a9583f ($44.65 in chips)
Seat 5: 2ad815d2 ($8.43 in chips)
Seat 6: ab081f1e ($10.85 in chips)
d940390d: posts small blind $0.05
Hero: posts big blind $0.1
*** HOLE CARDS ***
Dealt to ec7ff353 
Dealt to d940390d 
Dealt to Hero [9s 7s]
Dealt to 88a9583f 
Dealt to 2ad815d2 
Dealt to ab081f1e 
88a9583f: raises $0.1 to $0.2
2ad815d2: calls $0.2
ab081f1e: folds
ec7ff353: folds
d940390d: folds
Hero: folds
*** FLOP *** [4s 5s 3d]
88a9583f: checks
2ad815d2: checks
*** TURN *** [4s 5s 3d] [8s]
88a9583f: checks
2ad815d2: checks
*** RIVER *** [4s 5s 3d 8s] [Jh]
88a9583f: bets $0.46
2ad815d2: calls $0.46
88a9583f: shows [9h Th] (Jack-High)
2ad815d2: shows [Jd 9d] (Pair of Jacks)
*** SHOWDOWN ***
2ad815d2 collected $1.4 from pot
*** SUMMARY ***
Total pot $1.47 | Rake $0.07 | Jackpot $0 | Bingo $0 | Fortune $0 | Tax $0
Board [4s 5s 3d 8s Jh]
Seat 1: ec7ff353 (button) folded before Flop (didn't bet)
Seat 2: d940390d (small blind) folded before Flop
Seat 3: Hero (big blind) folded before Flop
Seat 4: 88a9583f showed [9h Th] and lost with Jack-High
Seat 5: 2ad815d2 showed [Jd 9d] and won ($1.4) with Pair of Jacks
Seat 6: ab081f1e folded before Flop (didn't bet)


Poker Hand #RC3141673712: Hold'em No Limit ($0.05/$0.1) - 2024/12/12 13:00:51
Table 'RushAndCash22318972' 6-max Seat #1 is the button
Seat 1: 228a039d ($13.7 in chips)
Seat 2: cfe70ef2 ($10.05 in chips)
Seat 3: d037fd58 ($12.8 in chips)
Seat 4: 4eb4d0d6 ($17.25 in chips)
Seat 5: 91e6eecf ($11.31 in chips)
Seat 6: Hero ($10 in chips)
cfe70ef2: posts small blind $0.05
d037fd58: posts big blind $0.1
*** HOLE CARDS ***
Dealt to 228a039d 
Dealt to cfe70ef2 
Dealt to d037fd58 
Dealt to 4eb4d0d6 
Dealt to 91e6eecf 
Dealt to Hero [Js 4h]
4eb4d0d6: raises $0.2 to $0.3
91e6eecf: folds
Hero: folds
228a039d: folds
cfe70ef2: folds
d037fd58: calls $0.2
*** FLOP *** [9s As 4s]
d037fd58: checks
4eb4d0d6: bets $0.33
d037fd58: folds
Uncalled bet ($0.33) returned to 4eb4d0d6
*** SHOWDOWN ***
4eb4d0d6 collected $0.62 from pot
*** SUMMARY ***
Total pot $0.65 | Rake $0.03 | Jackpot $0 | Bingo $0 | Fortune $0 | Tax $0
Board [9s As 4s]
Seat 1: 228a039d (button) folded before Flop (didn't bet)
Seat 2: cfe70ef2 (small blind) folded before Flop
Seat 3: d037fd58 (big blind) folded on the Flop
Seat 4: 4eb4d0d6 won ($0.62)
Seat 5: 91e6eecf folded before Flop (didn't bet)
Seat 6: Hero folded before Flop (didn't bet)


Poker Hand #RC3141673697: Hold'em No Limit ($0.05/$0.1) - 2024/12/12 13:00:47
Table 'RushAndCash22318957' 6-max Seat #1 is the button
Seat 1: f323cdf3 ($11.63 in chips)
Seat 2: 671b32fd ($14.92 in chips)
Seat 3: cb8dca6d ($10.1 in chips)
Seat 4: Hero ($10 in chips)
Seat 5: 4eb4d0d6 ($17.25 in chips)
Seat 6: 9a52083d ($25.23 in chips)
671b32fd: posts small blind $0.05
cb8dca6d: posts big blind $0.1
*** HOLE CARDS ***
Dealt to f323cdf3 
Dealt to 671b32fd 
Dealt to cb8dca6d 
Dealt to Hero [Kd 2c]
Dealt to 4eb4d0d6 
Dealt to 9a52083d 
Hero: folds
4eb4d0d6: folds
9a52083d: folds
f323cdf3: folds
671b32fd: folds
Uncalled bet ($0.05) returned to cb8dca6d
*** SHOWDOWN ***
cb8dca6d collected $0.1 from pot
*** SUMMARY ***
Total pot $0.1 | Rake $0 | Jackpot $0 | Bingo $0 | Fortune $0 | Tax $0
Seat 1: f323cdf3 (button) folded before Flop (didn't bet)
Seat 2: 671b32fd (small blind) folded before Flop
Seat 3: cb8dca6d (big blind) collected ($0.1)
Seat 4: Hero folded before Flop (didn't bet)
Seat 5: 4eb4d0d6 folded before Flop (didn't bet)
Seat 6: 9a52083d folded before Flop (didn't bet)


Poker Hand #RC3141673563: Hold'em No Limit ($0.05/$0.1) - 2024/12/12 13:00:14
Table 'RushAndCash22318823' 6-max Seat #1 is the button
Seat 1: 8ebad06f ($10.23 in chips)
Seat 2: 27c51518 ($23.22 in chips)
Seat 3: 9dd76deb ($13.56 in chips)
Seat 4: 84cc5caa ($10.64 in chips)
Seat 5: eb12374a ($12.91 in chips)
Seat 6: Hero ($10 in chips)
27c51518: posts small blind $0.05
9dd76deb: posts big blind $0.1
*** HOLE CARDS ***
Dealt to 8ebad06f 
Dealt to 27c51518 
Dealt to 9dd76deb 
Dealt to 84cc5caa 
Dealt to eb12374a 
Dealt to Hero [Ad 3d]
84cc5caa: folds
eb12374a: folds
Hero: raises $0.15 to $0.25
8ebad06f: folds
27c51518: raises $0.75 to $1
9dd76deb: folds
Hero: folds
Uncalled bet ($0.75) returned to 27c51518
*** SHOWDOWN ***
27c51518 collected $0.57 from pot
*** SUMMARY ***
Total pot $0.6 | Rake $0.03 | Jackpot $0 | Bingo $0 | Fortune $0 | Tax $0
Seat 1: 8ebad06f (button) folded before Flop (didn't bet)
Seat 2: 27c51518 (small blind) collected ($0.57)
Seat 3: 9dd76deb (big blind) folded before Flop
Seat 4: 84cc5caa folded before Flop (didn't bet)
Seat 5: eb12374a folded before Flop (didn't bet)
Seat 6: Hero folded before Flop


Poker Hand #RC3141673547: Hold'em No Limit ($0.05/$0.1) - 2024/12/12 13:00:11
Table 'RushAndCash22318807' 6-max Seat #1 is the button
Seat 1: 17b381d5 ($34.27 in chips)
Seat 2: ec7ff353 ($10 in chips)
Seat 3: 289eab8b ($5.43 in chips)
Seat 4: Hero ($10 in chips)
Seat 5: c6786b68 ($16.12 in chips)
Seat 6: 54d53a50 ($17.06 in chips)
ec7ff353: posts small blind $0.05
289eab8b: posts big blind $0.1
*** HOLE CARDS ***
Dealt to 17b381d5 
Dealt to ec7ff353 
Dealt to 289eab8b 
Dealt to Hero [7h Ad]
Dealt to c6786b68 
Dealt to 54d53a50 
Hero: folds
c6786b68: folds
54d53a50: raises $0.12 to $0.22
17b381d5: folds
ec7ff353: folds
289eab8b: calls $0.12
*** FLOP *** [4s Qc Ks]
289eab8b: bets $0.1
54d53a50: calls $0.1
*** TURN *** [4s Qc Ks] [6c]
289eab8b: bets $0.23
54d53a50: calls $0.23
*** RIVER *** [4s Qc Ks 6c] [Jh]
289eab8b: checks
54d53a50: bets $16.51 and is all-in
289eab8b: folds
Uncalled bet ($16.51) returned to 54d53a50
*** SHOWDOWN ***
54d53a50 collected $1.1 from pot
*** SUMMARY ***
Total pot $1.15 | Rake $0.05 | Jackpot $0 | Bingo $0 | Fortune $0 | Tax $0
Board [4s Qc Ks 6c Jh]
Seat 1: 17b381d5 (button) folded before Flop (didn't bet)
Seat 2: ec7ff353 (small blind) folded before Flop
Seat 3: 289eab8b (big blind) folded on the River
Seat 4: Hero folded before Flop (didn't bet)
Seat 5: c6786b68 folded before Flop (didn't bet)
Seat 6: 54d53a50 won ($1.1)


Poker Hand #RC3141673428: Hold'em No Limit ($0.05/$0.1) - 2024/12/12 12:59:39
Table 'RushAndCash22318688' 6-max Seat #1 is the button
Seat 1: Hero ($10 in chips)
Seat 2: 43056553 ($10 in chips)
Seat 3: 9b962a1c ($10 in chips)
Seat 4: 4de3c51 ($10.09 in chips)
Seat 5: d1764387 ($13.91 in chips)
Seat 6: 101c026b ($35.55 in chips)
43056553: posts small blind $0.05
9b962a1c: posts big blind $0.1
*** HOLE CARDS ***
Dealt to Hero [6s 6d]
Dealt to 43056553 
Dealt to 9b962a1c 
Dealt to 4de3c51 
Dealt to d1764387 
Dealt to 101c026b 
4de3c51: folds
d1764387: folds
101c026b: folds
Hero: raises $0.15 to $0.25
43056553: raises $0.87 to $1.12
9b962a1c: folds
Hero: folds
Uncalled bet ($0.87) returned to 43056553
*** SHOWDOWN ***
43056553 collected $0.57 from pot
*** SUMMARY ***
Total pot $0.6 | Rake $0.03 | Jackpot $0 | Bingo $0 | Fortune $0 | Tax $0
Seat 1: Hero (button) folded before Flop
Seat 2: 43056553 (small blind) collected ($0.57)
Seat 3: 9b962a1c (big blind) folded before Flop
Seat 4: 4de3c51 folded before Flop (didn't bet)
Seat 5: d1764387 folded before Flop (didn't bet)
Seat 6: 101c026b folded before Flop (didn't bet)


Poker Hand #RC3141673344: Hold'em No Limit ($0.05/$0.1) - 2024/12/12 12:59:18
Table 'RushAndCash22318604' 6-max Seat #1 is the button
Seat 1: 9ab5b010 ($24.5 in chips)
Seat 2: 38992bb8 ($10.9 in chips)
Seat 3: Hero ($10 in chips)
Seat 4: 745c6911 ($14.46 in chips)
Seat 5: f500aed7 ($10.55 in chips)
Seat 6: fed66cf6 ($12.2 in chips)
38992bb8: posts small blind $0.05
Hero: posts big blind $0.1
*** HOLE CARDS ***
Dealt to 9ab5b010 
Dealt to 38992bb8 
Dealt to Hero [As 4h]
Dealt to 745c6911 
Dealt to f500aed7 
Dealt to fed66cf6 
745c6911: folds
f500aed7: folds
fed66cf6: raises $0.15 to $0.25
9ab5b010: calls $0.25
38992bb8: folds
Hero: folds
*** FLOP *** [7s 6c 5c]
fed66cf6: checks
9ab5b010: bets $0.51
fed66cf6: folds
Uncalled bet ($0.51) returned to 9ab5b010
*** SHOWDOWN ***
9ab5b010 collected $0.62 from pot
*** SUMMARY ***
Total pot $0.65 | Rake $0.03 | Jackpot $0 | Bingo $0 | Fortune $0 | Tax $0
Board [7s 6c 5c]
Seat 1: 9ab5b010 (button) won ($0.62)
Seat 2: 38992bb8 (small blind) folded before Flop
Seat 3: Hero (big blind) folded before Flop
Seat 4: 745c6911 folded before Flop (didn't bet)
Seat 5: f500aed7 folded before Flop (didn't bet)
Seat 6: fed66cf6 folded on the Flop


Poker Hand #RC3141673327: Hold'em No Limit ($0.05/$0.1) - 2024/12/12 12:59:14
Table 'RushAndCash22318587' 6-max Seat #1 is the button
Seat 1: 8a31e4cb ($17.47 in chips)
Seat 2: Hero ($10 in chips)
Seat 3: 8f901b97 ($10.33 in chips)
Seat 4: ab081f1e ($10.1 in chips)
Seat 5: 7829feb5 ($11.68 in chips)
Seat 6: 66f3bea2 ($10.15 in chips)
Hero: posts small blind $0.05
8f901b97: posts big blind $0.1
*** HOLE CARDS ***
Dealt to 8a31e4cb 
Dealt to Hero [Jh 6s]
Dealt to 8f901b97 
Dealt to ab081f1e 
Dealt to 7829feb5 
Dealt to 66f3bea2 
ab081f1e: folds
7829feb5: folds
66f3bea2: folds
8a31e4cb: folds
Hero: folds
Uncalled bet ($0.05) returned to 8f901b97
*** SHOWDOWN ***
8f901b97 collected $0.1 from pot
*** SUMMARY ***
Total pot $0.1 | Rake $0 | Jackpot $0 | Bingo $0 | Fortune $0 | Tax $0
Seat 1: 8a31e4cb (button) folded before Flop (didn't bet)
Seat 2: Hero (small blind) folded before Flop
Seat 3: 8f901b97 (big blind) collected ($0.1)
Seat 4: ab081f1e folded before Flop (didn't bet)
Seat 5: 7829feb5 folded before Flop (didn't bet)
Seat 6: 66f3bea2 folded before Flop (didn't bet)


Poker Hand #RC3141673300: Hold'em No Limit ($0.05/$0.1) - 2024/12/12 12:59:09
Table 'RushAndCash22318560' 6-max Seat #1 is the button
Seat 1: 9a52083d ($25.18 in chips)
Seat 2: 4e5368fb ($9.9 in chips)
Seat 3: dcaacb33 ($2.78 in chips)
Seat 4: dbcd9107 ($20.09 in chips)
Seat 5: d4deed2f ($10.61 in chips)
Seat 6: Hero ($10 in chips)
4e5368fb: posts small blind $0.05
dcaacb33: posts big blind $0.1
*** HOLE CARDS ***
Dealt to 9a52083d 
Dealt to 4e5368fb 
Dealt to dcaacb33 
Dealt to dbcd9107 
Dealt to d4deed2f 
Dealt to Hero [7c 6h]
dbcd9107: folds
d4deed2f: folds
Hero: folds
9a52083d: folds
4e5368fb: folds
Uncalled bet ($0.05) returned to dcaacb33
*** SHOWDOWN ***
dcaacb33 collected $0.1 from pot
*** SUMMARY ***
Total pot $0.1 | Rake $0 | Jackpot $0 | Bingo $0 | Fortune $0 | Tax $0
Seat 1: 9a52083d (button) folded before Flop (didn't bet)
Seat 2: 4e5368fb (small blind) folded before Flop
Seat 3: dcaacb33 (big blind) collected ($0.1)
Seat 4: dbcd9107 folded before Flop (didn't bet)
Seat 5: d4deed2f folded before Flop (didn't bet)
Seat 6: Hero folded before Flop (didn't bet)


Poker Hand #RC3141673008: Hold'em No Limit ($0.05/$0.1) - 2024/12/12 12:58:00
Table 'RushAndCash22318268' 6-max Seat #1 is the button
Seat 1: cacc74b2 ($12.3 in chips)
Seat 2: 4f76bae1 ($10.29 in chips)
Seat 3: a3382d82 ($25.87 in chips)
Seat 4: 9ab5b010 ($23.72 in chips)
Seat 5: 16994a2d ($9.74 in chips)
Seat 6: Hero ($10.13 in chips)
4f76bae1: posts small blind $0.05
a3382d82: posts big blind $0.1
*** HOLE CARDS ***
Dealt to cacc74b2 
Dealt to 4f76bae1 
Dealt to a3382d82 
Dealt to 9ab5b010 
Dealt to 16994a2d 
Dealt to Hero [Th Qc]
9ab5b010: folds
16994a2d: folds
Hero: raises $0.15 to $0.25
cacc74b2: folds
4f76bae1: folds
a3382d82: calls $0.15
*** FLOP *** [Ah 5c 7d]
a3382d82: checks
Hero: checks
*** TURN *** [Ah 5c 7d] [Jh]
a3382d82: bets $0.28
Hero: folds
Uncalled bet ($0.28) returned to a3382d82
*** SHOWDOWN ***
a3382d82 collected $0.53 from pot
*** SUMMARY ***
Total pot $0.55 | Rake $0.02 | Jackpot $0 | Bingo $0 | Fortune $0 | Tax $0
Board [Ah 5c 7d Jh]
Seat 1: cacc74b2 (button) folded before Flop (didn't bet)
Seat 2: 4f76bae1 (small blind) folded before Flop
Seat 3: a3382d82 (big blind) won ($0.53)
Seat 4: 9ab5b010 folded before Flop (didn't bet)
Seat 5: 16994a2d folded before Flop (didn't bet)
Seat 6: Hero folded on the Turn


Poker Hand #RC3141672996: Hold'em No Limit ($0.05/$0.1) - 2024/12/12 12:57:57
Table 'RushAndCash22318256' 6-max Seat #1 is the button
Seat 1: c8e1bfcc ($9.73 in chips)
Seat 2: 8ebc9879 ($10.54 in chips)
Seat 3: 11f48e34 ($10 in chips)
Seat 4: Hero ($10.13 in chips)
Seat 5: 481b7ef8 ($16.96 in chips)
Seat 6: 17b381d5 ($34.57 in chips)
8ebc9879: posts small blind $0.05
11f48e34: posts big blind $0.1
*** HOLE CARDS ***
Dealt to c8e1bfcc 
Dealt to 8ebc9879 
Dealt to 11f48e34 
Dealt to Hero [Th 9d]
Dealt to 481b7ef8 
Dealt to 17b381d5 
Hero: folds
481b7ef8: folds
17b381d5: folds
c8e1bfcc: folds
8ebc9879: folds
Uncalled bet ($0.05) returned to 11f48e34
*** SHOWDOWN ***
11f48e34 collected $0.1 from pot
*** SUMMARY ***
Total pot $0.1 | Rake $0 | Jackpot $0 | Bingo $0 | Fortune $0 | Tax $0
Seat 1: c8e1bfcc (button) folded before Flop (didn't bet)
Seat 2: 8ebc9879 (small blind) folded before Flop
Seat 3: 11f48e34 (big blind) collected ($0.1)
Seat 4: Hero folded before Flop (didn't bet)
Seat 5: 481b7ef8 folded before Flop (didn't bet)
Seat 6: 17b381d5 folded before Flop (didn't bet)


Poker Hand #RC3141672975: Hold'em No Limit ($0.05/$0.1) - 2024/12/12 12:57:51
Table 'RushAndCash22318235' 6-max Seat #1 is the button
Seat 1: Hero ($10.13 in chips)
Seat 2: b8e03e64 ($14.7 in chips)
Seat 3: 2441c176 ($11.01 in chips)
Seat 4: 25c1f7d7 ($10.56 in chips)
Seat 5: 643f85e7 ($11.95 in chips)
Seat 6: 1677a3f4 ($14.87 in chips)
b8e03e64: posts small blind $0.05
2441c176: posts big blind $0.1
*** HOLE CARDS ***
Dealt to Hero [3h 4h]
Dealt to b8e03e64 
Dealt to 2441c176 
Dealt to 25c1f7d7 
Dealt to 643f85e7 
Dealt to 1677a3f4 
25c1f7d7: folds
643f85e7: folds
1677a3f4: folds
Hero: folds
b8e03e64: raises $0.1 to $0.2
2441c176: calls $0.1
*** FLOP *** [9c Tc 8c]
b8e03e64: checks
2441c176: bets $0.15
b8e03e64: folds
Uncalled bet ($0.15) returned to 2441c176
*** SHOWDOWN ***
2441c176 collected $0.38 from pot
*** SUMMARY ***
Total pot $0.4 | Rake $0.02 | Jackpot $0 | Bingo $0 | Fortune $0 | Tax $0
Board [9c Tc 8c]
Seat 1: Hero (button) folded before Flop (didn't bet)
Seat 2: b8e03e64 (small blind) folded on the Flop
Seat 3: 2441c176 (big blind) won ($0.38)
Seat 4: 25c1f7d7 folded before Flop (didn't bet)
Seat 5: 643f85e7 folded before Flop (didn't bet)
Seat 6: 1677a3f4 folded before Flop (didn't bet)


Poker Hand #RC3141672906: Hold'em No Limit ($0.05/$0.1) - 2024/12/12 12:57:35
Table 'RushAndCash22318166' 6-max Seat #1 is the button
Seat 1: f4a6a825 ($10.04 in chips)
Seat 2: 66f3bea2 ($10 in chips)
Seat 3: Hero ($10.23 in chips)
Seat 4: 7ec40c0d ($10.1 in chips)
Seat 5: bbe73ee2 ($10.84 in chips)
Seat 6: 23d20ac6 ($17.49 in chips)
66f3bea2: posts small blind $0.05
Hero: posts big blind $0.1
*** HOLE CARDS ***
Dealt to f4a6a825 
Dealt to 66f3bea2 
Dealt to Hero [Jh 8d]
Dealt to 7ec40c0d 
Dealt to bbe73ee2 
Dealt to 23d20ac6 
7ec40c0d: raises $0.1 to $0.2
bbe73ee2: folds
23d20ac6: folds
f4a6a825: folds
66f3bea2: calls $0.15
Hero: folds
*** FLOP *** [8h Jd Ac]
66f3bea2: checks
7ec40c0d: bets $0.2
66f3bea2: folds
Uncalled bet ($0.2) returned to 7ec40c0d
*** SHOWDOWN ***
7ec40c0d collected $0.48 from pot
*** SUMMARY ***
Total pot $0.5 | Rake $0.02 | Jackpot $0 | Bingo $0 | Fortune $0 | Tax $0
Board [8h Jd Ac]
Seat 1: f4a6a825 (button) folded before Flop (didn't bet)
Seat 2: 66f3bea2 (small blind) folded on the Flop
Seat 3: Hero (big blind) folded before Flop
Seat 4: 7ec40c0d won ($0.48)
Seat 5: bbe73ee2 folded before Flop (didn't bet)
Seat 6: 23d20ac6 folded before Flop (didn't bet)


Poker Hand #RC3141672892: Hold'em No Limit ($0.05/$0.1) - 2024/12/12 12:57:31
Table 'RushAndCash22318152' 6-max Seat #1 is the button
Seat 1: 8a31e4cb ($18.23 in chips)
Seat 2: Hero ($10.28 in chips)
Seat 3: 86ee8e36 ($29.36 in chips)
Seat 4: a699d2de ($10.46 in chips)
Seat 5: 66f3bea2 ($10 in chips)
Seat 6: 101c026b ($35.65 in chips)
Hero: posts small blind $0.05
86ee8e36: posts big blind $0.1
*** HOLE CARDS ***
Dealt to 8a31e4cb 
Dealt to Hero [3d Ks]
Dealt to 86ee8e36 
Dealt to a699d2de 
Dealt to 66f3bea2 
Dealt to 101c026b 
a699d2de: folds
66f3bea2: folds
101c026b: folds
8a31e4cb: folds
Hero: folds
Uncalled bet ($0.05) returned to 86ee8e36
*** SHOWDOWN ***
86ee8e36 collected $0.1 from pot
*** SUMMARY ***
Total pot $0.1 | Rake $0 | Jackpot $0 | Bingo $0 | Fortune $0 | Tax $0
Seat 1: 8a31e4cb (button) folded before Flop (didn't bet)
Seat 2: Hero (small blind) folded before Flop
Seat 3: 86ee8e36 (big blind) collected ($0.1)
Seat 4: a699d2de folded before Flop (didn't bet)
Seat 5: 66f3bea2 folded before Flop (didn't bet)
Seat 6: 101c026b folded before Flop (didn't bet)


Poker Hand #RC3141672879: Hold'em No Limit ($0.05/$0.1) - 2024/12/12 12:57:28
Table 'RushAndCash22318139' 6-max Seat #1 is the button
Seat 1: dcaacb33 ($2.8 in chips)
Seat 2: 3f5e12f8 ($10 in chips)
Seat 3: 9dd125fd ($13.42 in chips)
Seat 4: Hero ($10.28 in chips)
Seat 5: 916c6bd3 ($14.9 in chips)
Seat 6: eb12374a ($12.73 in chips)
3f5e12f8: posts small blind $0.05
9dd125fd: posts big blind $0.1
*** HOLE CARDS ***
Dealt to dcaacb33 
Dealt to 3f5e12f8 
Dealt to 9dd125fd 
Dealt to Hero [Kc 3s]
Dealt to 916c6bd3 
Dealt to eb12374a 
Hero: folds
916c6bd3: raises $0.1 to $0.2
eb12374a: folds
dcaacb33: folds
3f5e12f8: folds
9dd125fd: calls $0.1
*** FLOP *** [Jd 7d 7h]
9dd125fd: checks
916c6bd3: bets $0.23
9dd125fd: calls $0.23
*** TURN *** [Jd 7d 7h] [Qh]
9dd125fd: checks
916c6bd3: checks
*** RIVER *** [Jd 7d 7h Qh] [4d]
9dd125fd: bets $0.46
916c6bd3: folds
Uncalled bet ($0.46) returned to 9dd125fd
*** SHOWDOWN ***
9dd125fd collected $0.87 from pot
*** SUMMARY ***
Total pot $0.91 | Rake $0.04 | Jackpot $0 | Bingo $0 | Fortune $0 | Tax $0
Board [Jd 7d 7h Qh 4d]
Seat 1: dcaacb33 (button) folded before Flop (didn't bet)
Seat 2: 3f5e12f8 (small blind) folded before Flop
Seat 3: 9dd125fd (big blind) won ($0.87)
Seat 4: Hero folded before Flop (didn't bet)
Seat 5: 916c6bd3 folded on the River
Seat 6: eb12374a folded before Flop (didn't bet)


Poker Hand #RC3141672865: Hold'em No Limit ($0.05/$0.1) - 2024/12/12 12:57:24
Table 'RushAndCash22318125' 6-max Seat #1 is the button
Seat 1: 7fe88fe3 ($10 in chips)
Seat 2: 5346f1e0 ($11.76 in chips)
Seat 3: 1dc50d10 ($10.15 in chips)
Seat 4: Hero ($10.28 in chips)
Seat 5: af208717 ($10.52 in chips)
Seat 6: 41ad32d3 ($20.47 in chips)
5346f1e0: posts small blind $0.05
1dc50d10: posts big blind $0.1
*** HOLE CARDS ***
Dealt to 7fe88fe3 
Dealt to 5346f1e0 
Dealt to 1dc50d10 
Dealt to Hero [Ac 8d]
Dealt to af208717 
Dealt to 41ad32d3 
Hero: folds
af208717: folds
41ad32d3: raises $0.15 to $0.25
7fe88fe3: folds
5346f1e0: folds
1dc50d10: calls $0.15
*** FLOP *** [7d 7s 8h]
1dc50d10: checks
41ad32d3: checks
*** TURN *** [7d 7s 8h] [9d]
1dc50d10: checks
41ad32d3: checks
*** RIVER *** [7d 7s 8h 9d] [6d]
1dc50d10: bets $1.45
41ad32d3: folds
Uncalled bet ($1.45) returned to 1dc50d10
*** SHOWDOWN ***
1dc50d10 collected $0.53 from pot
*** SUMMARY ***
Total pot $0.55 | Rake $0.02 | Jackpot $0 | Bingo $0 | Fortune $0 | Tax $0
Board [7d 7s 8h 9d 6d]
Seat 1: 7fe88fe3 (button) folded before Flop (didn't bet)
Seat 2: 5346f1e0 (small blind) folded before Flop
Seat 3: 1dc50d10 (big blind) won ($0.53)
Seat 4: Hero folded before Flop (didn't bet)
Seat 5: af208717 folded before Flop (didn't bet)
Seat 6: 41ad32d3 folded on the River


Poker Hand #RC3141672849: Hold'em No Limit ($0.05/$0.1) - 2024/12/12 12:57:21
Table 'RushAndCash22318109' 6-max Seat #1 is the button
Seat 1: 9dd125fd ($13.47 in chips)
Seat 2: 7829feb5 ($11.78 in chips)
Seat 3: 4898aa10 ($30.82 in chips)
Seat 4: b82279c3 ($43.76 in chips)
Seat 5: 5346f1e0 ($11.76 in chips)
Seat 6: Hero ($10.28 in chips)
7829feb5: posts small blind $0.05
4898aa10: posts big blind $0.1
*** HOLE CARDS ***
Dealt to 9dd125fd 
Dealt to 7829feb5 
Dealt to 4898aa10 
Dealt to b82279c3 
Dealt to 5346f1e0 
Dealt to Hero [8h 7c]
b82279c3: raises $0.15 to $0.25
5346f1e0: folds
Hero: folds
9dd125fd: folds
7829feb5: folds
4898aa10: folds
Uncalled bet ($0.15) returned to b82279c3
*** SHOWDOWN ***
b82279c3 collected $0.25 from pot
*** SUMMARY ***
Total pot $0.25 | Rake $0 | Jackpot $0 | Bingo $0 | Fortune $0 | Tax $0
Seat 1: 9dd125fd (button) folded before Flop (didn't bet)
Seat 2: 7829feb5 (small blind) folded before Flop
Seat 3: 4898aa10 (big blind) folded before Flop
Seat 4: b82279c3 collected ($0.25)
Seat 5: 5346f1e0 folded before Flop (didn't bet)
Seat 6: Hero folded before Flop (didn't bet)


Poker Hand #RC3141672713: Hold'em No Limit ($0.05/$0.1) - 2024/12/12 12:56:46
Table 'RushAndCash22317973' 6-max Seat #1 is the button
Seat 1: Hero ($10 in chips)
Seat 2: ce410800 ($19.55 in chips)
Seat 3: 9dd125fd ($13.72 in chips)
Seat 4: 5ddf2544 ($13.65 in chips)
Seat 5: 1d8dcfab ($48.18 in chips)
Seat 6: c1fd0ebe ($19.05 in chips)
ce410800: posts small blind $0.05
9dd125fd: posts big blind $0.1
*** HOLE CARDS ***
Dealt to Hero [4h 4d]
Dealt to ce410800 
Dealt to 9dd125fd 
Dealt to 5ddf2544 
Dealt to 1d8dcfab 
Dealt to c1fd0ebe 
5ddf2544: folds
1d8dcfab: folds
c1fd0ebe: folds
Hero: raises $0.15 to $0.25
ce410800: folds
9dd125fd: calls $0.15
*** FLOP *** [Ac Kd Jh]
9dd125fd: checks
Hero: bets $0.14
9dd125fd: folds
Uncalled bet ($0.14) returned to Hero
*** SHOWDOWN ***
Hero collected $0.53 from pot
*** SUMMARY ***
Total pot $0.55 | Rake $0.02 | Jackpot $0 | Bingo $0 | Fortune $0 | Tax $0
Board [Ac Kd Jh]
Seat 1: Hero (button) won ($0.53)
Seat 2: ce410800 (small blind) folded before Flop
Seat 3: 9dd125fd (big blind) folded on the Flop
Seat 4: 5ddf2544 folded before Flop (didn't bet)
Seat 5: 1d8dcfab folded before Flop (didn't bet)
Seat 6: c1fd0ebe folded before Flop (didn't bet)


Poker Hand #RC3141672700: Hold'em No Limit ($0.05/$0.1) - 2024/12/12 12:56:42
Table 'RushAndCash22317960' 6-max Seat #1 is the button
Seat 1: 15f3779a ($19.8 in chips)
Seat 2: Hero ($10 in chips)
Seat 3: d6974a94 ($28.97 in chips)
Seat 4: 35b5987 ($18.38 in chips)
Seat 5: 721b66f0 ($10 in chips)
Seat 6: b0559006 ($9.87 in chips)
Hero: posts small blind $0.05
d6974a94: posts big blind $0.1
*** HOLE CARDS ***
Dealt to 15f3779a 
Dealt to Hero [Th 2c]
Dealt to d6974a94 
Dealt to 35b5987 
Dealt to 721b66f0 
Dealt to b0559006 
35b5987: raises $0.11 to $0.21
721b66f0: folds
b0559006: folds
15f3779a: folds
Hero: folds
d6974a94: calls $0.11
*** FLOP *** [3h Ks As]
d6974a94: checks
35b5987: bets $0.24
d6974a94: calls $0.24
*** TURN *** [3h Ks As] [4d]
d6974a94: checks
35b5987: bets $0.9
d6974a94: folds
Uncalled bet ($0.9) returned to 35b5987
*** SHOWDOWN ***
35b5987 collected $0.91 from pot
*** SUMMARY ***
Total pot $0.95 | Rake $0.04 | Jackpot $0 | Bingo $0 | Fortune $0 | Tax $0
Board [3h Ks As 4d]
Seat 1: 15f3779a (button) folded before Flop (didn't bet)
Seat 2: Hero (small blind) folded before Flop
Seat 3: d6974a94 (big blind) folded on the Turn
Seat 4: 35b5987 won ($0.91)
Seat 5: 721b66f0 folded before Flop (didn't bet)
Seat 6: b0559006 folded before Flop (didn't bet)


Poker Hand #RC3141672657: Hold'em No Limit ($0.05/$0.1) - 2024/12/12 12:56:32
Table 'RushAndCash22317917' 6-max Seat #1 is the button
Seat 1: a2fc0fa3 ($10 in chips)
Seat 2: 4859226e ($8.99 in chips)
Seat 3: Hero ($10.1 in chips)
Seat 4: 718b4a9 ($9.5 in chips)
Seat 5: 74b4c8de ($15.26 in chips)
Seat 6: 8424fd65 ($15.63 in chips)
4859226e: posts small blind $0.05
Hero: posts big blind $0.1
*** HOLE CARDS ***
Dealt to a2fc0fa3 
Dealt to 4859226e 
Dealt to Hero [8c 6h]
Dealt to 718b4a9 
Dealt to 74b4c8de 
Dealt to 8424fd65 
718b4a9: raises $0.2 to $0.3
74b4c8de: folds
8424fd65: folds
a2fc0fa3: folds
4859226e: folds
Hero: folds
Uncalled bet ($0.2) returned to 718b4a9
*** SHOWDOWN ***
718b4a9 collected $0.25 from pot
*** SUMMARY ***
Total pot $0.25 | Rake $0 | Jackpot $0 | Bingo $0 | Fortune $0 | Tax $0
Seat 1: a2fc0fa3 (button) folded before Flop (didn't bet)
Seat 2: 4859226e (small blind) folded before Flop
Seat 3: Hero (big blind) folded before Flop
Seat 4: 718b4a9 collected ($0.25)
Seat 5: 74b4c8de folded before Flop (didn't bet)
Seat 6: 8424fd65 folded before Flop (didn't bet)


Poker Hand #RC3141672643: Hold'em No Limit ($0.05/$0.1) - 2024/12/12 12:56:28
Table 'RushAndCash22317903' 6-max Seat #1 is the button
Seat 1: e2a23377 ($10 in chips)
Seat 2: ead6156b ($7.62 in chips)
Seat 3: 89d15c60 ($10.15 in chips)
Seat 4: Hero ($10.1 in chips)
Seat 5: 3f1c4e6e ($13.83 in chips)
Seat 6: 844091a0 ($12.8 in chips)
ead6156b: posts small blind $0.05
89d15c60: posts big blind $0.1
*** HOLE CARDS ***
Dealt to e2a23377 
Dealt to ead6156b 
Dealt to 89d15c60 
Dealt to Hero [4s Kd]
Dealt to 3f1c4e6e 
Dealt to 844091a0 
Hero: folds
3f1c4e6e: folds
844091a0: raises $0.12 to $0.22
e2a23377: folds
ead6156b: folds
89d15c60: folds
Uncalled bet ($0.12) returned to 844091a0
*** SHOWDOWN ***
844091a0 collected $0.25 from pot
*** SUMMARY ***
Total pot $0.25 | Rake $0 | Jackpot $0 | Bingo $0 | Fortune $0 | Tax $0
Seat 1: e2a23377 (button) folded before Flop (didn't bet)
Seat 2: ead6156b (small blind) folded before Flop
Seat 3: 89d15c60 (big blind) folded before Flop
Seat 4: Hero folded before Flop (didn't bet)
Seat 5: 3f1c4e6e folded before Flop (didn't bet)
Seat 6: 844091a0 collected ($0.25)


Poker Hand #RC3141672605: Hold'em No Limit ($0.05/$0.1) - 2024/12/12 12:56:17
Table 'RushAndCash22317865' 6-max Seat #1 is the button
Seat 1: af208717 ($10 in chips)
Seat 2: 22e8274e ($16.1 in chips)
Seat 3: f04fb852 ($12.24 in chips)
Seat 4: f4a6a825 ($10 in chips)
Seat 5: 7829feb5 ($12.03 in chips)
Seat 6: Hero ($10.1 in chips)
22e8274e: posts small blind $0.05
f04fb852: posts big blind $0.1
*** HOLE CARDS ***
Dealt to af208717 
Dealt to 22e8274e 
Dealt to f04fb852 
Dealt to f4a6a825 
Dealt to 7829feb5 
Dealt to Hero [2s As]
f4a6a825: raises $0.1 to $0.2
7829feb5: folds
Hero: folds
af208717: folds
22e8274e: folds
f04fb852: folds
Uncalled bet ($0.1) returned to f4a6a825
*** SHOWDOWN ***
f4a6a825 collected $0.25 from pot
*** SUMMARY ***
Total pot $0.25 | Rake $0 | Jackpot $0 | Bingo $0 | Fortune $0 | Tax $0
Seat 1: af208717 (button) folded before Flop (didn't bet)
Seat 2: 22e8274e (small blind) folded before Flop
Seat 3: f04fb852 (big blind) folded before Flop
Seat 4: f4a6a825 collected ($0.25)
Seat 5: 7829feb5 folded before Flop (didn't bet)
Seat 6: Hero folded before Flop (didn't bet)


Poker Hand #RC3141672592: Hold'em No Limit ($0.05/$0.1) - 2024/12/12 12:56:14
Table 'RushAndCash22317852' 6-max Seat #1 is the button
Seat 1: Hero ($10.1 in chips)
Seat 2: 79af8002 ($10.05 in chips)
Seat 3: 4f76bae1 ($10.78 in chips)
Seat 4: 95a503e1 ($16.84 in chips)
Seat 5: a6717311 ($22.73 in chips)
Seat 6: 9c716b19 ($25.2 in chips)
79af8002: posts small blind $0.05
4f76bae1: posts big blind $0.1
*** HOLE CARDS ***
Dealt to Hero [5c Kd]
Dealt to 79af8002 
Dealt to 4f76bae1 
Dealt to 95a503e1 
Dealt to a6717311 
Dealt to 9c716b19 
95a503e1: folds
a6717311: folds
9c716b19: folds
Hero: folds
79af8002: raises $0.2 to $0.3
4f76bae1: calls $0.2
*** FLOP *** [6c 8h 9d]
79af8002: checks
4f76bae1: bets $0.27
79af8002: raises $1.73 to $2
4f76bae1: folds
Uncalled bet ($1.73) returned to 79af8002
*** SHOWDOWN ***
79af8002 collected $1.09 from pot
*** SUMMARY ***
Total pot $1.14 | Rake $0.05 | Jackpot $0 | Bingo $0 | Fortune $0 | Tax $0
Board [6c 8h 9d]
Seat 1: Hero (button) folded before Flop (didn't bet)
Seat 2: 79af8002 (small blind) won ($1.09)
Seat 3: 4f76bae1 (big blind) folded on the Flop
Seat 4: 95a503e1 folded before Flop (didn't bet)
Seat 5: a6717311 folded before Flop (didn't bet)
Seat 6: 9c716b19 folded before Flop (didn't bet)


Poker Hand #RC3141672534: Hold'em No Limit ($0.05/$0.1) - 2024/12/12 12:55:58
Table 'RushAndCash22317794' 6-max Seat #1 is the button
Seat 1: b2132e5f ($14.52 in chips)
Seat 2: Hero ($10 in chips)
Seat 3: e0a099ae ($11.5 in chips)
Seat 4: f9bba8ef ($10 in chips)
Seat 5: 4740c06b ($16.66 in chips)
Seat 6: f383ae87 ($23.96 in chips)
Hero: posts small blind $0.05
e0a099ae: posts big blind $0.1
*** HOLE CARDS ***
Dealt to b2132e5f 
Dealt to Hero [7d Kd]
Dealt to e0a099ae 
Dealt to f9bba8ef 
Dealt to 4740c06b 
Dealt to f383ae87 
f9bba8ef: folds
4740c06b: folds
f383ae87: folds
b2132e5f: folds
Hero: raises $0.2 to $0.3
e0a099ae: folds
Uncalled bet ($0.2) returned to Hero
*** SHOWDOWN ***
Hero collected $0.2 from pot
*** SUMMARY ***
Total pot $0.2 | Rake $0 | Jackpot $0 | Bingo $0 | Fortune $0 | Tax $0
Seat 1: b2132e5f (button) folded before Flop (didn't bet)
Seat 2: Hero (small blind) collected ($0.2)
Seat 3: e0a099ae (big blind) folded before Flop
Seat 4: f9bba8ef folded before Flop (didn't bet)
Seat 5: 4740c06b folded before Flop (didn't bet)
Seat 6: f383ae87 folded before Flop (didn't bet)


Poker Hand #RC3141672518: Hold'em No Limit ($0.05/$0.1) - 2024/12/12 12:55:55
Table 'RushAndCash22317778' 6-max Seat #1 is the button
Seat 1: 4740c06b ($16.66 in chips)
Seat 2: c5141ec9 ($12.85 in chips)
Seat 3: d827b781 ($12.55 in chips)
Seat 4: f9bba8ef ($10 in chips)
Seat 5: Hero ($10 in chips)
Seat 6: 1dc50d10 ($10 in chips)
c5141ec9: posts small blind $0.05
d827b781: posts big blind $0.1
*** HOLE CARDS ***
Dealt to 4740c06b 
Dealt to c5141ec9 
Dealt to d827b781 
Dealt to f9bba8ef 
Dealt to Hero [8d 2c]
Dealt to 1dc50d10 
f9bba8ef: folds
Hero: folds
1dc50d10: folds
4740c06b: folds
c5141ec9: folds
Uncalled bet ($0.05) returned to d827b781
*** SHOWDOWN ***
d827b781 collected $0.1 from pot
*** SUMMARY ***
Total pot $0.1 | Rake $0 | Jackpot $0 | Bingo $0 | Fortune $0 | Tax $0
Seat 1: 4740c06b (button) folded before Flop (didn't bet)
Seat 2: c5141ec9 (small blind) folded before Flop
Seat 3: d827b781 (big blind) collected ($0.1)
Seat 4: f9bba8ef folded before Flop (didn't bet)
Seat 5: Hero folded before Flop (didn't bet)
Seat 6: 1dc50d10 folded before Flop (didn't bet)


Poker Hand #RC3141672437: Hold'em No Limit ($0.05/$0.1) - 2024/12/12 12:55:34
Table 'RushAndCash22317697' 6-max Seat #1 is the button
Seat 1: 1e25b5bb ($17.69 in chips)
Seat 2: b82279c3 ($43.66 in chips)
Seat 3: Hero ($10 in chips)
Seat 4: a2fc0fa3 ($10 in chips)
Seat 5: 74b4c8de ($14.92 in chips)
Seat 6: cf64da1a ($20.8 in chips)
b82279c3: posts small blind $0.05
Hero: posts big blind $0.1
*** HOLE CARDS ***
Dealt to 1e25b5bb 
Dealt to b82279c3 
Dealt to Hero [Qd Kc]
Dealt to a2fc0fa3 
Dealt to 74b4c8de 
Dealt to cf64da1a 
a2fc0fa3: folds
74b4c8de: folds
cf64da1a: folds
1e25b5bb: folds
b82279c3: raises $0.15 to $0.25
Hero: calls $0.15
*** FLOP *** [4d Js 6h]
b82279c3: bets $0.2
Hero: folds
Uncalled bet ($0.2) returned to b82279c3
*** SHOWDOWN ***
b82279c3 collected $0.48 from pot
*** SUMMARY ***
Total pot $0.5 | Rake $0.02 | Jackpot $0 | Bingo $0 | Fortune $0 | Tax $0
Board [4d Js 6h]
Seat 1: 1e25b5bb (button) folded before Flop (didn't bet)
Seat 2: b82279c3 (small blind) won ($0.48)
Seat 3: Hero (big blind) folded on the Flop
Seat 4: a2fc0fa3 folded before Flop (didn't bet)
Seat 5: 74b4c8de folded before Flop (didn't bet)
Seat 6: cf64da1a folded before Flop (didn't bet)


Poker Hand #RC3141672425: Hold'em No Limit ($0.05/$0.1) - 2024/12/12 12:55:30
Table 'RushAndCash22317685' 6-max Seat #1 is the button
Seat 1: f1e9bea0 ($37.36 in chips)
Seat 2: 44a078c0 ($12.9 in chips)
Seat 3: d92455c8 ($10.09 in chips)
Seat 4: f3cd242a ($16.73 in chips)
Seat 5: 3cdac696 ($9.4 in chips)
Seat 6: Hero ($10 in chips)
44a078c0: posts small blind $0.05
d92455c8: posts big blind $0.1
*** HOLE CARDS ***
Dealt to f1e9bea0 
Dealt to 44a078c0 
Dealt to d92455c8 
Dealt to f3cd242a 
Dealt to 3cdac696 
Dealt to Hero [2c 4h]
f3cd242a: folds
3cdac696: calls $0.1
Hero: folds
f1e9bea0: folds
44a078c0: folds
d92455c8: checks
*** FLOP *** [3d 9d Kc]
d92455c8: checks
3cdac696: checks
*** TURN *** [3d 9d Kc] [Th]
d92455c8: checks
3cdac696: bets $0.25
d92455c8: folds
Uncalled bet ($0.25) returned to 3cdac696
*** SHOWDOWN ***
3cdac696 collected $0.24 from pot
*** SUMMARY ***
Total pot $0.25 | Rake $0.01 | Jackpot $0 | Bingo $0 | Fortune $0 | Tax $0
Board [3d 9d Kc Th]
Seat 1: f1e9bea0 (button) folded before Flop (didn't bet)
Seat 2: 44a078c0 (small blind) folded before Flop
Seat 3: d92455c8 (big blind) folded on the Turn
Seat 4: f3cd242a folded before Flop (didn't bet)
Seat 5: 3cdac696 won ($0.24)
Seat 6: Hero folded before Flop (didn't bet)


Poker Hand #RC3141672412: Hold'em No Limit ($0.05/$0.1) - 2024/12/12 12:55:27
Table 'RushAndCash22317672' 6-max Seat #1 is the button
Seat 1: 1aa8c909 ($10.66 in chips)
Seat 2: f3cd242a ($16.78 in chips)
Seat 3: c2b852ae ($10.03 in chips)
Seat 4: Hero ($10 in chips)
Seat 5: 2fb13304 ($11.07 in chips)
Seat 6: 44a078c0 ($12.9 in chips)
f3cd242a: posts small blind $0.05
c2b852ae: posts big blind $0.1
*** HOLE CARDS ***
Dealt to 1aa8c909 
Dealt to f3cd242a 
Dealt to c2b852ae 
Dealt to Hero [5c 4d]
Dealt to 2fb13304 
Dealt to 44a078c0 
Hero: folds
2fb13304: folds
44a078c0: folds
1aa8c909: folds
f3cd242a: folds
Uncalled bet ($0.05) returned to c2b852ae
*** SHOWDOWN ***
c2b852ae collected $0.1 from pot
*** SUMMARY ***
Total pot $0.1 | Rake $0 | Jackpot $0 | Bingo $0 | Fortune $0 | Tax $0
Seat 1: 1aa8c909 (button) folded before Flop (didn't bet)
Seat 2: f3cd242a (small blind) folded before Flop
Seat 3: c2b852ae (big blind) collected ($0.1)
Seat 4: Hero folded before Flop (didn't bet)
Seat 5: 2fb13304 folded before Flop (didn't bet)
Seat 6: 44a078c0 folded before Flop (didn't bet)


Poker Hand #RC3141672398: Hold'em No Limit ($0.05/$0.1) - 2024/12/12 12:55:23
Table 'RushAndCash22317658' 6-max Seat #1 is the button
Seat 1: d6974a94 ($28.72 in chips)
Seat 2: ead6156b ($7.87 in chips)
Seat 3: 2e735933 ($15.19 in chips)
Seat 4: Hero ($10 in chips)
Seat 5: ead05d7d ($12.74 in chips)
Seat 6: ab081f1e ($10.15 in chips)
ead6156b: posts small blind $0.05
2e735933: posts big blind $0.1
*** HOLE CARDS ***
Dealt to d6974a94 
Dealt to ead6156b 
Dealt to 2e735933 
Dealt to Hero [7s 9h]
Dealt to ead05d7d 
Dealt to ab081f1e 
Hero: folds
ead05d7d: folds
ab081f1e: folds
d6974a94: raises $0.11 to $0.21
ead6156b: folds
2e735933: folds
Uncalled bet ($0.11) returned to d6974a94
*** SHOWDOWN ***
d6974a94 collected $0.25 from pot
*** SUMMARY ***
Total pot $0.25 | Rake $0 | Jackpot $0 | Bingo $0 | Fortune $0 | Tax $0
Seat 1: d6974a94 (button) collected ($0.25)
Seat 2: ead6156b (small blind) folded before Flop
Seat 3: 2e735933 (big blind) folded before Flop
Seat 4: Hero folded before Flop (didn't bet)
Seat 5: ead05d7d folded before Flop (didn't bet)
Seat 6: ab081f1e folded before Flop (didn't bet)


Poker Hand #RC3141672384: Hold'em No Limit ($0.05/$0.1) - 2024/12/12 12:55:20
Table 'RushAndCash22317644' 6-max Seat #1 is the button
Seat 1: Hero ($10 in chips)
Seat 2: 1e25b5bb ($17.84 in chips)
Seat 3: fed66cf6 ($10.1 in chips)
Seat 4: ff1406c1 ($12.39 in chips)
Seat 5: ab081f1e ($10.15 in chips)
Seat 6: 73d90cc7 ($12.9 in chips)
1e25b5bb: posts small blind $0.05
fed66cf6: posts big blind $0.1
*** HOLE CARDS ***
Dealt to Hero [4h 7c]
Dealt to 1e25b5bb 
Dealt to fed66cf6 
Dealt to ff1406c1 
Dealt to ab081f1e 
Dealt to 73d90cc7 
ff1406c1: folds
ab081f1e: folds
73d90cc7: folds
Hero: folds
1e25b5bb: folds
Uncalled bet ($0.05) returned to fed66cf6
*** SHOWDOWN ***
fed66cf6 collected $0.1 from pot
*** SUMMARY ***
Total pot $0.1 | Rake $0 | Jackpot $0 | Bingo $0 | Fortune $0 | Tax $0
Seat 1: Hero (button) folded before Flop (didn't bet)
Seat 2: 1e25b5bb (small blind) folded before Flop
Seat 3: fed66cf6 (big blind) collected ($0.1)
Seat 4: ff1406c1 folded before Flop (didn't bet)
Seat 5: ab081f1e folded before Flop (didn't bet)
Seat 6: 73d90cc7 folded before Flop (didn't bet)


Poker Hand #RC3141672363: Hold'em No Limit ($0.05/$0.1) - 2024/12/12 12:55:15
Table 'RushAndCash22317623' 6-max Seat #1 is the button
Seat 1: 204f692c ($10 in chips)
Seat 2: Hero ($10 in chips)
Seat 3: ead6156b ($7.97 in chips)
Seat 4: d6b17ac7 ($12.14 in chips)
Seat 5: 6904b57e ($10 in chips)
Seat 6: dea1301e ($24.52 in chips)
Hero: posts small blind $0.05
ead6156b: posts big blind $0.1
*** HOLE CARDS ***
Dealt to 204f692c 
Dealt to Hero [5h Ts]
Dealt to ead6156b 
Dealt to d6b17ac7 
Dealt to 6904b57e 
Dealt to dea1301e 
d6b17ac7: folds
6904b57e: raises $0.15 to $0.25
dea1301e: folds
204f692c: folds
Hero: folds
ead6156b: folds
Uncalled bet ($0.15) returned to 6904b57e
*** SHOWDOWN ***
6904b57e collected $0.25 from pot
*** SUMMARY ***
Total pot $0.25 | Rake $0 | Jackpot $0 | Bingo $0 | Fortune $0 | Tax $0
Seat 1: 204f692c (button) folded before Flop (didn't bet)
Seat 2: Hero (small blind) folded before Flop
Seat 3: ead6156b (big blind) folded before Flop
Seat 4: d6b17ac7 folded before Flop (didn't bet)
Seat 5: 6904b57e collected ($0.25)
Seat 6: dea1301e folded before Flop (didn't bet)


Poker Hand #RC3141672329: Hold'em No Limit ($0.05/$0.1) - 2024/12/12 12:55:06
Table 'RushAndCash22317589' 6-max Seat #1 is the button
Seat 1: c8c2a1e ($10.86 in chips)
Seat 2: 208ee152 ($14.87 in chips)
Seat 3: Hero ($10.09 in chips)
Seat 4: 36e85ed3 ($10.15 in chips)
Seat 5: dbcd9107 ($20.21 in chips)
Seat 6: fed66cf6 ($10.15 in chips)
208ee152: posts small blind $0.05
Hero: posts big blind $0.1
*** HOLE CARDS ***
Dealt to c8c2a1e 
Dealt to 208ee152 
Dealt to Hero [5s Jc]
Dealt to 36e85ed3 
Dealt to dbcd9107 
Dealt to fed66cf6 
36e85ed3: folds
dbcd9107: folds
fed66cf6: folds
c8c2a1e: folds
208ee152: raises $0.1 to $0.2
Hero: folds
Uncalled bet ($0.1) returned to 208ee152
*** SHOWDOWN ***
208ee152 collected $0.2 from pot
*** SUMMARY ***
Total pot $0.2 | Rake $0 | Jackpot $0 | Bingo $0 | Fortune $0 | Tax $0
Seat 1: c8c2a1e (button) folded before Flop (didn't bet)
Seat 2: 208ee152 (small blind) collected ($0.2)
Seat 3: Hero (big blind) folded before Flop
Seat 4: 36e85ed3 folded before Flop (didn't bet)
Seat 5: dbcd9107 folded before Flop (didn't bet)
Seat 6: fed66cf6 folded before Flop (didn't bet)


Poker Hand #RC3141672314: Hold'em No Limit ($0.05/$0.1) - 2024/12/12 12:55:03
Table 'RushAndCash22317574' 6-max Seat #1 is the button
Seat 1: 1e0385e8 ($10 in chips)
Seat 2: ec7ff353 ($10.15 in chips)
Seat 3: e4fc8b12 ($11.46 in chips)
Seat 4: ff1406c1 ($12.14 in chips)
Seat 5: Hero ($10.09 in chips)
Seat 6: cc63da9c ($18.41 in chips)
ec7ff353: posts small blind $0.05
e4fc8b12: posts big blind $0.1
*** HOLE CARDS ***
Dealt to 1e0385e8 
Dealt to ec7ff353 
Dealt to e4fc8b12 
Dealt to ff1406c1 
Dealt to Hero [9s 6h]
Dealt to cc63da9c 
ff1406c1: raises $0.1 to $0.2
Hero: folds
cc63da9c: folds
1e0385e8: folds
ec7ff353: folds
e4fc8b12: folds
Uncalled bet ($0.1) returned to ff1406c1
*** SHOWDOWN ***
ff1406c1 collected $0.25 from pot
*** SUMMARY ***
Total pot $0.25 | Rake $0 | Jackpot $0 | Bingo $0 | Fortune $0 | Tax $0
Seat 1: 1e0385e8 (button) folded before Flop (didn't bet)
Seat 2: ec7ff353 (small blind) folded before Flop
Seat 3: e4fc8b12 (big blind) folded before Flop
Seat 4: ff1406c1 collected ($0.25)
Seat 5: Hero folded before Flop (didn't bet)
Seat 6: cc63da9c folded before Flop (didn't bet)


Poker Hand #RC3141672299: Hold'em No Limit ($0.05/$0.1) - 2024/12/12 12:55:00
Table 'RushAndCash22317559' 6-max Seat #1 is the button
Seat 1: 38fd477d ($10.43 in chips)
Seat 2: 1e0385e8 ($10 in chips)
Seat 3: ff1406c1 ($12.24 in chips)
Seat 4: Hero ($10.09 in chips)
Seat 5: ff98cbcb ($23.67 in chips)
Seat 6: e4fc8b12 ($11.46 in chips)
1e0385e8: posts small blind $0.05
ff1406c1: posts big blind $0.1
*** HOLE CARDS ***
Dealt to 38fd477d 
Dealt to 1e0385e8 
Dealt to ff1406c1 
Dealt to Hero [Qh 8c]
Dealt to ff98cbcb 
Dealt to e4fc8b12 
Hero: folds
ff98cbcb: folds
e4fc8b12: folds
38fd477d: folds
1e0385e8: folds
Uncalled bet ($0.05) returned to ff1406c1
*** SHOWDOWN ***
ff1406c1 collected $0.1 from pot
*** SUMMARY ***
Total pot $0.1 | Rake $0 | Jackpot $0 | Bingo $0 | Fortune $0 | Tax $0
Seat 1: 38fd477d (button) folded before Flop (didn't bet)
Seat 2: 1e0385e8 (small blind) folded before Flop
Seat 3: ff1406c1 (big blind) collected ($0.1)
Seat 4: Hero folded before Flop (didn't bet)
Seat 5: ff98cbcb folded before Flop (didn't bet)
Seat 6: e4fc8b12 folded before Flop (didn't bet)


Poker Hand #RC3141672268: Hold'em No Limit ($0.05/$0.1) - 2024/12/12 12:54:53
Table 'RushAndCash22317528' 6-max Seat #1 is the button
Seat 1: 23d20ac6 ($14.76 in chips)
Seat 2: Hero ($10.14 in chips)
Seat 3: d09451f5 ($12.95 in chips)
Seat 4: a9eb45fc ($11.28 in chips)
Seat 5: d1122f42 ($10.21 in chips)
Seat 6: 41ad32d3 ($20.82 in chips)
Hero: posts small blind $0.05
d09451f5: posts big blind $0.1
*** HOLE CARDS ***
Dealt to 23d20ac6 
Dealt to Hero [2d 3h]
Dealt to d09451f5 
Dealt to a9eb45fc 
Dealt to d1122f42 
Dealt to 41ad32d3 
a9eb45fc: raises $0.1 to $0.2
d1122f42: folds
41ad32d3: folds
23d20ac6: folds
Hero: folds
d09451f5: folds
Uncalled bet ($0.1) returned to a9eb45fc
*** SHOWDOWN ***
a9eb45fc collected $0.25 from pot
*** SUMMARY ***
Total pot $0.25 | Rake $0 | Jackpot $0 | Bingo $0 | Fortune $0 | Tax $0
Seat 1: 23d20ac6 (button) folded before Flop (didn't bet)
Seat 2: Hero (small blind) folded before Flop
Seat 3: d09451f5 (big blind) folded before Flop
Seat 4: a9eb45fc collected ($0.25)
Seat 5: d1122f42 folded before Flop (didn't bet)
Seat 6: 41ad32d3 folded before Flop (didn't bet)


Poker Hand #RC3141672223: Hold'em No Limit ($0.05/$0.1) - 2024/12/12 12:54:41
Table 'RushAndCash22317483' 6-max Seat #1 is the button
Seat 1: a3382d82 ($18.91 in chips)
Seat 2: 1d8dcfab ($47.43 in chips)
Seat 3: Hero ($10.24 in chips)
Seat 4: 2ff0a04b ($48.69 in chips)
Seat 5: d037fd58 ($13.96 in chips)
Seat 6: 7ee23c5e ($10.43 in chips)
1d8dcfab: posts small blind $0.05
Hero: posts big blind $0.1
*** HOLE CARDS ***
Dealt to a3382d82 
Dealt to 1d8dcfab 
Dealt to Hero [5d 5h]
Dealt to 2ff0a04b 
Dealt to d037fd58 
Dealt to 7ee23c5e 
2ff0a04b: raises $0.11 to $0.21
d037fd58: folds
7ee23c5e: folds
a3382d82: raises $0.43 to $0.64
1d8dcfab: calls $0.59
Hero: folds
2ff0a04b: calls $0.43
*** FLOP *** [Qh 8s 8d]
1d8dcfab: checks
2ff0a04b: checks
a3382d82: bets $0.67
1d8dcfab: folds
2ff0a04b: calls $0.67
*** TURN *** [Qh 8s 8d] [2s]
2ff0a04b: checks
a3382d82: bets $1.11
2ff0a04b: calls $1.11
*** RIVER *** [Qh 8s 8d 2s] [2h]
2ff0a04b: checks
a3382d82: bets $5.58
2ff0a04b: folds
Uncalled bet ($5.58) returned to a3382d82
*** SHOWDOWN ***
a3382d82 collected $5.16 from pot
*** SUMMARY ***
Total pot $5.58 | Rake $0.27 | Jackpot $0.15 | Bingo $0 | Fortune $0 | Tax $0
Board [Qh 8s 8d 2s 2h]
Seat 1: a3382d82 (button) won ($5.16)
Seat 2: 1d8dcfab (small blind) folded on the Flop
Seat 3: Hero (big blind) folded before Flop
Seat 4: 2ff0a04b folded on the River
Seat 5: d037fd58 folded before Flop (didn't bet)
Seat 6: 7ee23c5e folded before Flop (didn't bet)


Poker Hand #RC3141671998: Hold'em No Limit ($0.05/$0.1) - 2024/12/12 12:53:43
Table 'RushAndCash22317258' 6-max Seat #1 is the button
Seat 1: Hero ($10.34 in chips)
Seat 2: 9c1507dc ($10 in chips)
Seat 3: f879c2d8 ($12.44 in chips)
Seat 4: f3cd242a ($18.01 in chips)
Seat 5: a1f416c7 ($14.59 in chips)
Seat 6: 73d90cc7 ($10.7 in chips)
Cash Drop to Pot : total $1 
9c1507dc: posts small blind $0.05
f879c2d8: posts big blind $0.1
*** HOLE CARDS ***
Dealt to Hero [9s Qd]
Dealt to 9c1507dc 
Dealt to f879c2d8 
Dealt to f3cd242a 
Dealt to a1f416c7 
Dealt to 73d90cc7 
f3cd242a: calls $0.1
a1f416c7: folds
73d90cc7: calls $0.1
Hero: calls $0.1
9c1507dc: calls $0.05
f879c2d8: checks
*** FLOP *** [9h Jc 7h]
9c1507dc: checks
f879c2d8: checks
f3cd242a: bets $1.13
73d90cc7: calls $1.13
Hero: folds
9c1507dc: folds
f879c2d8: folds
*** TURN *** [9h Jc 7h] [2h]
f3cd242a: checks
73d90cc7: bets $9.47 and is all-in
f3cd242a: folds
Uncalled bet ($9.47) returned to 73d90cc7
*** SHOWDOWN ***
73d90cc7 collected $3.43 from pot
*** SUMMARY ***
Total pot $3.76 | Rake $0.18 | Jackpot $0.15 | Bingo $0 | Fortune $0 | Tax $0
Board [9h Jc 7h 2h]
Seat 1: Hero (button) folded on the Flop
Seat 2: 9c1507dc (small blind) folded on the Flop
Seat 3: f879c2d8 (big blind) folded on the Flop
Seat 4: f3cd242a folded on the Turn
Seat 5: a1f416c7 folded before Flop (didn't bet)
Seat 6: 73d90cc7 won ($3.43)


Poker Hand #RC3141671984: Hold'em No Limit ($0.05/$0.1) - 2024/12/12 12:53:40
Table 'RushAndCash22317244' 6-max Seat #1 is the button
Seat 1: 4c96024a ($10.15 in chips)
Seat 2: 7bad2adb ($10 in chips)
Seat 3: ca4fa05a ($8.1 in chips)
Seat 4: 73d90cc7 ($10.7 in chips)
Seat 5: Hero ($10.34 in chips)
Seat 6: 4bddf600 ($10.7 in chips)
7bad2adb: posts small blind $0.05
ca4fa05a: posts big blind $0.1
*** HOLE CARDS ***
Dealt to 4c96024a 
Dealt to 7bad2adb 
Dealt to ca4fa05a 
Dealt to 73d90cc7 
Dealt to Hero [4h 3d]
Dealt to 4bddf600 
73d90cc7: folds
Hero: folds
4bddf600: raises $0.12 to $0.22
4c96024a: raises $0.48 to $0.7
7bad2adb: folds
ca4fa05a: folds
4bddf600: calls $0.48
*** FLOP *** [2c 2h 5h]
4bddf600: checks
4c96024a: bets $1.1
4bddf600: calls $1.1
*** TURN *** [2c 2h 5h] [5c]
4bddf600: checks
4c96024a: checks
*** RIVER *** [2c 2h 5h 5c] [As]
4bddf600: bets $2.82
4c96024a: calls $2.82
4bddf600: shows [Th Jh] (Pair of Fives and Pair of Twos)
4c96024a: shows [Ac Td] (Pair of Aces and Pair of Fives)
*** SHOWDOWN ***
4c96024a collected $8.94 from pot
*** SUMMARY ***
Total pot $9.39 | Rake $0.3 | Jackpot $0.15 | Bingo $0 | Fortune $0 | Tax $0
Board [2c 2h 5h 5c As]
Seat 1: 4c96024a (button) showed [Ac Td] and won ($8.94) with Pair of Aces and Pair of Fives
Seat 2: 7bad2adb (small blind) folded before Flop
Seat 3: ca4fa05a (big blind) folded before Flop
Seat 4: 73d90cc7 folded before Flop (didn't bet)
Seat 5: Hero folded before Flop (didn't bet)
Seat 6: 4bddf600 showed [Th Jh] and lost with Pair of Fives and Pair of Twos


Poker Hand #RC3141671891: Hold'em No Limit ($0.05/$0.1) - 2024/12/12 12:53:15
Table 'RushAndCash22317151' 6-max Seat #1 is the button
Seat 1: 73d90cc7 ($10.37 in chips)
Seat 2: 111c75 ($10 in chips)
Seat 3: 26077f2f ($10.33 in chips)
Seat 4: 5c1d4f73 ($11.71 in chips)
Seat 5: Hero ($10.54 in chips)
Seat 6: 37686872 ($15.9 in chips)
111c75: posts small blind $0.05
26077f2f: posts big blind $0.1
*** HOLE CARDS ***
Dealt to 73d90cc7 
Dealt to 111c75 
Dealt to 26077f2f 
Dealt to 5c1d4f73 
Dealt to Hero [8c 8s]
Dealt to 37686872 
5c1d4f73: folds
Hero: raises $0.1 to $0.2
37686872: folds
73d90cc7: raises $0.5 to $0.7
111c75: folds
26077f2f: folds
Hero: folds
Uncalled bet ($0.5) returned to 73d90cc7
*** SHOWDOWN ***
73d90cc7 collected $0.53 from pot
*** SUMMARY ***
Total pot $0.55 | Rake $0.02 | Jackpot $0 | Bingo $0 | Fortune $0 | Tax $0
Seat 1: 73d90cc7 (button) collected ($0.53)
Seat 2: 111c75 (small blind) folded before Flop
Seat 3: 26077f2f (big blind) folded before Flop
Seat 4: 5c1d4f73 folded before Flop (didn't bet)
Seat 5: Hero folded before Flop
Seat 6: 37686872 folded before Flop (didn't bet)


Poker Hand #RC3141671877: Hold'em No Limit ($0.05/$0.1) - 2024/12/12 12:53:12
Table 'RushAndCash22317137' 6-max Seat #1 is the button
Seat 1: a47e8f5 ($12.38 in chips)
Seat 2: 1677a3f4 ($11.84 in chips)
Seat 3: dea1301e ($25.52 in chips)
Seat 4: Hero ($10.54 in chips)
Seat 5: 4898aa10 ($28.45 in chips)
Seat 6: 719fb29e ($13.82 in chips)
1677a3f4: posts small blind $0.05
dea1301e: posts big blind $0.1
*** HOLE CARDS ***
Dealt to a47e8f5 
Dealt to 1677a3f4 
Dealt to dea1301e 
Dealt to Hero [8s Ad]
Dealt to 4898aa10 
Dealt to 719fb29e 
Hero: folds
4898aa10: raises $0.1 to $0.2
719fb29e: folds
a47e8f5: folds
1677a3f4: folds
dea1301e: folds
Uncalled bet ($0.1) returned to 4898aa10
*** SHOWDOWN ***
4898aa10 collected $0.25 from pot
*** SUMMARY ***
Total pot $0.25 | Rake $0 | Jackpot $0 | Bingo $0 | Fortune $0 | Tax $0
Seat 1: a47e8f5 (button) folded before Flop (didn't bet)
Seat 2: 1677a3f4 (small blind) folded before Flop
Seat 3: dea1301e (big blind) folded before Flop
Seat 4: Hero folded before Flop (didn't bet)
Seat 5: 4898aa10 collected ($0.25)
Seat 6: 719fb29e folded before Flop (didn't bet)


Poker Hand #RC3141671863: Hold'em No Limit ($0.05/$0.1) - 2024/12/12 12:53:08
Table 'RushAndCash22317123' 6-max Seat #1 is the button
Seat 1: b9463896 ($10.33 in chips)
Seat 2: cacc74b2 ($12.2 in chips)
Seat 3: 1c087ec5 ($40.55 in chips)
Seat 4: cfe70ef2 ($10.38 in chips)
Seat 5: 11a00985 ($20.53 in chips)
Seat 6: Hero ($10.54 in chips)
cacc74b2: posts small blind $0.05
1c087ec5: posts big blind $0.1
*** HOLE CARDS ***
Dealt to b9463896 
Dealt to cacc74b2 
Dealt to 1c087ec5 
Dealt to cfe70ef2 
Dealt to 11a00985 
Dealt to Hero [Th 6s]
cfe70ef2: raises $0.1 to $0.2
11a00985: raises $0.46 to $0.66
Hero: folds
b9463896: folds
cacc74b2: folds
1c087ec5: folds
cfe70ef2: folds
Uncalled bet ($0.46) returned to 11a00985
*** SHOWDOWN ***
11a00985 collected $0.53 from pot
*** SUMMARY ***
Total pot $0.55 | Rake $0.02 | Jackpot $0 | Bingo $0 | Fortune $0 | Tax $0
Seat 1: b9463896 (button) folded before Flop (didn't bet)
Seat 2: cacc74b2 (small blind) folded before Flop
Seat 3: 1c087ec5 (big blind) folded before Flop
Seat 4: cfe70ef2 folded before Flop
Seat 5: 11a00985 collected ($0.53)
Seat 6: Hero folded before Flop (didn't bet)


Poker Hand #RC3141671839: Hold'em No Limit ($0.05/$0.1) - 2024/12/12 12:53:02
Table 'RushAndCash22317099' 6-max Seat #1 is the button
Seat 1: c6352e1c ($10.72 in chips)
Seat 2: d827b781 ($13.92 in chips)
Seat 3: ead6156b ($7.16 in chips)
Seat 4: Hero ($10.54 in chips)
Seat 5: fd36d45d ($10.15 in chips)
Seat 6: be885022 ($12.97 in chips)
d827b781: posts small blind $0.05
ead6156b: posts big blind $0.1
*** HOLE CARDS ***
Dealt to c6352e1c 
Dealt to d827b781 
Dealt to ead6156b 
Dealt to Hero [7s Ah]
Dealt to fd36d45d 
Dealt to be885022 
Hero: folds
fd36d45d: folds
be885022: folds
c6352e1c: raises $0.1 to $0.2
d827b781: folds
ead6156b: folds
Uncalled bet ($0.1) returned to c6352e1c
*** SHOWDOWN ***
c6352e1c collected $0.25 from pot
*** SUMMARY ***
Total pot $0.25 | Rake $0 | Jackpot $0 | Bingo $0 | Fortune $0 | Tax $0
Seat 1: c6352e1c (button) collected ($0.25)
Seat 2: d827b781 (small blind) folded before Flop
Seat 3: ead6156b (big blind) folded before Flop
Seat 4: Hero folded before Flop (didn't bet)
Seat 5: fd36d45d folded before Flop (didn't bet)
Seat 6: be885022 folded before Flop (didn't bet)


Poker Hand #RC3141671786: Hold'em No Limit ($0.05/$0.1) - 2024/12/12 12:52:49
Table 'RushAndCash22317046' 6-max Seat #1 is the button
Seat 1: 54a8e111 ($10.88 in chips)
Seat 2: Hero ($10.59 in chips)
Seat 3: 4de3c51 ($10 in chips)
Seat 4: c570720c ($14.69 in chips)
Seat 5: c6352e1c ($10.72 in chips)
Seat 6: f2ece23 ($14.23 in chips)
Hero: posts small blind $0.05
4de3c51: posts big blind $0.1
*** HOLE CARDS ***
Dealt to 54a8e111 
Dealt to Hero [Ad 8s]
Dealt to 4de3c51 
Dealt to c570720c 
Dealt to c6352e1c 
Dealt to f2ece23 
c570720c: raises $0.2 to $0.3
c6352e1c: folds
f2ece23: folds
54a8e111: folds
Hero: folds
4de3c51: folds
Uncalled bet ($0.2) returned to c570720c
*** SHOWDOWN ***
c570720c collected $0.25 from pot
*** SUMMARY ***
Total pot $0.25 | Rake $0 | Jackpot $0 | Bingo $0 | Fortune $0 | Tax $0
Seat 1: 54a8e111 (button) folded before Flop (didn't bet)
Seat 2: Hero (small blind) folded before Flop
Seat 3: 4de3c51 (big blind) folded before Flop
Seat 4: c570720c collected ($0.25)
Seat 5: c6352e1c folded before Flop (didn't bet)
Seat 6: f2ece23 folded before Flop (didn't bet)


Poker Hand #RC3141671768: Hold'em No Limit ($0.05/$0.1) - 2024/12/12 12:52:43
Table 'RushAndCash22317028' 6-max Seat #1 is the button
Seat 1: d6974a94 ($29.44 in chips)
Seat 2: bc8cb2ed ($7.35 in chips)
Seat 3: Hero ($10.69 in chips)
Seat 4: 9ef3daf1 ($14.72 in chips)
Seat 5: 4c96024a ($10 in chips)
Seat 6: 8424fd65 ($15.52 in chips)
bc8cb2ed: posts small blind $0.05
Hero: posts big blind $0.1
*** HOLE CARDS ***
Dealt to d6974a94 
Dealt to bc8cb2ed 
Dealt to Hero [3d 8c]
Dealt to 9ef3daf1 
Dealt to 4c96024a 
Dealt to 8424fd65 
9ef3daf1: raises $0.1 to $0.2
4c96024a: folds
8424fd65: raises $0.6 to $0.8
d6974a94: folds
bc8cb2ed: folds
Hero: folds
9ef3daf1: folds
Uncalled bet ($0.6) returned to 8424fd65
*** SHOWDOWN ***
8424fd65 collected $0.53 from pot
*** SUMMARY ***
Total pot $0.55 | Rake $0.02 | Jackpot $0 | Bingo $0 | Fortune $0 | Tax $0
Seat 1: d6974a94 (button) folded before Flop (didn't bet)
Seat 2: bc8cb2ed (small blind) folded before Flop
Seat 3: Hero (big blind) folded before Flop
Seat 4: 9ef3daf1 folded before Flop
Seat 5: 4c96024a folded before Flop (didn't bet)
Seat 6: 8424fd65 collected ($0.53)


Poker Hand #RC3141671755: Hold'em No Limit ($0.05/$0.1) - 2024/12/12 12:52:40
Table 'RushAndCash22317015' 6-max Seat #1 is the button
Seat 1: Hero ($10.69 in chips)
Seat 2: 73d90cc7 ($10.05 in chips)
Seat 3: 4a1f9c37 ($7.25 in chips)
Seat 4: 81834a2f ($17.55 in chips)
Seat 5: 111c75 ($10.08 in chips)
Seat 6: c4d674fe ($14.03 in chips)
73d90cc7: posts small blind $0.05
4a1f9c37: posts big blind $0.1
*** HOLE CARDS ***
Dealt to Hero [7c Kd]
Dealt to 73d90cc7 
Dealt to 4a1f9c37 
Dealt to 81834a2f 
Dealt to 111c75 
Dealt to c4d674fe 
81834a2f: folds
111c75: raises $0.15 to $0.25
c4d674fe: folds
Hero: folds
73d90cc7: calls $0.2
4a1f9c37: folds
*** FLOP *** [4c Kc Ks]
73d90cc7: bets $0.21
111c75: folds
Uncalled bet ($0.21) returned to 73d90cc7
*** SHOWDOWN ***
73d90cc7 collected $0.57 from pot
*** SUMMARY ***
Total pot $0.6 | Rake $0.03 | Jackpot $0 | Bingo $0 | Fortune $0 | Tax $0
Board [4c Kc Ks]
Seat 1: Hero (button) folded before Flop (didn't bet)
Seat 2: 73d90cc7 (small blind) won ($0.57)
Seat 3: 4a1f9c37 (big blind) folded before Flop
Seat 4: 81834a2f folded before Flop (didn't bet)
Seat 5: 111c75 folded on the Flop
Seat 6: c4d674fe folded before Flop (didn't bet)


Poker Hand #RC3141671741: Hold'em No Limit ($0.05/$0.1) - 2024/12/12 12:52:36
Table 'RushAndCash22317001' 6-max Seat #1 is the button
Seat 1: 7f4b234e ($11.87 in chips)
Seat 2: 8cfa2620 ($22.1 in chips)
Seat 3: b57eea46 ($8.68 in chips)
Seat 4: a47e8f5 ($12.33 in chips)
Seat 5: Hero ($10.69 in chips)
Seat 6: d4deed2f ($10.15 in chips)
8cfa2620: posts small blind $0.05
b57eea46: posts big blind $0.1
*** HOLE CARDS ***
Dealt to 7f4b234e 
Dealt to 8cfa2620 
Dealt to b57eea46 
Dealt to a47e8f5 
Dealt to Hero [Ks 9c]
Dealt to d4deed2f 
a47e8f5: folds
Hero: folds
d4deed2f: folds
7f4b234e: folds
8cfa2620: folds
Uncalled bet ($0.05) returned to b57eea46
*** SHOWDOWN ***
b57eea46 collected $0.1 from pot
*** SUMMARY ***
Total pot $0.1 | Rake $0 | Jackpot $0 | Bingo $0 | Fortune $0 | Tax $0
Seat 1: 7f4b234e (button) folded before Flop (didn't bet)
Seat 2: 8cfa2620 (small blind) folded before Flop
Seat 3: b57eea46 (big blind) collected ($0.1)
Seat 4: a47e8f5 folded before Flop (didn't bet)
Seat 5: Hero folded before Flop (didn't bet)
Seat 6: d4deed2f folded before Flop (didn't bet)


Poker Hand #RC3141671398: Hold'em No Limit ($0.05/$0.1) - 2024/12/12 12:51:07
Table 'RushAndCash22316658' 6-max Seat #1 is the button
Seat 1: d9ccf407 ($12.39 in chips)
Seat 2: 8e0a697 ($12.58 in chips)
Seat 3: 902b9d1a ($9.63 in chips)
Seat 4: Hero ($10 in chips)
Seat 5: bc2007a2 ($18.49 in chips)
Seat 6: 7f4b234e ($12.47 in chips)
8e0a697: posts small blind $0.05
902b9d1a: posts big blind $0.1
*** HOLE CARDS ***
Dealt to d9ccf407 
Dealt to 8e0a697 
Dealt to 902b9d1a 
Dealt to Hero [Jd Jh]
Dealt to bc2007a2 
Dealt to 7f4b234e 
Hero: raises $0.1 to $0.2
bc2007a2: folds
7f4b234e: raises $0.4 to $0.6
d9ccf407: folds
8e0a697: folds
902b9d1a: folds
Hero: calls $0.4
*** FLOP *** [9d Qs Kd]
Hero: checks
7f4b234e: checks
*** TURN *** [9d Qs Kd] [8h]
Hero: checks
7f4b234e: checks
*** RIVER *** [9d Qs Kd 8h] [2s]
Hero: checks
7f4b234e: checks
Hero: shows [Jd Jh] (Pair of Jacks)
7f4b234e: shows [6s 8s] (Pair of Eights)
*** SHOWDOWN ***
Hero collected $1.29 from pot
*** SUMMARY ***
Total pot $1.35 | Rake $0.06 | Jackpot $0 | Bingo $0 | Fortune $0 | Tax $0
Board [9d Qs Kd 8h 2s]
Seat 1: d9ccf407 (button) folded before Flop (didn't bet)
Seat 2: 8e0a697 (small blind) folded before Flop
Seat 3: 902b9d1a (big blind) folded before Flop
Seat 4: Hero showed [Jd Jh] and won ($1.29) with Pair of Jacks
Seat 5: bc2007a2 folded before Flop (didn't bet)
Seat 6: 7f4b234e showed [6s 8s] and lost with Pair of Eights


Poker Hand #RC3141671341: Hold'em No Limit ($0.05/$0.1) - 2024/12/12 12:50:53
Table 'RushAndCash22316601' 6-max Seat #1 is the button
Seat 1: 2ff0a04b ($50.39 in chips)
Seat 2: Hero ($10 in chips)
Seat 3: 3a317c38 ($17.27 in chips)
Seat 4: 8d92b14e ($11.25 in chips)
Seat 5: 4746887d ($20.6 in chips)
Seat 6: 9c1507dc ($10 in chips)
Hero: posts small blind $0.05
3a317c38: posts big blind $0.1
*** HOLE CARDS ***
Dealt to 2ff0a04b 
Dealt to Hero [Ah 8h]
Dealt to 3a317c38 
Dealt to 8d92b14e 
Dealt to 4746887d 
Dealt to 9c1507dc 
8d92b14e: folds
4746887d: folds
9c1507dc: raises $0.15 to $0.25
2ff0a04b: folds
Hero: folds
3a317c38: folds
Uncalled bet ($0.15) returned to 9c1507dc
*** SHOWDOWN ***
9c1507dc collected $0.25 from pot
*** SUMMARY ***
Total pot $0.25 | Rake $0 | Jackpot $0 | Bingo $0 | Fortune $0 | Tax $0
Seat 1: 2ff0a04b (button) folded before Flop (didn't bet)
Seat 2: Hero (small blind) folded before Flop
Seat 3: 3a317c38 (big blind) folded before Flop
Seat 4: 8d92b14e folded before Flop (didn't bet)
Seat 5: 4746887d folded before Flop (didn't bet)
Seat 6: 9c1507dc collected ($0.25)


Poker Hand #RC3141671315: Hold'em No Limit ($0.05/$0.1) - 2024/12/12 12:50:46
Table 'RushAndCash22316575' 6-max Seat #1 is the button
Seat 1: e4fc8b12 ($11.86 in chips)
Seat 2: b0559006 ($9.64 in chips)
Seat 3: Hero ($10 in chips)
Seat 4: 8a55880e ($10.15 in chips)
Seat 5: ead6156b ($7.43 in chips)
Seat 6: 4db3d050 ($6.87 in chips)
b0559006: posts small blind $0.05
Hero: posts big blind $0.1
*** HOLE CARDS ***
Dealt to e4fc8b12 
Dealt to b0559006 
Dealt to Hero [4s 2c]
Dealt to 8a55880e 
Dealt to ead6156b 
Dealt to 4db3d050 
8a55880e: folds
ead6156b: folds
4db3d050: folds
e4fc8b12: raises $0.1 to $0.2
b0559006: folds
Hero: folds
Uncalled bet ($0.1) returned to e4fc8b12
*** SHOWDOWN ***
e4fc8b12 collected $0.25 from pot
*** SUMMARY ***
Total pot $0.25 | Rake $0 | Jackpot $0 | Bingo $0 | Fortune $0 | Tax $0
Seat 1: e4fc8b12 (button) collected ($0.25)
Seat 2: b0559006 (small blind) folded before Flop
Seat 3: Hero (big blind) folded before Flop
Seat 4: 8a55880e folded before Flop (didn't bet)
Seat 5: ead6156b folded before Flop (didn't bet)
Seat 6: 4db3d050 folded before Flop (didn't bet)


Poker Hand #RC3141671303: Hold'em No Limit ($0.05/$0.1) - 2024/12/12 12:50:43
Table 'RushAndCash22316563' 6-max Seat #1 is the button
Seat 1: Hero ($10 in chips)
Seat 2: 2b1a7fe5 ($17.03 in chips)
Seat 3: 647dd971 ($7.94 in chips)
Seat 4: 23d20ac6 ($16.89 in chips)
Seat 5: dd68a104 ($10.42 in chips)
Seat 6: 1c087ec5 ($40.98 in chips)
2b1a7fe5: posts small blind $0.05
647dd971: posts big blind $0.1
*** HOLE CARDS ***
Dealt to Hero [Jd 6c]
Dealt to 2b1a7fe5 
Dealt to 647dd971 
Dealt to 23d20ac6 
Dealt to dd68a104 
Dealt to 1c087ec5 
23d20ac6: raises $0.1 to $0.2
dd68a104: calls $0.2
1c087ec5: folds
Hero: folds
2b1a7fe5: folds
647dd971: folds
*** FLOP *** [8s 7h Th]
23d20ac6: checks
dd68a104: bets $0.42
23d20ac6: calls $0.42
*** TURN *** [8s 7h Th] [8h]
23d20ac6: checks
dd68a104: bets $0.7
23d20ac6: calls $0.7
*** RIVER *** [8s 7h Th 8h] [3s]
23d20ac6: checks
dd68a104: bets $3.39
23d20ac6: folds
Uncalled bet ($3.39) returned to dd68a104
*** SHOWDOWN ***
dd68a104 collected $2.65 from pot
*** SUMMARY ***
Total pot $2.79 | Rake $0.14 | Jackpot $0 | Bingo $0 | Fortune $0 | Tax $0
Board [8s 7h Th 8h 3s]
Seat 1: Hero (button) folded before Flop (didn't bet)
Seat 2: 2b1a7fe5 (small blind) folded before Flop
Seat 3: 647dd971 (big blind) folded before Flop
Seat 4: 23d20ac6 folded on the River
Seat 5: dd68a104 won ($2.65)
Seat 6: 1c087ec5 folded before Flop (didn't bet)


Poker Hand #RC3141671289: Hold'em No Limit ($0.05/$0.1) - 2024/12/12 12:50:40
Table 'RushAndCash22316549' 6-max Seat #1 is the button
Seat 1: 295cc1bc ($10.23 in chips)
Seat 2: 556a8b26 ($16.35 in chips)
Seat 3: 216abb36 ($10 in chips)
Seat 4: b82279c3 ($39.85 in chips)
Seat 5: eb12374a ($10 in chips)
Seat 6: Hero ($10 in chips)
556a8b26: posts small blind $0.05
216abb36: posts big blind $0.1
*** HOLE CARDS ***
Dealt to 295cc1bc 
Dealt to 556a8b26 
Dealt to 216abb36 
Dealt to b82279c3 
Dealt to eb12374a 
Dealt to Hero [Qh 2c]
b82279c3: folds
eb12374a: raises $0.1 to $0.2
Hero: folds
295cc1bc: folds
556a8b26: folds
216abb36: calls $0.1
*** FLOP *** [7s 9h 7d]
216abb36: checks
eb12374a: bets $0.15
216abb36: calls $0.15
*** TURN *** [7s 9h 7d] [Ah]
216abb36: checks
eb12374a: checks
*** RIVER *** [7s 9h 7d Ah] [Ac]
216abb36: bets $0.25
eb12374a: calls $0.25
216abb36: shows [Qc As] (Aces Full over Sevens)
eb12374a: shows [9c Tc] (Pair of Aces and Pair of Nines)
*** SHOWDOWN ***
216abb36 collected $1.19 from pot
*** SUMMARY ***
Total pot $1.25 | Rake $0.06 | Jackpot $0 | Bingo $0 | Fortune $0 | Tax $0
Board [7s 9h 7d Ah Ac]
Seat 1: 295cc1bc (button) folded before Flop (didn't bet)
Seat 2: 556a8b26 (small blind) folded before Flop
Seat 3: 216abb36 (big blind) showed [Qc As] and won ($1.19) with Aces Full over Sevens
Seat 4: b82279c3 folded before Flop (didn't bet)
Seat 5: eb12374a showed [9c Tc] and lost with Pair of Aces and Pair of Nines
Seat 6: Hero folded before Flop (didn't bet)


Poker Hand #RC3141671274: Hold'em No Limit ($0.05/$0.1) - 2024/12/12 12:50:36
Table 'RushAndCash22316534' 6-max Seat #1 is the button
Seat 1: Hero ($10 in chips)
Seat 2: d037fd58 ($14.93 in chips)
Seat 3: be24e56d ($17.23 in chips)
Seat 4: 4d3004b8 ($11.52 in chips)
Seat 5: f347a136 ($10 in chips)
Seat 6: f2ece23 ($11.13 in chips)
d037fd58: posts small blind $0.05
be24e56d: posts big blind $0.1
*** HOLE CARDS ***
Dealt to Hero [4h 2h]
Dealt to d037fd58 
Dealt to be24e56d 
Dealt to 4d3004b8 
Dealt to f347a136 
Dealt to f2ece23 
4d3004b8: raises $0.1 to $0.2
f347a136: raises $0.5 to $0.7
f2ece23: folds
Hero: folds
d037fd58: folds
be24e56d: folds
4d3004b8: calls $0.5
*** FLOP *** [Qc 5h 9s]
4d3004b8: checks
f347a136: bets $0.52
4d3004b8: calls $0.52
*** TURN *** [Qc 5h 9s] [9d]
4d3004b8: checks
f347a136: bets $1.5
4d3004b8: folds
Uncalled bet ($1.5) returned to f347a136
*** SHOWDOWN ***
f347a136 collected $2.46 from pot
*** SUMMARY ***
Total pot $2.59 | Rake $0.13 | Jackpot $0 | Bingo $0 | Fortune $0 | Tax $0
Board [Qc 5h 9s 9d]
Seat 1: Hero (button) folded before Flop (didn't bet)
Seat 2: d037fd58 (small blind) folded before Flop
Seat 3: be24e56d (big blind) folded before Flop
Seat 4: 4d3004b8 folded on the Turn
Seat 5: f347a136 won ($2.46)
Seat 6: f2ece23 folded before Flop (didn't bet)


Poker Hand #RC3141671256: Hold'em No Limit ($0.05/$0.1) - 2024/12/12 12:50:32
Table 'RushAndCash22316516' 6-max Seat #1 is the button
Seat 1: dd68a104 ($10.42 in chips)
Seat 2: 6d89c9cc ($12.27 in chips)
Seat 3: cc8462b1 ($12.76 in chips)
Seat 4: a9eb45fc ($10.3 in chips)
Seat 5: Hero ($10 in chips)
Seat 6: ac65db07 ($5.93 in chips)
6d89c9cc: posts small blind $0.05
cc8462b1: posts big blind $0.1
*** HOLE CARDS ***
Dealt to dd68a104 
Dealt to 6d89c9cc 
Dealt to cc8462b1 
Dealt to a9eb45fc 
Dealt to Hero [2c 9h]
Dealt to ac65db07 
a9eb45fc: folds
Hero: folds
ac65db07: folds
dd68a104: folds
6d89c9cc: raises $0.2 to $0.3
cc8462b1: raises $0.6 to $0.9
6d89c9cc: calls $0.6
*** FLOP *** [2h Qs 5c]
6d89c9cc: checks
cc8462b1: bets $0.65
6d89c9cc: calls $0.65
*** TURN *** [2h Qs 5c] [6c]
6d89c9cc: checks
cc8462b1: checks
*** RIVER *** [2h Qs 5c 6c] [3h]
6d89c9cc: bets $3.5
cc8462b1: folds
Uncalled bet ($3.5) returned to 6d89c9cc
*** SHOWDOWN ***
6d89c9cc collected $2.81 from pot
*** SUMMARY ***
Total pot $3.1 | Rake $0.14 | Jackpot $0.15 | Bingo $0 | Fortune $0 | Tax $0
Board [2h Qs 5c 6c 3h]
Seat 1: dd68a104 (button) folded before Flop (didn't bet)
Seat 2: 6d89c9cc (small blind) won ($2.81)
Seat 3: cc8462b1 (big blind) folded on the River
Seat 4: a9eb45fc folded before Flop (didn't bet)
Seat 5: Hero folded before Flop (didn't bet)
Seat 6: ac65db07 folded before Flop (didn't bet)


Poker Hand #RC3141671218: Hold'em No Limit ($0.05/$0.1) - 2024/12/12 12:50:23
Table 'RushAndCash22316478' 6-max Seat #1 is the button
Seat 1: 1a8ef95a ($11.47 in chips)
Seat 2: Hero ($10.05 in chips)
Seat 3: b9463896 ($10.88 in chips)
Seat 4: ff1406c1 ($10.7 in chips)
Seat 5: dbcd9107 ($19.47 in chips)
Seat 6: 11a00985 ($21.85 in chips)
Hero: posts small blind $0.05
b9463896: posts big blind $0.1
*** HOLE CARDS ***
Dealt to 1a8ef95a 
Dealt to Hero [Ts 8c]
Dealt to b9463896 
Dealt to ff1406c1 
Dealt to dbcd9107 
Dealt to 11a00985 
ff1406c1: raises $0.1 to $0.2
dbcd9107: folds
11a00985: folds
1a8ef95a: folds
Hero: folds
b9463896: calls $0.1
*** FLOP *** [3s Jd 4s]
b9463896: checks
ff1406c1: bets $0.15
b9463896: calls $0.15
*** TURN *** [3s Jd 4s] [Kc]
b9463896: checks
ff1406c1: bets $0.38
b9463896: folds
Uncalled bet ($0.38) returned to ff1406c1
*** SHOWDOWN ***
ff1406c1 collected $0.72 from pot
*** SUMMARY ***
Total pot $0.75 | Rake $0.03 | Jackpot $0 | Bingo $0 | Fortune $0 | Tax $0
Board [3s Jd 4s Kc]
Seat 1: 1a8ef95a (button) folded before Flop (didn't bet)
Seat 2: Hero (small blind) folded before Flop
Seat 3: b9463896 (big blind) folded on the Turn
Seat 4: ff1406c1 won ($0.72)
Seat 5: dbcd9107 folded before Flop (didn't bet)
Seat 6: 11a00985 folded before Flop (didn't bet)


Poker Hand #RC3141671182: Hold'em No Limit ($0.05/$0.1) - 2024/12/12 12:50:14
Table 'RushAndCash22316442' 6-max Seat #1 is the button
Seat 1: 1e25b5bb ($14.53 in chips)
Seat 2: 481b7ef8 ($12.77 in chips)
Seat 3: Hero ($10 in chips)
Seat 4: 645be922 ($10.48 in chips)
Seat 5: a699d2de ($10.86 in chips)
Seat 6: cfe70ef2 ($10.41 in chips)
481b7ef8: posts small blind $0.05
Hero: posts big blind $0.1
*** HOLE CARDS ***
Dealt to 1e25b5bb 
Dealt to 481b7ef8 
Dealt to Hero [Tc Ad]
Dealt to 645be922 
Dealt to a699d2de 
Dealt to cfe70ef2 
645be922: folds
a699d2de: folds
cfe70ef2: folds
1e25b5bb: folds
481b7ef8: folds
Uncalled bet ($0.05) returned to Hero
*** SHOWDOWN ***
Hero collected $0.1 from pot
*** SUMMARY ***
Total pot $0.1 | Rake $0 | Jackpot $0 | Bingo $0 | Fortune $0 | Tax $0
Seat 1: 1e25b5bb (button) folded before Flop (didn't bet)
Seat 2: 481b7ef8 (small blind) folded before Flop
Seat 3: Hero (big blind) collected ($0.1)
Seat 4: 645be922 folded before Flop (didn't bet)
Seat 5: a699d2de folded before Flop (didn't bet)
Seat 6: cfe70ef2 folded before Flop (didn't bet)


Poker Hand #RC3141671170: Hold'em No Limit ($0.05/$0.1) - 2024/12/12 12:50:11
Table 'RushAndCash22316430' 6-max Seat #1 is the button
Seat 1: c2b852ae ($10.75 in chips)
Seat 2: 1e25b5bb ($14.58 in chips)
Seat 3: f4a0e033 ($13.63 in chips)
Seat 4: Hero ($10 in chips)
Seat 5: 8ebad06f ($14.51 in chips)
Seat 6: a699d2de ($10.86 in chips)
1e25b5bb: posts small blind $0.05
f4a0e033: posts big blind $0.1
*** HOLE CARDS ***
Dealt to c2b852ae 
Dealt to 1e25b5bb 
Dealt to f4a0e033 
Dealt to Hero [Th 4c]
Dealt to 8ebad06f 
Dealt to a699d2de 
Hero: folds
8ebad06f: folds
a699d2de: folds
c2b852ae: folds
1e25b5bb: folds
Uncalled bet ($0.05) returned to f4a0e033
*** SHOWDOWN ***
f4a0e033 collected $0.1 from pot
*** SUMMARY ***
Total pot $0.1 | Rake $0 | Jackpot $0 | Bingo $0 | Fortune $0 | Tax $0
Seat 1: c2b852ae (button) folded before Flop (didn't bet)
Seat 2: 1e25b5bb (small blind) folded before Flop
Seat 3: f4a0e033 (big blind) collected ($0.1)
Seat 4: Hero folded before Flop (didn't bet)
Seat 5: 8ebad06f folded before Flop (didn't bet)
Seat 6: a699d2de folded before Flop (didn't bet)


Poker Hand #RC3141671157: Hold'em No Limit ($0.05/$0.1) - 2024/12/12 12:50:08
Table 'RushAndCash22316417' 6-max Seat #1 is the button
Seat 1: 356c8abd ($12.17 in chips)
Seat 2: e18303a2 ($13.76 in chips)
Seat 3: f2ece23 ($11.28 in chips)
Seat 4: 88a9583f ($22.11 in chips)
Seat 5: Hero ($10 in chips)
Seat 6: 3f1c4e6e ($14.31 in chips)
e18303a2: posts small blind $0.05
f2ece23: posts big blind $0.1
*** HOLE CARDS ***
Dealt to 356c8abd 
Dealt to e18303a2 
Dealt to f2ece23 
Dealt to 88a9583f 
Dealt to Hero [5c 9s]
Dealt to 3f1c4e6e 
88a9583f: raises $0.1 to $0.2
Hero: folds
3f1c4e6e: folds
356c8abd: folds
e18303a2: folds
f2ece23: folds
Uncalled bet ($0.1) returned to 88a9583f
*** SHOWDOWN ***
88a9583f collected $0.25 from pot
*** SUMMARY ***
Total pot $0.25 | Rake $0 | Jackpot $0 | Bingo $0 | Fortune $0 | Tax $0
Seat 1: 356c8abd (button) folded before Flop (didn't bet)
Seat 2: e18303a2 (small blind) folded before Flop
Seat 3: f2ece23 (big blind) folded before Flop
Seat 4: 88a9583f collected ($0.25)
Seat 5: Hero folded before Flop (didn't bet)
Seat 6: 3f1c4e6e folded before Flop (didn't bet)


Poker Hand #RC3141671026: Hold'em No Limit ($0.05/$0.1) - 2024/12/12 12:49:34
Table 'RushAndCash22316286' 6-max Seat #1 is the button
Seat 1: 1a8ef95a ($10.33 in chips)
Seat 2: 4898aa10 ($30.13 in chips)
Seat 3: 27c51518 ($23.21 in chips)
Seat 4: a7936163 ($15.34 in chips)
Seat 5: 1d656e64 ($103.53 in chips)
Seat 6: Hero ($10.15 in chips)
4898aa10: posts small blind $0.05
27c51518: posts big blind $0.1
*** HOLE CARDS ***
Dealt to 1a8ef95a 
Dealt to 4898aa10 
Dealt to 27c51518 
Dealt to a7936163 
Dealt to 1d656e64 
Dealt to Hero [Js Ts]
a7936163: folds
1d656e64: raises $0.2 to $0.3
Hero: raises $0.6 to $0.9
1a8ef95a: raises $1.6 to $2.5
4898aa10: folds
27c51518: folds
1d656e64: folds
Hero: folds
Uncalled bet ($1.6) returned to 1a8ef95a
*** SHOWDOWN ***
1a8ef95a collected $2.14 from pot
*** SUMMARY ***
Total pot $2.25 | Rake $0.11 | Jackpot $0 | Bingo $0 | Fortune $0 | Tax $0
Seat 1: 1a8ef95a (button) collected ($2.14)
Seat 2: 4898aa10 (small blind) folded before Flop
Seat 3: 27c51518 (big blind) folded before Flop
Seat 4: a7936163 folded before Flop (didn't bet)
Seat 5: 1d656e64 folded before Flop
Seat 6: Hero folded before Flop


Poker Hand #RC3141671013: Hold'em No Limit ($0.05/$0.1) - 2024/12/12 12:49:30
Table 'RushAndCash22316273' 6-max Seat #1 is the button
Seat 1: f564c212 ($10.15 in chips)
Seat 2: 3f7822ab ($18.68 in chips)
Seat 3: ca4fa05a ($8 in chips)
Seat 4: 2e735933 ($12.73 in chips)
Seat 5: Hero ($10.15 in chips)
Seat 6: 2746c1f0 ($11.01 in chips)
3f7822ab: posts small blind $0.05
ca4fa05a: posts big blind $0.1
*** HOLE CARDS ***
Dealt to f564c212 
Dealt to 3f7822ab 
Dealt to ca4fa05a 
Dealt to 2e735933 
Dealt to Hero [9s 5d]
Dealt to 2746c1f0 
2e735933: folds
Hero: folds
2746c1f0: folds
f564c212: raises $0.12 to $0.22
3f7822ab: folds
ca4fa05a: folds
Uncalled bet ($0.12) returned to f564c212
*** SHOWDOWN ***
f564c212 collected $0.25 from pot
*** SUMMARY ***
Total pot $0.25 | Rake $0 | Jackpot $0 | Bingo $0 | Fortune $0 | Tax $0
Seat 1: f564c212 (button) collected ($0.25)
Seat 2: 3f7822ab (small blind) folded before Flop
Seat 3: ca4fa05a (big blind) folded before Flop
Seat 4: 2e735933 folded before Flop (didn't bet)
Seat 5: Hero folded before Flop (didn't bet)
Seat 6: 2746c1f0 folded before Flop (didn't bet)


Poker Hand #RC3141670999: Hold'em No Limit ($0.05/$0.1) - 2024/12/12 12:49:27
Table 'RushAndCash22316259' 6-max Seat #1 is the button
Seat 1: Hero ($10.15 in chips)
Seat 2: 3cdac696 ($9.09 in chips)
Seat 3: 228a039d ($10.44 in chips)
Seat 4: 556a8b26 ($16.4 in chips)
Seat 5: 7bad2adb ($10.13 in chips)
Seat 6: 2e735933 ($12.73 in chips)
3cdac696: posts small blind $0.05
228a039d: posts big blind $0.1
*** HOLE CARDS ***
Dealt to Hero [Kh 7c]
Dealt to 3cdac696 
Dealt to 228a039d 
Dealt to 556a8b26 
Dealt to 7bad2adb 
Dealt to 2e735933 
556a8b26: folds
7bad2adb: folds
2e735933: folds
Hero: folds
3cdac696: raises $0.1 to $0.2
228a039d: calls $0.1
*** FLOP *** [7h Th Kd]
3cdac696: bets $0.2
228a039d: folds
Uncalled bet ($0.2) returned to 3cdac696
*** SHOWDOWN ***
3cdac696 collected $0.38 from pot
*** SUMMARY ***
Total pot $0.4 | Rake $0.02 | Jackpot $0 | Bingo $0 | Fortune $0 | Tax $0
Board [7h Th Kd]
Seat 1: Hero (button) folded before Flop (didn't bet)
Seat 2: 3cdac696 (small blind) won ($0.38)
Seat 3: 228a039d (big blind) folded on the Flop
Seat 4: 556a8b26 folded before Flop (didn't bet)
Seat 5: 7bad2adb folded before Flop (didn't bet)
Seat 6: 2e735933 folded before Flop (didn't bet)


Poker Hand #RC3141670936: Hold'em No Limit ($0.05/$0.1) - 2024/12/12 12:49:12
Table 'RushAndCash22316196' 6-max Seat #1 is the button
Seat 1: e60f3780 ($11.18 in chips)
Seat 2: Hero ($10.05 in chips)
Seat 3: 566d8ba0 ($10.46 in chips)
Seat 4: daa081a6 ($10.84 in chips)
Seat 5: 1cefc6e8 ($12.1 in chips)
Seat 6: 7d40d863 ($7.52 in chips)
Hero: posts small blind $0.05
566d8ba0: posts big blind $0.1
*** HOLE CARDS ***
Dealt to e60f3780 
Dealt to Hero [Ac 9h]
Dealt to 566d8ba0 
Dealt to daa081a6 
Dealt to 1cefc6e8 
Dealt to 7d40d863 
daa081a6: folds
1cefc6e8: folds
7d40d863: folds
e60f3780: folds
Hero: raises $0.2 to $0.3
566d8ba0: folds
Uncalled bet ($0.2) returned to Hero
*** SHOWDOWN ***
Hero collected $0.2 from pot
*** SUMMARY ***
Total pot $0.2 | Rake $0 | Jackpot $0 | Bingo $0 | Fortune $0 | Tax $0
Seat 1: e60f3780 (button) folded before Flop (didn't bet)
Seat 2: Hero (small blind) collected ($0.2)
Seat 3: 566d8ba0 (big blind) folded before Flop
Seat 4: daa081a6 folded before Flop (didn't bet)
Seat 5: 1cefc6e8 folded before Flop (didn't bet)
Seat 6: 7d40d863 folded before Flop (didn't bet)


Poker Hand #RC3141670912: Hold'em No Limit ($0.05/$0.1) - 2024/12/12 12:49:05
Table 'RushAndCash22316172' 6-max Seat #1 is the button
Seat 1: 719fb29e ($13.4 in chips)
Seat 2: 974f52 ($36.68 in chips)
Seat 3: Hero ($10.15 in chips)
Seat 4: 226dbbb0 ($10 in chips)
Seat 5: 4740c06b ($10 in chips)
Seat 6: daa081a6 ($10.84 in chips)
974f52: posts small blind $0.05
Hero: posts big blind $0.1
*** HOLE CARDS ***
Dealt to 719fb29e 
Dealt to 974f52 
Dealt to Hero [Js 6c]
Dealt to 226dbbb0 
Dealt to 4740c06b 
Dealt to daa081a6 
226dbbb0: raises $0.15 to $0.25
4740c06b: folds
daa081a6: folds
719fb29e: folds
974f52: folds
Hero: folds
Uncalled bet ($0.15) returned to 226dbbb0
*** SHOWDOWN ***
226dbbb0 collected $0.25 from pot
*** SUMMARY ***
Total pot $0.25 | Rake $0 | Jackpot $0 | Bingo $0 | Fortune $0 | Tax $0
Seat 1: 719fb29e (button) folded before Flop (didn't bet)
Seat 2: 974f52 (small blind) folded before Flop
Seat 3: Hero (big blind) folded before Flop
Seat 4: 226dbbb0 collected ($0.25)
Seat 5: 4740c06b folded before Flop (didn't bet)
Seat 6: daa081a6 folded before Flop (didn't bet)


Poker Hand #RC3141670900: Hold'em No Limit ($0.05/$0.1) - 2024/12/12 12:49:02
Table 'RushAndCash22316160' 6-max Seat #1 is the button
Seat 1: 6b0057b1 ($10 in chips)
Seat 2: daa081a6 ($10.89 in chips)
Seat 3: cf8c7bd5 ($21.15 in chips)
Seat 4: 1677a3f4 ($10.33 in chips)
Seat 5: 4e5c7119 ($11.55 in chips)
Seat 6: Hero ($10.15 in chips)
daa081a6: posts small blind $0.05
cf8c7bd5: posts big blind $0.1
*** HOLE CARDS ***
Dealt to 6b0057b1 
Dealt to daa081a6 
Dealt to cf8c7bd5 
Dealt to 1677a3f4 
Dealt to 4e5c7119 
Dealt to Hero [4s Tc]
1677a3f4: folds
4e5c7119: folds
Hero: folds
6b0057b1: raises $0.12 to $0.22
daa081a6: folds
cf8c7bd5: raises $0.25 to $0.47
6b0057b1: calls $0.25
*** FLOP *** [9s Qc Jh]
cf8c7bd5: checks
6b0057b1: bets $0.5
cf8c7bd5: folds
Uncalled bet ($0.5) returned to 6b0057b1
*** SHOWDOWN ***
6b0057b1 collected $0.94 from pot
*** SUMMARY ***
Total pot $0.99 | Rake $0.05 | Jackpot $0 | Bingo $0 | Fortune $0 | Tax $0
Board [9s Qc Jh]
Seat 1: 6b0057b1 (button) won ($0.94)
Seat 2: daa081a6 (small blind) folded before Flop
Seat 3: cf8c7bd5 (big blind) folded on the Flop
Seat 4: 1677a3f4 folded before Flop (didn't bet)
Seat 5: 4e5c7119 folded before Flop (didn't bet)
Seat 6: Hero folded before Flop (didn't bet)


Poker Hand #RC3141670887: Hold'em No Limit ($0.05/$0.1) - 2024/12/12 12:48:58
Table 'RushAndCash22316147' 6-max Seat #1 is the button
Seat 1: 2e3105a5 ($11.77 in chips)
Seat 2: 6b0057b1 ($10 in chips)
Seat 3: 77907fc4 ($24.46 in chips)
Seat 4: Hero ($10.15 in chips)
Seat 5: 111c75 ($10 in chips)
Seat 6: f5628a04 ($11.3 in chips)
6b0057b1: posts small blind $0.05
77907fc4: posts big blind $0.1
*** HOLE CARDS ***
Dealt to 2e3105a5 
Dealt to 6b0057b1 
Dealt to 77907fc4 
Dealt to Hero [5c 2s]
Dealt to 111c75 
Dealt to f5628a04 
Hero: folds
111c75: raises $0.15 to $0.25
f5628a04: folds
2e3105a5: folds
6b0057b1: folds
77907fc4: calls $0.15
*** FLOP *** [3s Tc 6d]
77907fc4: checks
111c75: checks
*** TURN *** [3s Tc 6d] [As]
77907fc4: bets $0.28
111c75: calls $0.28
*** RIVER *** [3s Tc 6d As] [3h]
77907fc4: checks
111c75: bets $0.56
77907fc4: folds
Uncalled bet ($0.56) returned to 111c75
*** SHOWDOWN ***
111c75 collected $1.06 from pot
*** SUMMARY ***
Total pot $1.11 | Rake $0.05 | Jackpot $0 | Bingo $0 | Fortune $0 | Tax $0
Board [3s Tc 6d As 3h]
Seat 1: 2e3105a5 (button) folded before Flop (didn't bet)
Seat 2: 6b0057b1 (small blind) folded before Flop
Seat 3: 77907fc4 (big blind) folded on the River
Seat 4: Hero folded before Flop (didn't bet)
Seat 5: 111c75 won ($1.06)
Seat 6: f5628a04 folded before Flop (didn't bet)


Poker Hand #RC3141670872: Hold'em No Limit ($0.05/$0.1) - 2024/12/12 12:48:54
Table 'RushAndCash22316132' 6-max Seat #1 is the button
Seat 1: 8e0a697 ($11.32 in chips)
Seat 2: b0559006 ($9.41 in chips)
Seat 3: 9c716b19 ($25.83 in chips)
Seat 4: 8ebad06f ($15.01 in chips)
Seat 5: 226dbbb0 ($10 in chips)
Seat 6: Hero ($10.15 in chips)
b0559006: posts small blind $0.05
9c716b19: posts big blind $0.1
*** HOLE CARDS ***
Dealt to 8e0a697 
Dealt to b0559006 
Dealt to 9c716b19 
Dealt to 8ebad06f 
Dealt to 226dbbb0 
Dealt to Hero [Ah 7c]
8ebad06f: folds
226dbbb0: folds
Hero: folds
8e0a697: folds
b0559006: folds
Uncalled bet ($0.05) returned to 9c716b19
*** SHOWDOWN ***
9c716b19 collected $0.1 from pot
*** SUMMARY ***
Total pot $0.1 | Rake $0 | Jackpot $0 | Bingo $0 | Fortune $0 | Tax $0
Seat 1: 8e0a697 (button) folded before Flop (didn't bet)
Seat 2: b0559006 (small blind) folded before Flop
Seat 3: 9c716b19 (big blind) collected ($0.1)
Seat 4: 8ebad06f folded before Flop (didn't bet)
Seat 5: 226dbbb0 folded before Flop (didn't bet)
Seat 6: Hero folded before Flop (didn't bet)


Poker Hand #RC3141670730: Hold'em No Limit ($0.05/$0.1) - 2024/12/12 12:48:15
Table 'RushAndCash22315990' 6-max Seat #1 is the button
Seat 1: Hero ($10.4 in chips)
Seat 2: bf6a4250 ($10 in chips)
Seat 3: b0559006 ($9.13 in chips)
Seat 4: b1f396f4 ($27.06 in chips)
Seat 5: fc90d2af ($12.26 in chips)
Seat 6: 4c96024a ($11.24 in chips)
bf6a4250: posts small blind $0.05
b0559006: posts big blind $0.1
*** HOLE CARDS ***
Dealt to Hero [Qd Kh]
Dealt to bf6a4250 
Dealt to b0559006 
Dealt to b1f396f4 
Dealt to fc90d2af 
Dealt to 4c96024a 
b1f396f4: folds
fc90d2af: folds
4c96024a: folds
Hero: raises $0.15 to $0.25
bf6a4250: folds
b0559006: calls $0.15
*** FLOP *** [7s 7h 5d]
b0559006: checks
Hero: checks
*** TURN *** [7s 7h 5d] [Ts]
b0559006: bets $0.28
Hero: folds
Uncalled bet ($0.28) returned to b0559006
*** SHOWDOWN ***
b0559006 collected $0.53 from pot
*** SUMMARY ***
Total pot $0.55 | Rake $0.02 | Jackpot $0 | Bingo $0 | Fortune $0 | Tax $0
Board [7s 7h 5d Ts]
Seat 1: Hero (button) folded on the Turn
Seat 2: bf6a4250 (small blind) folded before Flop
Seat 3: b0559006 (big blind) won ($0.53)
Seat 4: b1f396f4 folded before Flop (didn't bet)
Seat 5: fc90d2af folded before Flop (didn't bet)
Seat 6: 4c96024a folded before Flop (didn't bet)


Poker Hand #RC3141670498: Hold'em No Limit ($0.05/$0.1) - 2024/12/12 12:47:16
Table 'RushAndCash22315758' 6-max Seat #1 is the button
Seat 1: 52c6c741 ($11.49 in chips)
Seat 2: Hero ($10.45 in chips)
Seat 3: 4f76bae1 ($10.1 in chips)
Seat 4: f383ae87 ($25.25 in chips)
Seat 5: c8e1bfcc ($9.9 in chips)
Seat 6: b57eea46 ($8.92 in chips)
Hero: posts small blind $0.05
4f76bae1: posts big blind $0.1
*** HOLE CARDS ***
Dealt to 52c6c741 
Dealt to Hero [Ts Qd]
Dealt to 4f76bae1 
Dealt to f383ae87 
Dealt to c8e1bfcc 
Dealt to b57eea46 
f383ae87: folds
c8e1bfcc: folds
b57eea46: raises $0.1 to $0.2
52c6c741: folds
Hero: folds
4f76bae1: calls $0.1
*** FLOP *** [Kc 9d Kh]
4f76bae1: checks
b57eea46: checks
*** TURN *** [Kc 9d Kh] [4h]
4f76bae1: checks
b57eea46: checks
*** RIVER *** [Kc 9d Kh 4h] [5h]
4f76bae1: checks
b57eea46: checks
4f76bae1: shows [3s 7s] (Pair of Kings)
b57eea46: shows [Td Jc] (Pair of Kings)
*** SHOWDOWN ***
b57eea46 collected $0.43 from pot
*** SUMMARY ***
Total pot $0.45 | Rake $0.02 | Jackpot $0 | Bingo $0 | Fortune $0 | Tax $0
Board [Kc 9d Kh 4h 5h]
Seat 1: 52c6c741 (button) folded before Flop (didn't bet)
Seat 2: Hero (small blind) folded before Flop
Seat 3: 4f76bae1 (big blind) showed [3s 7s] and lost with Pair of Kings
Seat 4: f383ae87 folded before Flop (didn't bet)
Seat 5: c8e1bfcc folded before Flop (didn't bet)
Seat 6: b57eea46 showed [Td Jc] and won ($0.43) with Pair of Kings


Poker Hand #RC3141670449: Hold'em No Limit ($0.05/$0.1) - 2024/12/12 12:47:02
Table 'RushAndCash22315709' 6-max Seat #1 is the button
Seat 1: 7576a2e9 ($10 in chips)
Seat 2: bc2007a2 ($15.46 in chips)
Seat 3: Hero ($10.55 in chips)
Seat 4: e12528c0 ($33.38 in chips)
Seat 5: 26077f2f ($10.86 in chips)
Seat 6: 3954586d ($10.65 in chips)
bc2007a2: posts small blind $0.05
Hero: posts big blind $0.1
*** HOLE CARDS ***
Dealt to 7576a2e9 
Dealt to bc2007a2 
Dealt to Hero [5s 6c]
Dealt to e12528c0 
Dealt to 26077f2f 
Dealt to 3954586d 
e12528c0: raises $0.1 to $0.2
26077f2f: raises $0.43 to $0.63
3954586d: folds
7576a2e9: folds
bc2007a2: folds
Hero: folds
e12528c0: raises $1.57 to $2.2
26077f2f: folds
Uncalled bet ($1.57) returned to e12528c0
*** SHOWDOWN ***
e12528c0 collected $1.34 from pot
*** SUMMARY ***
Total pot $1.41 | Rake $0.07 | Jackpot $0 | Bingo $0 | Fortune $0 | Tax $0
Seat 1: 7576a2e9 (button) folded before Flop (didn't bet)
Seat 2: bc2007a2 (small blind) folded before Flop
Seat 3: Hero (big blind) folded before Flop
Seat 4: e12528c0 collected ($1.34)
Seat 5: 26077f2f folded before Flop
Seat 6: 3954586d folded before Flop (didn't bet)


Poker Hand #RC3141670436: Hold'em No Limit ($0.05/$0.1) - 2024/12/12 12:46:58
Table 'RushAndCash22315696' 6-max Seat #1 is the button
Seat 1: f2ece23 ($12.98 in chips)
Seat 2: dea1301e ($20.56 in chips)
Seat 3: 4898aa10 ($23.35 in chips)
Seat 4: 95a503e1 ($16.85 in chips)
Seat 5: e12528c0 ($33.38 in chips)
Seat 6: Hero ($10.55 in chips)
dea1301e: posts small blind $0.05
4898aa10: posts big blind $0.1
*** HOLE CARDS ***
Dealt to f2ece23 
Dealt to dea1301e 
Dealt to 4898aa10 
Dealt to 95a503e1 
Dealt to e12528c0 
Dealt to Hero [7s 3h]
95a503e1: folds
e12528c0: folds
Hero: folds
f2ece23: raises $0.1 to $0.2
dea1301e: folds
4898aa10: calls $0.1
*** FLOP *** [Th 5s 6d]
4898aa10: checks
f2ece23: bets $0.15
4898aa10: calls $0.15
*** TURN *** [Th 5s 6d] [7h]
4898aa10: checks
f2ece23: checks
*** RIVER *** [Th 5s 6d 7h] [5c]
4898aa10: checks
f2ece23: checks
4898aa10: shows [Ad Tc] (Pair of Tens and Pair of Fives)
f2ece23: shows [Qd Kc] (Pair of Fives)
*** SHOWDOWN ***
4898aa10 collected $0.72 from pot
*** SUMMARY ***
Total pot $0.75 | Rake $0.03 | Jackpot $0 | Bingo $0 | Fortune $0 | Tax $0
Board [Th 5s 6d 7h 5c]
Seat 1: f2ece23 (button) showed [Qd Kc] and lost with Pair of Fives
Seat 2: dea1301e (small blind) folded before Flop
Seat 3: 4898aa10 (big blind) showed [Ad Tc] and won ($0.72) with Pair of Tens and Pair of Fives
Seat 4: 95a503e1 folded before Flop (didn't bet)
Seat 5: e12528c0 folded before Flop (didn't bet)
Seat 6: Hero folded before Flop (didn't bet)


Poker Hand #RC3141670394: Hold'em No Limit ($0.05/$0.1) - 2024/12/12 12:46:47
Table 'RushAndCash22315654' 6-max Seat #1 is the button
Seat 1: 4e5368fb ($10.49 in chips)
Seat 2: f04fb852 ($11.71 in chips)
Seat 3: 3c75bc00 ($33.11 in chips)
Seat 4: e7a93172 ($17.69 in chips)
Seat 5: Hero ($10.55 in chips)
Seat 6: 5e5bf12a ($9.85 in chips)
f04fb852: posts small blind $0.05
3c75bc00: posts big blind $0.1
*** HOLE CARDS ***
Dealt to 4e5368fb 
Dealt to f04fb852 
Dealt to 3c75bc00 
Dealt to e7a93172 
Dealt to Hero [Kh Tc]
Dealt to 5e5bf12a 
e7a93172: folds
Hero: folds
5e5bf12a: folds
4e5368fb: folds
f04fb852: folds
Uncalled bet ($0.05) returned to 3c75bc00
*** SHOWDOWN ***
3c75bc00 collected $0.1 from pot
*** SUMMARY ***
Total pot $0.1 | Rake $0 | Jackpot $0 | Bingo $0 | Fortune $0 | Tax $0
Seat 1: 4e5368fb (button) folded before Flop (didn't bet)
Seat 2: f04fb852 (small blind) folded before Flop
Seat 3: 3c75bc00 (big blind) collected ($0.1)
Seat 4: e7a93172 folded before Flop (didn't bet)
Seat 5: Hero folded before Flop (didn't bet)
Seat 6: 5e5bf12a folded before Flop (didn't bet)


Poker Hand #RC3141670380: Hold'em No Limit ($0.05/$0.1) - 2024/12/12 12:46:44
Table 'RushAndCash22315640' 6-max Seat #1 is the button
Seat 1: 2746c1f0 ($10.51 in chips)
Seat 2: 22e8274e ($13.45 in chips)
Seat 3: 5ab2e15d ($10 in chips)
Seat 4: 3c75bc00 ($33.11 in chips)
Seat 5: 1d875186 ($10.86 in chips)
Seat 6: Hero ($10.55 in chips)
22e8274e: posts small blind $0.05
5ab2e15d: posts big blind $0.1
*** HOLE CARDS ***
Dealt to 2746c1f0 
Dealt to 22e8274e 
Dealt to 5ab2e15d 
Dealt to 3c75bc00 
Dealt to 1d875186 
Dealt to Hero [5h 9c]
3c75bc00: folds
1d875186: raises $0.15 to $0.25
Hero: folds
2746c1f0: folds
22e8274e: raises $0.6 to $0.85
5ab2e15d: folds
1d875186: calls $0.6
*** FLOP *** [Kc Kh 5s]
22e8274e: bets $0.9
1d875186: folds
Uncalled bet ($0.9) returned to 22e8274e
*** SHOWDOWN ***
22e8274e collected $1.71 from pot
*** SUMMARY ***
Total pot $1.8 | Rake $0.09 | Jackpot $0 | Bingo $0 | Fortune $0 | Tax $0
Board [Kc Kh 5s]
Seat 1: 2746c1f0 (button) folded before Flop (didn't bet)
Seat 2: 22e8274e (small blind) won ($1.71)
Seat 3: 5ab2e15d (big blind) folded before Flop
Seat 4: 3c75bc00 folded before Flop (didn't bet)
Seat 5: 1d875186 folded on the Flop
Seat 6: Hero folded before Flop (didn't bet)


Poker Hand #RC3141670301: Hold'em No Limit ($0.05/$0.1) - 2024/12/12 12:46:22
Table 'RushAndCash22315561' 6-max Seat #1 is the button
Seat 1: 1d875186 ($10.91 in chips)
Seat 2: 2746c1f0 ($10.04 in chips)
Seat 3: c8e1bfcc ($10 in chips)
Seat 4: Hero ($10.75 in chips)
Seat 5: f2b49ec ($11.29 in chips)
Seat 6: 8499417 ($10.1 in chips)
2746c1f0: posts small blind $0.05
c8e1bfcc: posts big blind $0.1
*** HOLE CARDS ***
Dealt to 1d875186 
Dealt to 2746c1f0 
Dealt to c8e1bfcc 
Dealt to Hero [Kh 9h]
Dealt to f2b49ec 
Dealt to 8499417 
Hero: raises $0.1 to $0.2
f2b49ec: folds
8499417: folds
1d875186: calls $0.2
2746c1f0: raises $1 to $1.2
c8e1bfcc: folds
Hero: folds
1d875186: folds
Uncalled bet ($1) returned to 2746c1f0
*** SHOWDOWN ***
2746c1f0 collected $0.67 from pot
*** SUMMARY ***
Total pot $0.7 | Rake $0.03 | Jackpot $0 | Bingo $0 | Fortune $0 | Tax $0
Seat 1: 1d875186 (button) folded before Flop
Seat 2: 2746c1f0 (small blind) collected ($0.67)
Seat 3: c8e1bfcc (big blind) folded before Flop
Seat 4: Hero folded before Flop
Seat 5: f2b49ec folded before Flop (didn't bet)
Seat 6: 8499417 folded before Flop (didn't bet)


Poker Hand #RC3141670289: Hold'em No Limit ($0.05/$0.1) - 2024/12/12 12:46:18
Table 'RushAndCash22315549' 6-max Seat #1 is the button
Seat 1: Hero ($10.75 in chips)
Seat 2: 8a55880e ($10.84 in chips)
Seat 3: 1d875186 ($11.01 in chips)
Seat 4: 8499417 ($10.1 in chips)
Seat 5: cc8462b1 ($13.11 in chips)
Seat 6: 4684e24a ($21.39 in chips)
8a55880e: posts small blind $0.05
1d875186: posts big blind $0.1
*** HOLE CARDS ***
Dealt to Hero [3s 8h]
Dealt to 8a55880e 
Dealt to 1d875186 
Dealt to 8499417 
Dealt to cc8462b1 
Dealt to 4684e24a 
8499417: folds
cc8462b1: folds
4684e24a: folds
Hero: folds
8a55880e: folds
Uncalled bet ($0.05) returned to 1d875186
*** SHOWDOWN ***
1d875186 collected $0.1 from pot
*** SUMMARY ***
Total pot $0.1 | Rake $0 | Jackpot $0 | Bingo $0 | Fortune $0 | Tax $0
Seat 1: Hero (button) folded before Flop (didn't bet)
Seat 2: 8a55880e (small blind) folded before Flop
Seat 3: 1d875186 (big blind) collected ($0.1)
Seat 4: 8499417 folded before Flop (didn't bet)
Seat 5: cc8462b1 folded before Flop (didn't bet)
Seat 6: 4684e24a folded before Flop (didn't bet)


Poker Hand #RC3141670086: Hold'em No Limit ($0.05/$0.1) - 2024/12/12 12:45:21
Table 'RushAndCash22315346' 6-max Seat #1 is the button
Seat 1: 1e25b5bb ($15.04 in chips)
Seat 2: Hero ($10 in chips)
Seat 3: 8a55880e ($11.67 in chips)
Seat 4: a6151fd4 ($7.8 in chips)
Seat 5: 3954586d ($10 in chips)
Seat 6: 418b0280 ($12.22 in chips)
Hero: posts small blind $0.05
8a55880e: posts big blind $0.1
*** HOLE CARDS ***
Dealt to 1e25b5bb 
Dealt to Hero [Ac Ad]
Dealt to 8a55880e 
Dealt to a6151fd4 
Dealt to 3954586d 
Dealt to 418b0280 
a6151fd4: folds
3954586d: folds
418b0280: folds
1e25b5bb: folds
Hero: raises $0.2 to $0.3
8a55880e: calls $0.2
*** FLOP *** [2c 4h 5d]
Hero: checks
8a55880e: bets $0.2
Hero: calls $0.2
*** TURN *** [2c 4h 5d] [8h]
Hero: checks
8a55880e: bets $0.33
Hero: calls $0.33
*** RIVER *** [2c 4h 5d 8h] [9s]
Hero: checks
8a55880e: checks
Hero: shows [Ac Ad] (Pair of Aces)
8a55880e: shows [6h Ah] (Ace-High)
*** SHOWDOWN ***
Hero collected $1.58 from pot
*** SUMMARY ***
Total pot $1.66 | Rake $0.08 | Jackpot $0 | Bingo $0 | Fortune $0 | Tax $0
Board [2c 4h 5d 8h 9s]
Seat 1: 1e25b5bb (button) folded before Flop (didn't bet)
Seat 2: Hero (small blind) showed [Ac Ad] and won ($1.58) with Pair of Aces
Seat 3: 8a55880e (big blind) showed [6h Ah] and lost with Ace-High
Seat 4: a6151fd4 folded before Flop (didn't bet)
Seat 5: 3954586d folded before Flop (didn't bet)
Seat 6: 418b0280 folded before Flop (didn't bet)


Poker Hand #RC3141669714: Hold'em No Limit ($0.05/$0.1) - 2024/12/12 12:43:54
Table 'RushAndCash22314974' 6-max Seat #1 is the button
Seat 1: 78428b92 ($51.2 in chips)
Seat 2: 1e25b5bb ($13.82 in chips)
Seat 3: Hero ($10 in chips)
Seat 4: 5b14e7af ($21.89 in chips)
Seat 5: f323cdf3 ($12.17 in chips)
Seat 6: be2bfc8f ($10 in chips)
1e25b5bb: posts small blind $0.05
Hero: posts big blind $0.1
*** HOLE CARDS ***
Dealt to 78428b92 
Dealt to 1e25b5bb 
Dealt to Hero [Tc Th]
Dealt to 5b14e7af 
Dealt to f323cdf3 
Dealt to be2bfc8f 
5b14e7af: folds
f323cdf3: folds
be2bfc8f: folds
78428b92: folds
1e25b5bb: raises $0.2 to $0.3
Hero: raises $0.6 to $0.9
1e25b5bb: calls $0.6
*** FLOP *** [4d 5s Jc]
1e25b5bb: checks
Hero: bets $0.45
1e25b5bb: calls $0.45
*** TURN *** [4d 5s Jc] [7s]
1e25b5bb: checks
Hero: checks
*** RIVER *** [4d 5s Jc 7s] [6d]
1e25b5bb: bets $1.35
Hero: folds
Uncalled bet ($1.35) returned to 1e25b5bb
*** SHOWDOWN ***
1e25b5bb collected $2.57 from pot
*** SUMMARY ***
Total pot $2.7 | Rake $0.13 | Jackpot $0 | Bingo $0 | Fortune $0 | Tax $0
Board [4d 5s Jc 7s 6d]
Seat 1: 78428b92 (button) folded before Flop (didn't bet)
Seat 2: 1e25b5bb (small blind) won ($2.57)
Seat 3: Hero (big blind) folded on the River
Seat 4: 5b14e7af folded before Flop (didn't bet)
Seat 5: f323cdf3 folded before Flop (didn't bet)
Seat 6: be2bfc8f folded before Flop (didn't bet)


Poker Hand #RC3141669688: Hold'em No Limit ($0.05/$0.1) - 2024/12/12 12:43:47
Table 'RushAndCash22314948' 6-max Seat #1 is the button
Seat 1: 7829feb5 ($10 in chips)
Seat 2: c6786b68 ($19.67 in chips)
Seat 3: 17f79555 ($10.34 in chips)
Seat 4: 3cdac696 ($9.28 in chips)
Seat 5: Hero ($10 in chips)
Seat 6: 974f52 ($33.97 in chips)
c6786b68: posts small blind $0.05
17f79555: posts big blind $0.1
*** HOLE CARDS ***
Dealt to 7829feb5 
Dealt to c6786b68 
Dealt to 17f79555 
Dealt to 3cdac696 
Dealt to Hero [Kd 9d]
Dealt to 974f52 
3cdac696: raises $0.1 to $0.2
Hero: folds
974f52: calls $0.2
7829feb5: folds
c6786b68: folds
17f79555: folds
*** FLOP *** [Jh 8d Qc]
3cdac696: checks
974f52: checks
*** TURN *** [Jh 8d Qc] [Js]
3cdac696: checks
974f52: checks
*** RIVER *** [Jh 8d Qc Js] [Jd]
3cdac696: checks
974f52: checks
3cdac696: shows [Ks Td] (Three Jacks)
974f52: shows [4d 4h] (Jacks Full over Fours)
*** SHOWDOWN ***
974f52 collected $0.53 from pot
*** SUMMARY ***
Total pot $0.55 | Rake $0.02 | Jackpot $0 | Bingo $0 | Fortune $0 | Tax $0
Board [Jh 8d Qc Js Jd]
Seat 1: 7829feb5 (button) folded before Flop (didn't bet)
Seat 2: c6786b68 (small blind) folded before Flop
Seat 3: 17f79555 (big blind) folded before Flop
Seat 4: 3cdac696 showed [Ks Td] and lost with Three Jacks
Seat 5: Hero folded before Flop (didn't bet)
Seat 6: 974f52 showed [4d 4h] and won ($0.53) with Jacks Full over Fours


Poker Hand #RC3141669672: Hold'em No Limit ($0.05/$0.1) - 2024/12/12 12:43:44
Table 'RushAndCash22314932' 6-max Seat #1 is the button
Seat 1: 2db5d1cb ($13.13 in chips)
Seat 2: 101c026b ($24.64 in chips)
Seat 3: 81834a2f ($21.81 in chips)
Seat 4: 3954586d ($10 in chips)
Seat 5: Hero ($10 in chips)
Seat 6: 17f79555 ($10.34 in chips)
101c026b: posts small blind $0.05
81834a2f: posts big blind $0.1
*** HOLE CARDS ***
Dealt to 2db5d1cb 
Dealt to 101c026b 
Dealt to 81834a2f 
Dealt to 3954586d 
Dealt to Hero [6d 8s]
Dealt to 17f79555 
3954586d: folds
Hero: folds
17f79555: folds
2db5d1cb: folds
101c026b: raises $0.2 to $0.3
81834a2f: folds
Uncalled bet ($0.2) returned to 101c026b
*** SHOWDOWN ***
101c026b collected $0.2 from pot
*** SUMMARY ***
Total pot $0.2 | Rake $0 | Jackpot $0 | Bingo $0 | Fortune $0 | Tax $0
Seat 1: 2db5d1cb (button) folded before Flop (didn't bet)
Seat 2: 101c026b (small blind) collected ($0.2)
Seat 3: 81834a2f (big blind) folded before Flop
Seat 4: 3954586d folded before Flop (didn't bet)
Seat 5: Hero folded before Flop (didn't bet)
Seat 6: 17f79555 folded before Flop (didn't bet)


Poker Hand #RC3141669657: Hold'em No Limit ($0.05/$0.1) - 2024/12/12 12:43:40
Table 'RushAndCash22314917' 6-max Seat #1 is the button
Seat 1: 1d2dacdf ($10 in chips)
Seat 2: f08fe70 ($22.38 in chips)
Seat 3: d827b781 ($13.83 in chips)
Seat 4: Hero ($10 in chips)
Seat 5: 17f79555 ($10.34 in chips)
Seat 6: 111c75 ($10.33 in chips)
f08fe70: posts small blind $0.05
d827b781: posts big blind $0.1
*** HOLE CARDS ***
Dealt to 1d2dacdf 
Dealt to f08fe70 
Dealt to d827b781 
Dealt to Hero [2d 9d]
Dealt to 17f79555 
Dealt to 111c75 
Hero: folds
17f79555: folds
111c75: folds
1d2dacdf: folds
f08fe70: raises $0.2 to $0.3
d827b781: folds
Uncalled bet ($0.2) returned to f08fe70
*** SHOWDOWN ***
f08fe70 collected $0.2 from pot
*** SUMMARY ***
Total pot $0.2 | Rake $0 | Jackpot $0 | Bingo $0 | Fortune $0 | Tax $0
Seat 1: 1d2dacdf (button) folded before Flop (didn't bet)
Seat 2: f08fe70 (small blind) collected ($0.2)
Seat 3: d827b781 (big blind) folded before Flop
Seat 4: Hero folded before Flop (didn't bet)
Seat 5: 17f79555 folded before Flop (didn't bet)
Seat 6: 111c75 folded before Flop (didn't bet)


Poker Hand #RC3141669640: Hold'em No Limit ($0.05/$0.1) - 2024/12/12 12:43:36
Table 'RushAndCash22314900' 6-max Seat #1 is the button
Seat 1: 4684e24a ($26.77 in chips)
Seat 2: Hero ($10 in chips)
Seat 3: 54a8e111 ($10.15 in chips)
Seat 4: 5304ad76 ($10 in chips)
Seat 5: 40c5a5bd ($10 in chips)
Seat 6: 228a039d ($11.86 in chips)
Hero: posts small blind $0.05
54a8e111: posts big blind $0.1
*** HOLE CARDS ***
Dealt to 4684e24a 
Dealt to Hero [3h 2s]
Dealt to 54a8e111 
Dealt to 5304ad76 
Dealt to 40c5a5bd 
Dealt to 228a039d 
5304ad76: raises $0.1 to $0.2
40c5a5bd: folds
228a039d: raises $0.6 to $0.8
4684e24a: folds
Hero: folds
54a8e111: folds
5304ad76: folds
Uncalled bet ($0.6) returned to 228a039d
*** SHOWDOWN ***
228a039d collected $0.53 from pot
*** SUMMARY ***
Total pot $0.55 | Rake $0.02 | Jackpot $0 | Bingo $0 | Fortune $0 | Tax $0
Seat 1: 4684e24a (button) folded before Flop (didn't bet)
Seat 2: Hero (small blind) folded before Flop
Seat 3: 54a8e111 (big blind) folded before Flop
Seat 4: 5304ad76 folded before Flop
Seat 5: 40c5a5bd folded before Flop (didn't bet)
Seat 6: 228a039d collected ($0.53)


Poker Hand #RC3141669572: Hold'em No Limit ($0.05/$0.1) - 2024/12/12 12:43:20
Table 'RushAndCash22314832' 6-max Seat #1 is the button
Seat 1: a730cdce ($10 in chips)
Seat 2: cc8462b1 ($12.96 in chips)
Seat 3: Hero ($10 in chips)
Seat 4: be885022 ($16.11 in chips)
Seat 5: 4cf42699 ($10.33 in chips)
Seat 6: 92e8bfbd ($26.08 in chips)
cc8462b1: posts small blind $0.05
Hero: posts big blind $0.1
*** HOLE CARDS ***
Dealt to a730cdce 
Dealt to cc8462b1 
Dealt to Hero [4s Ks]
Dealt to be885022 
Dealt to 4cf42699 
Dealt to 92e8bfbd 
be885022: folds
4cf42699: folds
92e8bfbd: folds
a730cdce: folds
cc8462b1: raises $0.2 to $0.3
Hero: folds
Uncalled bet ($0.2) returned to cc8462b1
*** SHOWDOWN ***
cc8462b1 collected $0.2 from pot
*** SUMMARY ***
Total pot $0.2 | Rake $0 | Jackpot $0 | Bingo $0 | Fortune $0 | Tax $0
Seat 1: a730cdce (button) folded before Flop (didn't bet)
Seat 2: cc8462b1 (small blind) collected ($0.2)
Seat 3: Hero (big blind) folded before Flop
Seat 4: be885022 folded before Flop (didn't bet)
Seat 5: 4cf42699 folded before Flop (didn't bet)
Seat 6: 92e8bfbd folded before Flop (didn't bet)


Poker Hand #RC3141669556: Hold'em No Limit ($0.05/$0.1) - 2024/12/12 12:43:17
Table 'RushAndCash22314816' 6-max Seat #1 is the button
Seat 1: Hero ($10 in chips)
Seat 2: deec756a ($10.1 in chips)
Seat 3: 59de94fc ($14.86 in chips)
Seat 4: 46e6c699 ($6.36 in chips)
Seat 5: b4bc8071 ($12.85 in chips)
Seat 6: cacc74b2 ($10.07 in chips)
deec756a: posts small blind $0.05
59de94fc: posts big blind $0.1
*** HOLE CARDS ***
Dealt to Hero [2d 5c]
Dealt to deec756a 
Dealt to 59de94fc 
Dealt to 46e6c699 
Dealt to b4bc8071 
Dealt to cacc74b2 
46e6c699: folds
b4bc8071: folds
cacc74b2: raises $0.11 to $0.21
Hero: folds
deec756a: folds
59de94fc: calls $0.11
*** FLOP *** [Ts 9h 7s]
59de94fc: checks
cacc74b2: bets $0.15
59de94fc: folds
Uncalled bet ($0.15) returned to cacc74b2
*** SHOWDOWN ***
cacc74b2 collected $0.45 from pot
*** SUMMARY ***
Total pot $0.47 | Rake $0.02 | Jackpot $0 | Bingo $0 | Fortune $0 | Tax $0
Board [Ts 9h 7s]
Seat 1: Hero (button) folded before Flop (didn't bet)
Seat 2: deec756a (small blind) folded before Flop
Seat 3: 59de94fc (big blind) folded on the Flop
Seat 4: 46e6c699 folded before Flop (didn't bet)
Seat 5: b4bc8071 folded before Flop (didn't bet)
Seat 6: cacc74b2 won ($0.45)


Poker Hand #RC3141669539: Hold'em No Limit ($0.05/$0.1) - 2024/12/12 12:43:13
Table 'RushAndCash22314799' 6-max Seat #1 is the button
Seat 1: 11a00985 ($23.56 in chips)
Seat 2: 4684e24a ($26.92 in chips)
Seat 3: 92e8bfbd ($26.18 in chips)
Seat 4: 46e6c699 ($6.36 in chips)
Seat 5: Hero ($10 in chips)
Seat 6: dbcd9107 ($17.29 in chips)
4684e24a: posts small blind $0.05
92e8bfbd: posts big blind $0.1
*** HOLE CARDS ***
Dealt to 11a00985 
Dealt to 4684e24a 
Dealt to 92e8bfbd 
Dealt to 46e6c699 
Dealt to Hero [7d Kh]
Dealt to dbcd9107 
46e6c699: folds
Hero: folds
dbcd9107: raises $0.1 to $0.2
11a00985: folds
4684e24a: folds
92e8bfbd: folds
Uncalled bet ($0.1) returned to dbcd9107
*** SHOWDOWN ***
dbcd9107 collected $0.25 from pot
*** SUMMARY ***
Total pot $0.25 | Rake $0 | Jackpot $0 | Bingo $0 | Fortune $0 | Tax $0
Seat 1: 11a00985 (button) folded before Flop (didn't bet)
Seat 2: 4684e24a (small blind) folded before Flop
Seat 3: 92e8bfbd (big blind) folded before Flop
Seat 4: 46e6c699 folded before Flop (didn't bet)
Seat 5: Hero folded before Flop (didn't bet)
Seat 6: dbcd9107 collected ($0.25)


Poker Hand #RC3141669509: Hold'em No Limit ($0.05/$0.1) - 2024/12/12 12:43:06
Table 'RushAndCash22314769' 6-max Seat #1 is the button
Seat 1: 77907fc4 ($25.42 in chips)
Seat 2: cc63da9c ($15.68 in chips)
Seat 3: 6fcf7795 ($25.98 in chips)
Seat 4: aee2ed20 ($10 in chips)
Seat 5: Hero ($10 in chips)
Seat 6: 8cfa2620 ($19.68 in chips)
cc63da9c: posts small blind $0.05
6fcf7795: posts big blind $0.1
*** HOLE CARDS ***
Dealt to 77907fc4 
Dealt to cc63da9c 
Dealt to 6fcf7795 
Dealt to aee2ed20 
Dealt to Hero [8d Ah]
Dealt to 8cfa2620 
aee2ed20: folds
Hero: folds
8cfa2620: folds
77907fc4: folds
cc63da9c: folds
Uncalled bet ($0.05) returned to 6fcf7795
*** SHOWDOWN ***
6fcf7795 collected $0.1 from pot
*** SUMMARY ***
Total pot $0.1 | Rake $0 | Jackpot $0 | Bingo $0 | Fortune $0 | Tax $0
Seat 1: 77907fc4 (button) folded before Flop (didn't bet)
Seat 2: cc63da9c (small blind) folded before Flop
Seat 3: 6fcf7795 (big blind) collected ($0.1)
Seat 4: aee2ed20 folded before Flop (didn't bet)
Seat 5: Hero folded before Flop (didn't bet)
Seat 6: 8cfa2620 folded before Flop (didn't bet)


Poker Hand #RC3141669267: Hold'em No Limit ($0.05/$0.1) - 2024/12/12 12:42:09
Table 'RushAndCash22314527' 6-max Seat #1 is the button
Seat 1: Hero ($10.08 in chips)
Seat 2: f3cd242a ($11.85 in chips)
Seat 3: 5783aa3 ($11.89 in chips)
Seat 4: d827b781 ($14.13 in chips)
Seat 5: ac65db07 ($10.76 in chips)
Seat 6: 332b855c ($10.17 in chips)
f3cd242a: posts small blind $0.05
5783aa3: posts big blind $0.1
*** HOLE CARDS ***
Dealt to Hero [Qc Qs]
Dealt to f3cd242a 
Dealt to 5783aa3 
Dealt to d827b781 
Dealt to ac65db07 
Dealt to 332b855c 
d827b781: folds
ac65db07: folds
332b855c: raises $0.16 to $0.26
Hero: raises $0.51 to $0.77
f3cd242a: folds
5783aa3: folds
332b855c: calls $0.51
*** FLOP *** [Ah Kc 4c]
332b855c: checks
Hero: bets $0.43
332b855c: calls $0.43
*** TURN *** [Ah Kc 4c] [8c]
332b855c: checks
Hero: checks
*** RIVER *** [Ah Kc 4c 8c] [5h]
332b855c: bets $1.41
Hero: folds
Uncalled bet ($1.41) returned to 332b855c
*** SHOWDOWN ***
332b855c collected $2.43 from pot
*** SUMMARY ***
Total pot $2.55 | Rake $0.12 | Jackpot $0 | Bingo $0 | Fortune $0 | Tax $0
Board [Ah Kc 4c 8c 5h]
Seat 1: Hero (button) folded on the River
Seat 2: f3cd242a (small blind) folded before Flop
Seat 3: 5783aa3 (big blind) folded before Flop
Seat 4: d827b781 folded before Flop (didn't bet)
Seat 5: ac65db07 folded before Flop (didn't bet)
Seat 6: 332b855c won ($2.43)


Poker Hand #RC3141669169: Hold'em No Limit ($0.05/$0.1) - 2024/12/12 12:41:45
Table 'RushAndCash22314429' 6-max Seat #1 is the button
Seat 1: ac65db07 ($10.43 in chips)
Seat 2: 17b381d5 ($25.32 in chips)
Seat 3: b2132e5f ($10.93 in chips)
Seat 4: ee394d0a ($10.15 in chips)
Seat 5: Hero ($10.28 in chips)
Seat 6: 73e84fa ($27.6 in chips)
17b381d5: posts small blind $0.05
b2132e5f: posts big blind $0.1
*** HOLE CARDS ***
Dealt to ac65db07 
Dealt to 17b381d5 
Dealt to b2132e5f 
Dealt to ee394d0a 
Dealt to Hero [Kc 9c]
Dealt to 73e84fa 
ee394d0a: folds
Hero: raises $0.1 to $0.2
73e84fa: folds
ac65db07: raises $0.42 to $0.62
17b381d5: folds
b2132e5f: folds
Hero: folds
Uncalled bet ($0.42) returned to ac65db07
*** SHOWDOWN ***
ac65db07 collected $0.53 from pot
*** SUMMARY ***
Total pot $0.55 | Rake $0.02 | Jackpot $0 | Bingo $0 | Fortune $0 | Tax $0
Seat 1: ac65db07 (button) collected ($0.53)
Seat 2: 17b381d5 (small blind) folded before Flop
Seat 3: b2132e5f (big blind) folded before Flop
Seat 4: ee394d0a folded before Flop (didn't bet)
Seat 5: Hero folded before Flop
Seat 6: 73e84fa folded before Flop (didn't bet)


Poker Hand #RC3141669134: Hold'em No Limit ($0.05/$0.1) - 2024/12/12 12:41:36
Table 'RushAndCash22314394' 6-max Seat #1 is the button
Seat 1: 9a52083d ($25.03 in chips)
Seat 2: cc8462b1 ($10.87 in chips)
Seat 3: Hero ($10.38 in chips)
Seat 4: 86cef673 ($27.09 in chips)
Seat 5: b17f5bfe ($6.43 in chips)
Seat 6: 6ea7e0fb ($6.37 in chips)
cc8462b1: posts small blind $0.05
Hero: posts big blind $0.1
*** HOLE CARDS ***
Dealt to 9a52083d 
Dealt to cc8462b1 
Dealt to Hero [4c 2c]
Dealt to 86cef673 
Dealt to b17f5bfe 
Dealt to 6ea7e0fb 
86cef673: folds
b17f5bfe: folds
6ea7e0fb: raises $0.3 to $0.4
9a52083d: folds
cc8462b1: folds
Hero: folds
Uncalled bet ($0.3) returned to 6ea7e0fb
*** SHOWDOWN ***
6ea7e0fb collected $0.25 from pot
*** SUMMARY ***
Total pot $0.25 | Rake $0 | Jackpot $0 | Bingo $0 | Fortune $0 | Tax $0
Seat 1: 9a52083d (button) folded before Flop (didn't bet)
Seat 2: cc8462b1 (small blind) folded before Flop
Seat 3: Hero (big blind) folded before Flop
Seat 4: 86cef673 folded before Flop (didn't bet)
Seat 5: b17f5bfe folded before Flop (didn't bet)
Seat 6: 6ea7e0fb collected ($0.25)


Poker Hand #RC3141669117: Hold'em No Limit ($0.05/$0.1) - 2024/12/12 12:41:33
Table 'RushAndCash22314377' 6-max Seat #1 is the button
Seat 1: 574859ba ($10.24 in chips)
Seat 2: Hero ($10.43 in chips)
Seat 3: 4746887d ($11.32 in chips)
Seat 4: 86cef673 ($27.09 in chips)
Seat 5: 73df44d1 ($10 in chips)
Seat 6: 9c5748d ($22 in chips)
Hero: posts small blind $0.05
4746887d: posts big blind $0.1
*** HOLE CARDS ***
Dealt to 574859ba 
Dealt to Hero [7c Td]
Dealt to 4746887d 
Dealt to 86cef673 
Dealt to 73df44d1 
Dealt to 9c5748d 
86cef673: folds
73df44d1: raises $0.1 to $0.2
9c5748d: raises $0.55 to $0.75
574859ba: folds
Hero: folds
4746887d: folds
73df44d1: raises $1.24 to $1.99
9c5748d: folds
Uncalled bet ($1.24) returned to 73df44d1
*** SHOWDOWN ***
73df44d1 collected $1.57 from pot
*** SUMMARY ***
Total pot $1.65 | Rake $0.08 | Jackpot $0 | Bingo $0 | Fortune $0 | Tax $0
Seat 1: 574859ba (button) folded before Flop (didn't bet)
Seat 2: Hero (small blind) folded before Flop
Seat 3: 4746887d (big blind) folded before Flop
Seat 4: 86cef673 folded before Flop (didn't bet)
Seat 5: 73df44d1 collected ($1.57)
Seat 6: 9c5748d folded before Flop


Poker Hand #RC3141668666: Hold'em No Limit ($0.05/$0.1) - 2024/12/12 12:39:45
Table 'RushAndCash22313926' 6-max Seat #1 is the button
Seat 1: a8e8a7b5 ($12.15 in chips)
Seat 2: 4db3d050 ($6.97 in chips)
Seat 3: 4b1c7e7e ($11.47 in chips)
Seat 4: Hero ($11.2 in chips)
Seat 5: b9463896 ($10.25 in chips)
Seat 6: 574859ba ($10 in chips)
4db3d050: posts small blind $0.05
4b1c7e7e: posts big blind $0.1
*** HOLE CARDS ***
Dealt to a8e8a7b5 
Dealt to 4db3d050 
Dealt to 4b1c7e7e 
Dealt to Hero [Kd 9d]
Dealt to b9463896 
Dealt to 574859ba 
Hero: raises $0.1 to $0.2
b9463896: folds
574859ba: folds
a8e8a7b5: folds
4db3d050: calls $0.15
4b1c7e7e: folds
*** FLOP *** [8h Jh Qd]
4db3d050: checks
Hero: bets $0.17
4db3d050: calls $0.17
*** TURN *** [8h Jh Qd] [6d]
4db3d050: checks
Hero: bets $0.4
4db3d050: calls $0.4
*** RIVER *** [8h Jh Qd 6d] [5s]
4db3d050: checks
Hero: checks
4db3d050: shows [7s Qs] (Pair of Queens)
Hero: shows [Kd 9d] (King-High)
*** SHOWDOWN ***
4db3d050 collected $1.56 from pot
*** SUMMARY ***
Total pot $1.64 | Rake $0.08 | Jackpot $0 | Bingo $0 | Fortune $0 | Tax $0
Board [8h Jh Qd 6d 5s]
Seat 1: a8e8a7b5 (button) folded before Flop (didn't bet)
Seat 2: 4db3d050 (small blind) showed [7s Qs] and won ($1.56) with Pair of Queens
Seat 3: 4b1c7e7e (big blind) folded before Flop
Seat 4: Hero showed [Kd 9d] and lost with King-High
Seat 5: b9463896 folded before Flop (didn't bet)
Seat 6: 574859ba folded before Flop (didn't bet)


Poker Hand #RC3141668636: Hold'em No Limit ($0.05/$0.1) - 2024/12/12 12:39:38
Table 'RushAndCash22313896' 6-max Seat #1 is the button
Seat 1: b8e03e64 ($10 in chips)
Seat 2: 1a8ef95a ($17.75 in chips)
Seat 3: 3954586d ($10 in chips)
Seat 4: 75ae83f ($10 in chips)
Seat 5: 4b1c7e7e ($11.47 in chips)
Seat 6: Hero ($11.2 in chips)
1a8ef95a: posts small blind $0.05
3954586d: posts big blind $0.1
*** HOLE CARDS ***
Dealt to b8e03e64 
Dealt to 1a8ef95a 
Dealt to 3954586d 
Dealt to 75ae83f 
Dealt to 4b1c7e7e 
Dealt to Hero [Tc 7c]
75ae83f: raises $0.12 to $0.22
4b1c7e7e: folds
Hero: folds
b8e03e64: folds
1a8ef95a: folds
3954586d: folds
Uncalled bet ($0.12) returned to 75ae83f
*** SHOWDOWN ***
75ae83f collected $0.25 from pot
*** SUMMARY ***
Total pot $0.25 | Rake $0 | Jackpot $0 | Bingo $0 | Fortune $0 | Tax $0
Seat 1: b8e03e64 (button) folded before Flop (didn't bet)
Seat 2: 1a8ef95a (small blind) folded before Flop
Seat 3: 3954586d (big blind) folded before Flop
Seat 4: 75ae83f collected ($0.25)
Seat 5: 4b1c7e7e folded before Flop (didn't bet)
Seat 6: Hero folded before Flop (didn't bet)


Poker Hand #RC3141668620: Hold'em No Limit ($0.05/$0.1) - 2024/12/12 12:39:35
Table 'RushAndCash22313880' 6-max Seat #1 is the button
Seat 1: ae47099b ($18.29 in chips)
Seat 2: 727ed023 ($7.2 in chips)
Seat 3: a730cdce ($10.37 in chips)
Seat 4: Hero ($11.2 in chips)
Seat 5: b9a180bb ($10 in chips)
Seat 6: 73e84fa ($27.11 in chips)
727ed023: posts small blind $0.05
a730cdce: posts big blind $0.1
*** HOLE CARDS ***
Dealt to ae47099b 
Dealt to 727ed023 
Dealt to a730cdce 
Dealt to Hero [6d 7c]
Dealt to b9a180bb 
Dealt to 73e84fa 
Hero: folds
b9a180bb: raises $0.12 to $0.22
73e84fa: folds
ae47099b: folds
727ed023: folds
a730cdce: folds
Uncalled bet ($0.12) returned to b9a180bb
*** SHOWDOWN ***
b9a180bb collected $0.25 from pot
*** SUMMARY ***
Total pot $0.25 | Rake $0 | Jackpot $0 | Bingo $0 | Fortune $0 | Tax $0
Seat 1: ae47099b (button) folded before Flop (didn't bet)
Seat 2: 727ed023 (small blind) folded before Flop
Seat 3: a730cdce (big blind) folded before Flop
Seat 4: Hero folded before Flop (didn't bet)
Seat 5: b9a180bb collected ($0.25)
Seat 6: 73e84fa folded before Flop (didn't bet)


Poker Hand #RC3141668601: Hold'em No Limit ($0.05/$0.1) - 2024/12/12 12:39:30
Table 'RushAndCash22313861' 6-max Seat #1 is the button
Seat 1: Hero ($11.2 in chips)
Seat 2: 4eb4d0d6 ($8.77 in chips)
Seat 3: 1a8ef95a ($17.85 in chips)
Seat 4: e7a93172 ($10 in chips)
Seat 5: 73e84fa ($27.11 in chips)
Seat 6: 8a9b1992 ($11.04 in chips)
4eb4d0d6: posts small blind $0.05
1a8ef95a: posts big blind $0.1
*** HOLE CARDS ***
Dealt to Hero [4h Tc]
Dealt to 4eb4d0d6 
Dealt to 1a8ef95a 
Dealt to e7a93172 
Dealt to 73e84fa 
Dealt to 8a9b1992 
e7a93172: folds
73e84fa: folds
8a9b1992: folds
Hero: folds
4eb4d0d6: raises $0.1 to $0.2
1a8ef95a: folds
Uncalled bet ($0.1) returned to 4eb4d0d6
*** SHOWDOWN ***
4eb4d0d6 collected $0.2 from pot
*** SUMMARY ***
Total pot $0.2 | Rake $0 | Jackpot $0 | Bingo $0 | Fortune $0 | Tax $0
Seat 1: Hero (button) folded before Flop (didn't bet)
Seat 2: 4eb4d0d6 (small blind) collected ($0.2)
Seat 3: 1a8ef95a (big blind) folded before Flop
Seat 4: e7a93172 folded before Flop (didn't bet)
Seat 5: 73e84fa folded before Flop (didn't bet)
Seat 6: 8a9b1992 folded before Flop (didn't bet)


Poker Hand #RC3141668563: Hold'em No Limit ($0.05/$0.1) - 2024/12/12 12:39:20
Table 'RushAndCash22313823' 6-max Seat #1 is the button
Seat 1: 2746c1f0 ($12.44 in chips)
Seat 2: 78428b92 ($49.92 in chips)
Seat 3: Hero ($11.3 in chips)
Seat 4: 5041f166 ($5.21 in chips)
Seat 5: 1d37642 ($7.78 in chips)
Seat 6: 81834a2f ($21.63 in chips)
78428b92: posts small blind $0.05
Hero: posts big blind $0.1
*** HOLE CARDS ***
Dealt to 2746c1f0 
Dealt to 78428b92 
Dealt to Hero [6c Jh]
Dealt to 5041f166 
Dealt to 1d37642 
Dealt to 81834a2f 
5041f166: raises $0.1 to $0.2
1d37642: folds
81834a2f: folds
2746c1f0: raises $0.5 to $0.7
78428b92: folds
Hero: folds
5041f166: calls $0.5
*** FLOP *** [8d 2d 3c]
5041f166: checks
2746c1f0: checks
*** TURN *** [8d 2d 3c] [8c]
5041f166: bets $0.78
2746c1f0: folds
Uncalled bet ($0.78) returned to 5041f166
*** SHOWDOWN ***
5041f166 collected $1.48 from pot
*** SUMMARY ***
Total pot $1.55 | Rake $0.07 | Jackpot $0 | Bingo $0 | Fortune $0 | Tax $0
Board [8d 2d 3c 8c]
Seat 1: 2746c1f0 (button) folded on the Turn
Seat 2: 78428b92 (small blind) folded before Flop
Seat 3: Hero (big blind) folded before Flop
Seat 4: 5041f166 won ($1.48)
Seat 5: 1d37642 folded before Flop (didn't bet)
Seat 6: 81834a2f folded before Flop (didn't bet)


Poker Hand #RC3141668527: Hold'em No Limit ($0.05/$0.1) - 2024/12/12 12:39:11
Table 'RushAndCash22313787' 6-max Seat #1 is the button
Seat 1: 727ed023 ($7.2 in chips)
Seat 2: Hero ($11.35 in chips)
Seat 3: ee992e7e ($10.15 in chips)
Seat 4: b0f074bd ($11.35 in chips)
Seat 5: c05b084c ($10 in chips)
Seat 6: cea6b02d ($10 in chips)
Hero: posts small blind $0.05
ee992e7e: posts big blind $0.1
*** HOLE CARDS ***
Dealt to 727ed023 
Dealt to Hero [9c Tc]
Dealt to ee992e7e 
Dealt to b0f074bd 
Dealt to c05b084c 
Dealt to cea6b02d 
b0f074bd: folds
c05b084c: folds
cea6b02d: raises $0.11 to $0.21
727ed023: folds
Hero: folds
ee992e7e: folds
Uncalled bet ($0.11) returned to cea6b02d
*** SHOWDOWN ***
cea6b02d collected $0.25 from pot
*** SUMMARY ***
Total pot $0.25 | Rake $0 | Jackpot $0 | Bingo $0 | Fortune $0 | Tax $0
Seat 1: 727ed023 (button) folded before Flop (didn't bet)
Seat 2: Hero (small blind) folded before Flop
Seat 3: ee992e7e (big blind) folded before Flop
Seat 4: b0f074bd folded before Flop (didn't bet)
Seat 5: c05b084c folded before Flop (didn't bet)
Seat 6: cea6b02d collected ($0.25)


Poker Hand #RC3141668476: Hold'em No Limit ($0.05/$0.1) - 2024/12/12 12:38:59
Table 'RushAndCash22313736' 6-max Seat #1 is the button
Seat 1: c05b084c ($10 in chips)
Seat 2: 9ef3daf1 ($10 in chips)
Seat 3: bc8cb2ed ($9.92 in chips)
Seat 4: Hero ($11.35 in chips)
Seat 5: 1a8ef95a ($17.53 in chips)
Seat 6: 1ecd1474 ($10 in chips)
9ef3daf1: posts small blind $0.05
bc8cb2ed: posts big blind $0.1
*** HOLE CARDS ***
Dealt to c05b084c 
Dealt to 9ef3daf1 
Dealt to bc8cb2ed 
Dealt to Hero [Ah 9s]
Dealt to 1a8ef95a 
Dealt to 1ecd1474 
Hero: folds
1a8ef95a: folds
1ecd1474: raises $0.12 to $0.22
c05b084c: folds
9ef3daf1: folds
bc8cb2ed: calls $0.12
*** FLOP *** [Qd 9d Td]
bc8cb2ed: checks
1ecd1474: bets $0.1
bc8cb2ed: calls $0.1
*** TURN *** [Qd 9d Td] [Qc]
bc8cb2ed: bets $0.35
1ecd1474: calls $0.35
*** RIVER *** [Qd 9d Td Qc] [Jd]
bc8cb2ed: checks
1ecd1474: bets $1.88
bc8cb2ed: folds
Uncalled bet ($1.88) returned to 1ecd1474
*** SHOWDOWN ***
1ecd1474 collected $1.32 from pot
*** SUMMARY ***
Total pot $1.39 | Rake $0.07 | Jackpot $0 | Bingo $0 | Fortune $0 | Tax $0
Board [Qd 9d Td Qc Jd]
Seat 1: c05b084c (button) folded before Flop (didn't bet)
Seat 2: 9ef3daf1 (small blind) folded before Flop
Seat 3: bc8cb2ed (big blind) folded on the River
Seat 4: Hero folded before Flop (didn't bet)
Seat 5: 1a8ef95a folded before Flop (didn't bet)
Seat 6: 1ecd1474 won ($1.32)


Poker Hand #RC3141668440: Hold'em No Limit ($0.05/$0.1) - 2024/12/12 12:38:50
Table 'RushAndCash22313700' 6-max Seat #1 is the button
Seat 1: fc90d2af ($1.48 in chips)
Seat 2: 3b9132dc ($10.3 in chips)
Seat 3: 5d654b2c ($11.3 in chips)
Seat 4: d578ebdd ($10 in chips)
Seat 5: Hero ($11.35 in chips)
Seat 6: ff98cbcb ($24.09 in chips)
3b9132dc: posts small blind $0.05
5d654b2c: posts big blind $0.1
*** HOLE CARDS ***
Dealt to fc90d2af 
Dealt to 3b9132dc 
Dealt to 5d654b2c 
Dealt to d578ebdd 
Dealt to Hero [Ah 5s]
Dealt to ff98cbcb 
d578ebdd: raises $0.1 to $0.2
Hero: folds
ff98cbcb: calls $0.2
fc90d2af: folds
3b9132dc: folds
5d654b2c: folds
*** FLOP *** [7d Ts 9h]
d578ebdd: checks
ff98cbcb: checks
*** TURN *** [7d Ts 9h] [8d]
d578ebdd: checks
ff98cbcb: bets $0.42
d578ebdd: raises $0.7 to $1.12
ff98cbcb: calls $0.7
*** RIVER *** [7d Ts 9h 8d] [2h]
d578ebdd: checks
ff98cbcb: bets $2.1
d578ebdd: folds
Uncalled bet ($2.1) returned to ff98cbcb
*** SHOWDOWN ***
ff98cbcb collected $2.65 from pot
*** SUMMARY ***
Total pot $2.79 | Rake $0.14 | Jackpot $0 | Bingo $0 | Fortune $0 | Tax $0
Board [7d Ts 9h 8d 2h]
Seat 1: fc90d2af (button) folded before Flop (didn't bet)
Seat 2: 3b9132dc (small blind) folded before Flop
Seat 3: 5d654b2c (big blind) folded before Flop
Seat 4: d578ebdd folded on the River
Seat 5: Hero folded before Flop (didn't bet)
Seat 6: ff98cbcb won ($2.65)


Poker Hand #RC3141668426: Hold'em No Limit ($0.05/$0.1) - 2024/12/12 12:38:47
Table 'RushAndCash22313686' 6-max Seat #1 is the button
Seat 1: Hero ($11.35 in chips)
Seat 2: 19a0d06d ($2.11 in chips)
Seat 3: 9c5748d ($23.67 in chips)
Seat 4: 12b883d0 ($26.06 in chips)
Seat 5: ff98cbcb ($24.09 in chips)
Seat 6: 66793bbe ($5.9 in chips)
19a0d06d: posts small blind $0.05
9c5748d: posts big blind $0.1
*** HOLE CARDS ***
Dealt to Hero [3s 8h]
Dealt to 19a0d06d 
Dealt to 9c5748d 
Dealt to 12b883d0 
Dealt to ff98cbcb 
Dealt to 66793bbe 
12b883d0: folds
ff98cbcb: folds
66793bbe: raises $0.12 to $0.22
Hero: folds
19a0d06d: folds
9c5748d: calls $0.12
*** FLOP *** [4s Jd 6d]
9c5748d: checks
66793bbe: bets $0.15
9c5748d: calls $0.15
*** TURN *** [4s Jd 6d] [7h]
9c5748d: checks
66793bbe: bets $1.15
9c5748d: calls $1.15
*** RIVER *** [4s Jd 6d 7h] [9c]
9c5748d: checks
66793bbe: bets $4.38 and is all-in
9c5748d: folds
Uncalled bet ($4.38) returned to 66793bbe
*** SHOWDOWN ***
66793bbe collected $2.8 from pot
*** SUMMARY ***
Total pot $3.09 | Rake $0.14 | Jackpot $0.15 | Bingo $0 | Fortune $0 | Tax $0
Board [4s Jd 6d 7h 9c]
Seat 1: Hero (button) folded before Flop (didn't bet)
Seat 2: 19a0d06d (small blind) folded before Flop
Seat 3: 9c5748d (big blind) folded on the River
Seat 4: 12b883d0 folded before Flop (didn't bet)
Seat 5: ff98cbcb folded before Flop (didn't bet)
Seat 6: 66793bbe won ($2.8)


Poker Hand #RC3141668371: Hold'em No Limit ($0.05/$0.1) - 2024/12/12 12:38:31
Table 'RushAndCash22313631' 6-max Seat #1 is the button
Seat 1: b73e1c09 ($25.19 in chips)
Seat 2: Hero ($11.4 in chips)
Seat 3: 3c75bc00 ($32.49 in chips)
Seat 4: e7a93172 ($10 in chips)
Seat 5: cd32f772 ($6.28 in chips)
Seat 6: d07ab82c ($11.38 in chips)
Hero: posts small blind $0.05
3c75bc00: posts big blind $0.1
*** HOLE CARDS ***
Dealt to b73e1c09 
Dealt to Hero [Ks 5d]
Dealt to 3c75bc00 
Dealt to e7a93172 
Dealt to cd32f772 
Dealt to d07ab82c 
e7a93172: raises $0.15 to $0.25
cd32f772: calls $0.25
d07ab82c: folds
b73e1c09: folds
Hero: folds
3c75bc00: folds
*** FLOP *** [8h 4d Kd]
e7a93172: checks
cd32f772: checks
*** TURN *** [8h 4d Kd] [2c]
e7a93172: bets $0.22
cd32f772: calls $0.22
*** RIVER *** [8h 4d Kd 2c] [Qh]
e7a93172: checks
cd32f772: bets $1.09
e7a93172: folds
Uncalled bet ($1.09) returned to cd32f772
*** SHOWDOWN ***
cd32f772 collected $1.03 from pot
*** SUMMARY ***
Total pot $1.09 | Rake $0.06 | Jackpot $0 | Bingo $0 | Fortune $0 | Tax $0
Board [8h 4d Kd 2c Qh]
Seat 1: b73e1c09 (button) folded before Flop (didn't bet)
Seat 2: Hero (small blind) folded before Flop
Seat 3: 3c75bc00 (big blind) folded before Flop
Seat 4: e7a93172 folded on the River
Seat 5: cd32f772 won ($1.03)
Seat 6: d07ab82c folded before Flop (didn't bet)


Poker Hand #RC3141668321: Hold'em No Limit ($0.05/$0.1) - 2024/12/12 12:38:18
Table 'RushAndCash22313581' 6-max Seat #1 is the button
Seat 1: cc63da9c ($10 in chips)
Seat 2: 84c34548 ($11.44 in chips)
Seat 3: Hero ($11.5 in chips)
Seat 4: c6f4a662 ($10.82 in chips)
Seat 5: ae47099b ($18.54 in chips)
Seat 6: 9ef3daf1 ($10 in chips)
84c34548: posts small blind $0.05
Hero: posts big blind $0.1
*** HOLE CARDS ***
Dealt to cc63da9c 
Dealt to 84c34548 
Dealt to Hero [2c As]
Dealt to c6f4a662 
Dealt to ae47099b 
Dealt to 9ef3daf1 
c6f4a662: folds
ae47099b: folds
9ef3daf1: raises $0.1 to $0.2
cc63da9c: folds
84c34548: folds
Hero: folds
Uncalled bet ($0.1) returned to 9ef3daf1
*** SHOWDOWN ***
9ef3daf1 collected $0.25 from pot
*** SUMMARY ***
Total pot $0.25 | Rake $0 | Jackpot $0 | Bingo $0 | Fortune $0 | Tax $0
Seat 1: cc63da9c (button) folded before Flop (didn't bet)
Seat 2: 84c34548 (small blind) folded before Flop
Seat 3: Hero (big blind) folded before Flop
Seat 4: c6f4a662 folded before Flop (didn't bet)
Seat 5: ae47099b folded before Flop (didn't bet)
Seat 6: 9ef3daf1 collected ($0.25)


Poker Hand #RC3141668275: Hold'em No Limit ($0.05/$0.1) - 2024/12/12 12:38:06
Table 'RushAndCash22313535' 6-max Seat #1 is the button
Seat 1: 5ab2e15d ($10.15 in chips)
Seat 2: bc2007a2 ($11.32 in chips)
Seat 3: 4b728c96 ($15.4 in chips)
Seat 4: 3b768af1 ($10.9 in chips)
Seat 5: 81834a2f ($21.78 in chips)
Seat 6: Hero ($11.5 in chips)
bc2007a2: posts small blind $0.05
4b728c96: posts big blind $0.1
*** HOLE CARDS ***
Dealt to 5ab2e15d 
Dealt to bc2007a2 
Dealt to 4b728c96 
Dealt to 3b768af1 
Dealt to 81834a2f 
Dealt to Hero [6h Th]
3b768af1: folds
81834a2f: folds
Hero: folds
5ab2e15d: raises $0.12 to $0.22
bc2007a2: folds
4b728c96: calls $0.12
*** FLOP *** [5d 9h 4c]
4b728c96: checks
5ab2e15d: checks
*** TURN *** [5d 9h 4c] [Js]
4b728c96: checks
5ab2e15d: checks
*** RIVER *** [5d 9h 4c Js] [7s]
4b728c96: bets $0.37
5ab2e15d: calls $0.37
4b728c96: shows [7c 7d] (Three Sevens)
5ab2e15d: shows [8d 8h] (Pair of Eights)
*** SHOWDOWN ***
4b728c96 collected $1.17 from pot
*** SUMMARY ***
Total pot $1.23 | Rake $0.06 | Jackpot $0 | Bingo $0 | Fortune $0 | Tax $0
Board [5d 9h 4c Js 7s]
Seat 1: 5ab2e15d (button) showed [8d 8h] and lost with Pair of Eights
Seat 2: bc2007a2 (small blind) folded before Flop
Seat 3: 4b728c96 (big blind) showed [7c 7d] and won ($1.17) with Three Sevens
Seat 4: 3b768af1 folded before Flop (didn't bet)
Seat 5: 81834a2f folded before Flop (didn't bet)
Seat 6: Hero folded before Flop (didn't bet)


Poker Hand #RC3141668221: Hold'em No Limit ($0.05/$0.1) - 2024/12/12 12:37:49
Table 'RushAndCash22313481' 6-max Seat #1 is the button
Seat 1: 84849e11 ($83.7 in chips)
Seat 2: a9eb45fc ($10.28 in chips)
Seat 3: aaca7529 ($5.01 in chips)
Seat 4: f95a58d4 ($24.35 in chips)
Seat 5: d578ebdd ($10 in chips)
Seat 6: Hero ($11.5 in chips)
a9eb45fc: posts small blind $0.05
aaca7529: posts big blind $0.1
*** HOLE CARDS ***
Dealt to 84849e11 
Dealt to a9eb45fc 
Dealt to aaca7529 
Dealt to f95a58d4 
Dealt to d578ebdd 
Dealt to Hero [2d 8c]
f95a58d4: folds
d578ebdd: folds
Hero: folds
84849e11: raises $0.2 to $0.3
a9eb45fc: folds
aaca7529: folds
Uncalled bet ($0.2) returned to 84849e11
*** SHOWDOWN ***
84849e11 collected $0.25 from pot
*** SUMMARY ***
Total pot $0.25 | Rake $0 | Jackpot $0 | Bingo $0 | Fortune $0 | Tax $0
Seat 1: 84849e11 (button) collected ($0.25)
Seat 2: a9eb45fc (small blind) folded before Flop
Seat 3: aaca7529 (big blind) folded before Flop
Seat 4: f95a58d4 folded before Flop (didn't bet)
Seat 5: d578ebdd folded before Flop (didn't bet)
Seat 6: Hero folded before Flop (didn't bet)


Poker Hand #RC3141668187: Hold'em No Limit ($0.05/$0.1) - 2024/12/12 12:37:40
Table 'RushAndCash22313447' 6-max Seat #1 is the button
Seat 1: 24039de0 ($10.4 in chips)
Seat 2: 15f3779a ($10.1 in chips)
Seat 3: 5b982aa5 ($15.29 in chips)
Seat 4: bb835227 ($10.56 in chips)
Seat 5: Hero ($11.35 in chips)
Seat 6: 1dca14f2 ($10.66 in chips)
15f3779a: posts small blind $0.05
5b982aa5: posts big blind $0.1
*** HOLE CARDS ***
Dealt to 24039de0 
Dealt to 15f3779a 
Dealt to 5b982aa5 
Dealt to bb835227 
Dealt to Hero [Ks 9s]
Dealt to 1dca14f2 
bb835227: folds
Hero: raises $0.1 to $0.2
1dca14f2: folds
24039de0: folds
15f3779a: folds
5b982aa5: folds
Uncalled bet ($0.1) returned to Hero
*** SHOWDOWN ***
Hero collected $0.25 from pot
*** SUMMARY ***
Total pot $0.25 | Rake $0 | Jackpot $0 | Bingo $0 | Fortune $0 | Tax $0
Seat 1: 24039de0 (button) folded before Flop (didn't bet)
Seat 2: 15f3779a (small blind) folded before Flop
Seat 3: 5b982aa5 (big blind) folded before Flop
Seat 4: bb835227 folded before Flop (didn't bet)
Seat 5: Hero collected ($0.25)
Seat 6: 1dca14f2 folded before Flop (didn't bet)


Poker Hand #RC3141668147: Hold'em No Limit ($0.05/$0.1) - 2024/12/12 12:37:30
Table 'RushAndCash22313407' 6-max Seat #1 is the button
Seat 1: 6753f046 ($41.86 in chips)
Seat 2: 643f85e7 ($12.86 in chips)
Seat 3: b053d810 ($10.27 in chips)
Seat 4: 9a7505e ($14.35 in chips)
Seat 5: Hero ($11.35 in chips)
Seat 6: daa081a6 ($10.68 in chips)
643f85e7: posts small blind $0.05
b053d810: posts big blind $0.1
*** HOLE CARDS ***
Dealt to 6753f046 
Dealt to 643f85e7 
Dealt to b053d810 
Dealt to 9a7505e 
Dealt to Hero [9d 7d]
Dealt to daa081a6 
9a7505e: folds
Hero: folds
daa081a6: folds
6753f046: folds
643f85e7: raises $0.11 to $0.21
b053d810: raises $0.74 to $0.95
643f85e7: calls $0.74
*** FLOP *** [Qs 8c Kc]
643f85e7: checks
b053d810: bets $0.63
643f85e7: folds
Uncalled bet ($0.63) returned to b053d810
*** SHOWDOWN ***
b053d810 collected $1.81 from pot
*** SUMMARY ***
Total pot $1.9 | Rake $0.09 | Jackpot $0 | Bingo $0 | Fortune $0 | Tax $0
Board [Qs 8c Kc]
Seat 1: 6753f046 (button) folded before Flop (didn't bet)
Seat 2: 643f85e7 (small blind) folded on the Flop
Seat 3: b053d810 (big blind) won ($1.81)
Seat 4: 9a7505e folded before Flop (didn't bet)
Seat 5: Hero folded before Flop (didn't bet)
Seat 6: daa081a6 folded before Flop (didn't bet)


Poker Hand #RC3141667841: Hold'em No Limit ($0.05/$0.1) - 2024/12/12 12:36:17
Table 'RushAndCash22313101' 6-max Seat #1 is the button
Seat 1: Hero ($10 in chips)
Seat 2: 43cdbcd9 ($11.73 in chips)
Seat 3: 71771351 ($13.32 in chips)
Seat 4: 8499417 ($12.87 in chips)
Seat 5: 3e330259 ($10 in chips)
Seat 6: 1039fde1 ($12.54 in chips)
43cdbcd9: posts small blind $0.05
71771351: posts big blind $0.1
*** HOLE CARDS ***
Dealt to Hero [Qh Qd]
Dealt to 43cdbcd9 
Dealt to 71771351 
Dealt to 8499417 
Dealt to 3e330259 
Dealt to 1039fde1 
8499417: raises $0.11 to $0.21
3e330259: folds
1039fde1: folds
Hero: raises $0.43 to $0.64
43cdbcd9: folds
71771351: folds
8499417: calls $0.43
*** FLOP *** [Jc 5c 6h]
8499417: checks
Hero: bets $0.7
8499417: calls $0.7
*** TURN *** [Jc 5c 6h] [4h]
8499417: checks
Hero: bets $1.4
8499417: folds
Uncalled bet ($1.4) returned to Hero
*** SHOWDOWN ***
Hero collected $2.69 from pot
*** SUMMARY ***
Total pot $2.83 | Rake $0.14 | Jackpot $0 | Bingo $0 | Fortune $0 | Tax $0
Board [Jc 5c 6h 4h]
Seat 1: Hero (button) won ($2.69)
Seat 2: 43cdbcd9 (small blind) folded before Flop
Seat 3: 71771351 (big blind) folded before Flop
Seat 4: 8499417 folded on the Turn
Seat 5: 3e330259 folded before Flop (didn't bet)
Seat 6: 1039fde1 folded before Flop (didn't bet)


Poker Hand #RC3141667824: Hold'em No Limit ($0.05/$0.1) - 2024/12/12 12:36:13
Table 'RushAndCash22313084' 6-max Seat #1 is the button
Seat 1: a5f5a77f ($10.54 in chips)
Seat 2: Hero ($10 in chips)
Seat 3: b8ef2786 ($10.49 in chips)
Seat 4: 673ecd77 ($22.57 in chips)
Seat 5: 1c087ec5 ($30.3 in chips)
Seat 6: c570720c ($12.87 in chips)
Hero: posts small blind $0.05
b8ef2786: posts big blind $0.1
*** HOLE CARDS ***
Dealt to a5f5a77f 
Dealt to Hero [7s 3c]
Dealt to b8ef2786 
Dealt to 673ecd77 
Dealt to 1c087ec5 
Dealt to c570720c 
673ecd77: folds
1c087ec5: folds
c570720c: raises $0.2 to $0.3
a5f5a77f: folds
Hero: folds
b8ef2786: calls $0.2
*** FLOP *** [8c 7h Ad]
b8ef2786: checks
c570720c: checks
*** TURN *** [8c 7h Ad] [Jh]
b8ef2786: bets $0.4
c570720c: folds
Uncalled bet ($0.4) returned to b8ef2786
*** SHOWDOWN ***
b8ef2786 collected $0.62 from pot
*** SUMMARY ***
Total pot $0.65 | Rake $0.03 | Jackpot $0 | Bingo $0 | Fortune $0 | Tax $0
Board [8c 7h Ad Jh]
Seat 1: a5f5a77f (button) folded before Flop (didn't bet)
Seat 2: Hero (small blind) folded before Flop
Seat 3: b8ef2786 (big blind) won ($0.62)
Seat 4: 673ecd77 folded before Flop (didn't bet)
Seat 5: 1c087ec5 folded before Flop (didn't bet)
Seat 6: c570720c folded on the Turn


Poker Hand #RC3141667755: Hold'em No Limit ($0.05/$0.1) - 2024/12/12 12:35:59
Table 'RushAndCash22313015' 6-max Seat #1 is the button
Seat 1: 22c85f0b ($4.63 in chips)
Seat 2: 844091a0 ($10.06 in chips)
Seat 3: Hero ($10 in chips)
Seat 4: 59de94fc ($14.39 in chips)
Seat 5: 48f3df37 ($22.78 in chips)
Seat 6: 8a9b1992 ($14.91 in chips)
844091a0: posts small blind $0.05
Hero: posts big blind $0.1
*** HOLE CARDS ***
Dealt to 22c85f0b 
Dealt to 844091a0 
Dealt to Hero [Qc 4s]
Dealt to 59de94fc 
Dealt to 48f3df37 
Dealt to 8a9b1992 
59de94fc: folds
48f3df37: folds
8a9b1992: raises $0.12 to $0.22
22c85f0b: folds
844091a0: raises $0.88 to $1.1
Hero: folds
8a9b1992: calls $0.88
*** FLOP *** [2h Jd Ks]
844091a0: bets $0.76
8a9b1992: folds
Uncalled bet ($0.76) returned to 844091a0
*** SHOWDOWN ***
844091a0 collected $2.19 from pot
*** SUMMARY ***
Total pot $2.3 | Rake $0.11 | Jackpot $0 | Bingo $0 | Fortune $0 | Tax $0
Board [2h Jd Ks]
Seat 1: 22c85f0b (button) folded before Flop (didn't bet)
Seat 2: 844091a0 (small blind) won ($2.19)
Seat 3: Hero (big blind) folded before Flop
Seat 4: 59de94fc folded before Flop (didn't bet)
Seat 5: 48f3df37 folded before Flop (didn't bet)
Seat 6: 8a9b1992 folded on the Flop


